% vymazat ohvězdičkovamé řádky!
% SPRÁVNÉ ŘEŠENÍ: V-ět --> N-ění, V-ět --> A-ěný

---------------------------------

118 GROUPS FOR RULE COMBINATION: A-ý --> N-í, V-ět --> N-ění

brněný	brnění	A-ý --> N-í		
brnět	brnění	V-ět --> N-ění		
brnět	brnění	V-ět --> N-ění		LINK ALREADY PRESENT

doháněný	dohánění	A-ý --> N-í		
dohánět	dohánění	V-ět --> N-ění		LINK ALREADY PRESENT

dorozuměný	dorozumění	A-ý --> N-í		
dorozumět	dorozumění	V-ět --> N-ění		

dostavěný	dostavění	A-ý --> N-í		
dostavět	dostavění	V-ět --> N-ění		

duněný	dunění	A-ý --> N-í		
dunět	dunění	V-ět --> N-ění		LINK ALREADY PRESENT

hladověný	hladovění	A-ý --> N-í		
hladovět	hladovění	V-ět --> N-ění		LINK ALREADY PRESENT

hutněný	hutnění	A-ý --> N-í		
hutnět	hutnění	V-ět --> N-ění		

naháněný	nahánění	A-ý --> N-í		
nahánět	nahánění	V-ět --> N-ění		LINK ALREADY PRESENT

nastavěný	nastavění	A-ý --> N-í		
nastavět	nastavění	V-ět --> N-ění		LINK ALREADY PRESENT

navoněný	navonění	A-ý --> N-í		
navonět	navonění	V-ět --> N-ění		LINK ALREADY PRESENT

naváděný	navádění	A-ý --> N-í		
navádět	navádění	V-ět --> N-ění		LINK ALREADY PRESENT

nenáviděný	nenávidění	A-ý --> N-í		
nenávidět	nenávidění	V-ět --> N-ění		

obráběný	obrábění	A-ý --> N-í		
obrábět	obrábění	V-ět --> N-ění		LINK ALREADY PRESENT

odvyprávěný	odvyprávění	A-ý --> N-í		
odvyprávět	odvyprávění	V-ět --> N-ění		LINK ALREADY PRESENT

odváděný	odvádění	A-ý --> N-í		
odvádět	odvádění	V-ět --> N-ění		LINK ALREADY PRESENT

onemocněný	onemocnění	A-ý --> N-í		
onemocnět	onemocnění	V-ět --> N-ění		LINK ALREADY PRESENT

otupěný	otupění	A-ý --> N-í		
otupět	otupění	V-ět --> N-ění		LINK ALREADY PRESENT

podváděný	podvádění	A-ý --> N-í		
podvádět	podvádění	V-ět --> N-ění		LINK ALREADY PRESENT

pohaněný	pohanění	A-ý --> N-í		
pohanět	pohanění	V-ět --> N-ění		
* poháněný	pohanění	A-ý --> N-í	CHANGE: á -> a	
* pohánět	pohanění	V-ět --> N-ění	CHANGE: á -> a	

* pohaněný	pohánění	A-ý --> N-í	CHANGE: a -> á	
* pohanět	pohánění	V-ět --> N-ění	CHANGE: a -> á	
poháněný	pohánění	A-ý --> N-í		
pohánět	pohánění	V-ět --> N-ění		LINK ALREADY PRESENT

pojížděný	pojíždění	A-ý --> N-í		
pojíždět	pojíždění	V-ět --> N-ění		LINK ALREADY PRESENT

popoháněný	popohánění	A-ý --> N-í		
popohánět	popohánění	V-ět --> N-ění		LINK ALREADY PRESENT

porozuměný	porozumění	A-ý --> N-í		
porozumět	porozumění	V-ět --> N-ění		LINK ALREADY PRESENT

potápěný	potápění	A-ý --> N-í		
potápět	potápění	V-ět --> N-ění		LINK ALREADY PRESENT

proděravěný	proděravění	A-ý --> N-í		
proděravět	proděravění	V-ět --> N-ění		LINK ALREADY PRESENT

proletěný	proletění	A-ý --> N-í		
proletět	proletění	V-ět --> N-ění		LINK ALREADY PRESENT

prováděný	provádění	A-ý --> N-í		
provádět	provádění	V-ět --> N-ění		
provádět	provádění	V-ět --> N-ění		LINK ALREADY PRESENT

předjížděný	předjíždění	A-ý --> N-í		
předjíždět	předjíždění	V-ět --> N-ění		LINK ALREADY PRESENT

předpověděný	předpovědění	A-ý --> N-í		
předpovědět	předpovědění	V-ět --> N-ění		
předpovědět	předpovědění	V-ět --> N-ění		LINK ALREADY PRESENT

předváděný	předvádění	A-ý --> N-í		
předvádět	předvádění	V-ět --> N-ění		LINK ALREADY PRESENT

přeháněný	přehánění	A-ý --> N-í		
přehánět	přehánění	V-ět --> N-ění		LINK ALREADY PRESENT

přestavěný	přestavění	A-ý --> N-í		
přestavět	přestavění	V-ět --> N-ění		LINK ALREADY PRESENT

převyprávěný	převyprávění	A-ý --> N-í		
převyprávět	převyprávění	V-ět --> N-ění		LINK ALREADY PRESENT

převáděný	převádění	A-ý --> N-í		
převádět	převádění	V-ět --> N-ění		LINK ALREADY PRESENT

přiváděný	přivádění	A-ý --> N-í		
přivádět	přivádění	V-ět --> N-ění		LINK ALREADY PRESENT

rozdováděný	rozdovádění	A-ý --> N-í		
rozdovádět	rozdovádění	V-ět --> N-ění		LINK ALREADY PRESENT

rozestavěný	rozestavění	A-ý --> N-í		
rozestavět	rozestavění	V-ět --> N-ění		LINK ALREADY PRESENT

rozháněný	rozhánění	A-ý --> N-í		
rozhánět	rozhánění	V-ět --> N-ění		LINK ALREADY PRESENT

* rozvaděný	rozvádění	A-ý --> N-í	CHANGE: a -> á	
rozváděný	rozvádění	A-ý --> N-í		
rozvádět	rozvádění	V-ět --> N-ění		LINK ALREADY PRESENT

sháněný	shánění	A-ý --> N-í		
shánět	shánění	V-ět --> N-ění		LINK ALREADY PRESENT

sklápěný	sklápění	A-ý --> N-í		
sklápět	sklápění	V-ět --> N-ění		LINK ALREADY PRESENT

skrápěný	skrápění	A-ý --> N-í		
skrápět	skrápění	V-ět --> N-ění		LINK ALREADY PRESENT

směný	smění	A-ý --> N-í		
smět	smění	V-ět --> N-ění		LINK ALREADY PRESENT

srozuměný	srozumění	A-ý --> N-í		
srozumět	srozumění	V-ět --> N-ění		LINK ALREADY PRESENT

stavěný	stavění	A-ý --> N-í		
stavět	stavění	V-ět --> N-ění		LINK ALREADY PRESENT

strpěný	strpění	A-ý --> N-í		
strpět	strpění	V-ět --> N-ění		LINK ALREADY PRESENT

svěděný	svědění	A-ý --> N-í		
svědět	svědění	V-ět --> N-ění		

trpěný	trpění	A-ý --> N-í		
trpět	trpění	V-ět --> N-ění		
trpět	trpění	V-ět --> N-ění		LINK ALREADY PRESENT

* uměný	umění	A-ý --> N-í		
umět	umění	V-ět --> N-ění		

utrpěný	utrpění	A-ý --> N-í		
utrpět	utrpění	V-ět --> N-ění		LINK ALREADY PRESENT

utápěný	utápění	A-ý --> N-í		
utápět	utápění	V-ět --> N-ění		LINK ALREADY PRESENT

uváděný	uvádění	A-ý --> N-í		
uvádět	uvádění	V-ět --> N-ění		LINK ALREADY PRESENT

vestavěný	vestavění	A-ý --> N-í		
vestavět	vestavění	V-ět --> N-ění		LINK ALREADY PRESENT

vháněný	vhánění	A-ý --> N-í		
vhánět	vhánění	V-ět --> N-ění		LINK ALREADY PRESENT

viděný	vidění	A-ý --> N-í		
vidět	vidění	V-ět --> N-ění		
vidět	vidění	V-ět --> N-ění		LINK ALREADY PRESENT

vrtěný	vrtění	A-ý --> N-í		
vrtět	vrtění	V-ět --> N-ění		
vrtět	vrtění	V-ět --> N-ění		LINK ALREADY PRESENT

vrásněný	vrásnění	A-ý --> N-í		
vrásnět	vrásnění	V-ět --> N-ění		

vyhladověný	vyhladovění	A-ý --> N-í		
vyhladovět	vyhladovění	V-ět --> N-ění		LINK ALREADY PRESENT

vyhověný	vyhovění	A-ý --> N-í		
vyhovět	vyhovění	V-ět --> N-ění		LINK ALREADY PRESENT

vyháněný	vyhánění	A-ý --> N-í		
vyhánět	vyhánění	V-ět --> N-ění		LINK ALREADY PRESENT

vyprávěný	vyprávění	A-ý --> N-í		
vyprávět	vyprávění	V-ět --> N-ění		LINK ALREADY PRESENT

vyrozuměný	vyrozumění	A-ý --> N-í		
vyrozumět	vyrozumění	V-ět --> N-ění		LINK ALREADY PRESENT

vyráběný	vyrábění	A-ý --> N-í		
vyrábět	vyrábění	V-ět --> N-ění		LINK ALREADY PRESENT

vystavěný	vystavění	A-ý --> N-í		
vystavět	vystavění	V-ět --> N-ění		LINK ALREADY PRESENT

vystřízlivěný	vystřízlivění	A-ý --> N-í		
vystřízlivět	vystřízlivění	V-ět --> N-ění		LINK ALREADY PRESENT

vytápěný	vytápění	A-ý --> N-í		
vytápět	vytápění	V-ět --> N-ění		
vytápět	vytápění	V-ět --> N-ění		LINK ALREADY PRESENT

vyváděný	vyvádění	A-ý --> N-í		
vyvádět	vyvádění	V-ět --> N-ění		

věděný	vědění	A-ý --> N-í		
vědět	vědění	V-ět --> N-ění		
vědět	vědění	V-ět --> N-ění		LINK ALREADY PRESENT

zahleděný	zahledění	A-ý --> N-í		
zahledět	zahledění	V-ět --> N-ění		
zahledět	zahledění	V-ět --> N-ění		LINK ALREADY PRESENT

zaháněný	zahánění	A-ý --> N-í		
zahánět	zahánění	V-ět --> N-ění		LINK ALREADY PRESENT

zapomněný	zapomnění	A-ý --> N-í		
zapomnět	zapomnění	V-ět --> N-ění		LINK ALREADY PRESENT

zaprděný	zaprdění	A-ý --> N-í		
zaprdět	zaprdění	V-ět --> N-ění		

zastavěný	zastavění	A-ý --> N-í		
zastavět	zastavění	V-ět --> N-ění		LINK ALREADY PRESENT

zasvištěný	zasvištění	A-ý --> N-í		
zasvištět	zasvištění	V-ět --> N-ění		
zasvištět	zasvištění	V-ět --> N-ění		LINK ALREADY PRESENT

zatemněný	zatemnění	A-ý --> N-í		
zatemnět	zatemnění	V-ět --> N-ění		

zaváděný	zavádění	A-ý --> N-í		
zavádět	zavádění	V-ět --> N-ění		
zavádět	zavádění	V-ět --> N-ění		LINK ALREADY PRESENT

zaškareděný	zaškaredění	A-ý --> N-í		
zaškaredět	zaškaredění	V-ět --> N-ění		

zašuměný	zašumění	A-ý --> N-í		
zašumět	zašumění	V-ět --> N-ění		LINK ALREADY PRESENT

zbytněný	zbytnění	A-ý --> N-í		
zbytnět	zbytnění	V-ět --> N-ění		LINK ALREADY PRESENT

zcitlivěný	zcitlivění	A-ý --> N-í		
zcitlivět	zcitlivění	V-ět --> N-ění		

zdrsněný	zdrsnění	A-ý --> N-í		
zdrsnět	zdrsnění	V-ět --> N-ění		

zevšeobecněný	zevšeobecnění	A-ý --> N-í		
zevšeobecnět	zevšeobecnění	V-ět --> N-ění		

zhmotněný	zhmotnění	A-ý --> N-í		
zhmotnět	zhmotnění	V-ět --> N-ění		

zhutněný	zhutnění	A-ý --> N-í		
zhutnět	zhutnění	V-ět --> N-ění		

zintenzivněný	zintenzivnění	A-ý --> N-í		
zintenzivnět	zintenzivnění	V-ět --> N-ění		LINK ALREADY PRESENT

* zintenzivněný	zintenzívnění	A-ý --> N-í	CHANGE: i -> í	
* zintenzivnět	zintenzívnění	V-ět --> N-ění	CHANGE: i -> í	
zintenzívněný	zintenzívnění	A-ý --> N-í		
zintenzívnět	zintenzívnění	V-ět --> N-ění		

zjasněný	zjasnění	A-ý --> N-í		
zjasnět	zjasnění	V-ět --> N-ění		

zjemněný	zjemnění	A-ý --> N-í		
zjemnět	zjemnění	V-ět --> N-ění		

zkapalněný	zkapalnění	A-ý --> N-í		
zkapalnět	zkapalnění	V-ět --> N-ění		

zklidněný	zklidnění	A-ý --> N-í		
zklidnět	zklidnění	V-ět --> N-ění		

zkrápěný	zkrápění	A-ý --> N-í		
zkrápět	zkrápění	V-ět --> N-ění		LINK ALREADY PRESENT

zkvalitněný	zkvalitnění	A-ý --> N-í		
zkvalitnět	zkvalitnění	V-ět --> N-ění		

zlevněný	zlevnění	A-ý --> N-í		
zlevnět	zlevnění	V-ět --> N-ění		

zmarněný	zmarnění	A-ý --> N-í		
zmarnět	zmarnění	V-ět --> N-ění		

zmocněný	zmocnění	A-ý --> N-í		
zmocnět	zmocnění	V-ět --> N-ění		

zmírněný	zmírnění	A-ý --> N-í		
zmírnět	zmírnění	V-ět --> N-ění		

znecitlivěný	znecitlivění	A-ý --> N-í		
znecitlivět	znecitlivění	V-ět --> N-ění		LINK ALREADY PRESENT

znehybněný	znehybnění	A-ý --> N-í		
znehybnět	znehybnění	V-ět --> N-ění		

zneklidněný	zneklidnění	A-ý --> N-í		
zneklidnět	zneklidnění	V-ět --> N-ění		

znervózněný	znervóznění	A-ý --> N-í		
znervóznět	znervóznění	V-ět --> N-ění		

znárodněný	znárodnění	A-ý --> N-í		
znárodnět	znárodnění	V-ět --> N-ění		

zobecněný	zobecnění	A-ý --> N-í		
zobecnět	zobecnění	V-ět --> N-ění		

zodpověděný	zodpovědění	A-ý --> N-í		
zodpovědět	zodpovědění	V-ět --> N-ění		
zodpovědět	zodpovědění	V-ět --> N-ění		LINK ALREADY PRESENT

zpevněný	zpevnění	A-ý --> N-í		
zpevnět	zpevnění	V-ět --> N-ění		

zpochybněný	zpochybnění	A-ý --> N-í		
zpochybnět	zpochybnění	V-ět --> N-ění		

zpopelněný	zpopelnění	A-ý --> N-í		
zpopelnět	zpopelnění	V-ět --> N-ění		

zprůmyslněný	zprůmyslnění	A-ý --> N-í		
zprůmyslnět	zprůmyslnění	V-ět --> N-ění		LINK ALREADY PRESENT

zpřesněný	zpřesnění	A-ý --> N-í		
zpřesnět	zpřesnění	V-ět --> N-ění		

* zpřesněný	zpřísnění	A-ý --> N-í	CHANGE: e -> í	
* zpřesnět	zpřísnění	V-ět --> N-ění	CHANGE: e -> í	
zpřísněný	zpřísnění	A-ý --> N-í		
zpřísnět	zpřísnění	V-ět --> N-ění		

zpříjemněný	zpříjemnění	A-ý --> N-í		
zpříjemnět	zpříjemnění	V-ět --> N-ění		

zpřístupněný	zpřístupnění	A-ý --> N-í		
zpřístupnět	zpřístupnění	V-ět --> N-ění		

zveřejněný	zveřejnění	A-ý --> N-í		
zveřejnět	zveřejnění	V-ět --> N-ění		

zviditelněný	zviditelnění	A-ý --> N-í		
zviditelnět	zviditelnění	V-ět --> N-ění		

* zvlákněný	zvláčnění	A-ý --> N-í	CHANGE: k -> č	
zvláčnět	zvláčnění	V-ět --> N-ění		

zvýrazněný	zvýraznění	A-ý --> N-í		
zvýraznět	zvýraznění	V-ět --> N-ění		

zvěčněný	zvěčnění	A-ý --> N-í		
zvěčnět	zvěčnění	V-ět --> N-ění		

zúrodněný	zúrodnění	A-ý --> N-í		
zúrodnět	zúrodnění	V-ět --> N-ění		

šuměný	šumění	A-ý --> N-í		
šumět	šumění	V-ět --> N-ění		LINK ALREADY PRESENT



