% vymazat ohvězdičkovamé řádky!
% SPRÁVNÉ ŘEŠENÍ: V-at --> N-ání, V-at --> A-aný


---------------------------------

47 GROUPS FOR RULE COMBINATION: A-ý --> N-í, N-a --> N-ání, V-at --> N-ání

* boura	bourání	N-a --> N-ání		
bouraný	bourání	A-ý --> N-í	CHANGE: a -> á	
bourat	bourání	V-at --> N-ání		LINK ALREADY PRESENT

* cekat	čekání	V-at --> N-ání	CHANGE: c -> č	
* čeka	čekání	N-a --> N-ání		
čekaný	čekání	A-ý --> N-í	CHANGE: a -> á	
čekat	čekání	V-at --> N-ání		LINK ALREADY PRESENT

domlouvaný	domlouvání	A-ý --> N-í	CHANGE: a -> á	
domlouvat	domlouvání	V-at --> N-ání		LINK ALREADY PRESENT
* domluva	domlouvání	N-a --> N-ání	CHANGE: u -> ou	

foukaný	foukání	A-ý --> N-í	CHANGE: a -> á	
foukat	foukání	V-at --> N-ání		LINK ALREADY PRESENT
* fuka	foukání	N-a --> N-ání	CHANGE: u -> ou	

hvízdaný	hvízdání	A-ý --> N-í	CHANGE: a -> á	
hvízdat	hvízdání	V-at --> N-ání		LINK ALREADY PRESENT
* hvězda	hvízdání	N-a --> N-ání	CHANGE: ě -> í	

* kapa	kapání	N-a --> N-ání		
kapaný	kapání	A-ý --> N-í	CHANGE: a -> á	
kapat	kapání	V-at --> N-ání		
kapat	kapání	V-at --> N-ání		LINK ALREADY PRESENT

* kona	konání	N-a --> N-ání		
konaný	konání	A-ý --> N-í	CHANGE: a -> á	
konat	konání	V-at --> N-ání		LINK ALREADY PRESENT

* kopa	kopání	N-a --> N-ání		
kopaný	kopání	A-ý --> N-í	CHANGE: a -> á	
kopat	kopání	V-at --> N-ání		
kopat	kopání	V-at --> N-ání		LINK ALREADY PRESENT

koupaný	koupání	A-ý --> N-í	CHANGE: a -> á	
koupat	koupání	V-at --> N-ání		
koupat	koupání	V-at --> N-ání		LINK ALREADY PRESENT
* kupa	koupání	N-a --> N-ání	CHANGE: u -> ou	

laskaný	laskání	A-ý --> N-í	CHANGE: a -> á	
laskat	laskání	V-at --> N-ání		LINK ALREADY PRESENT
* láska	laskání	N-a --> N-ání	CHANGE: á -> a	

loupaný	loupání	A-ý --> N-í	CHANGE: a -> á	
loupat	loupání	V-at --> N-ání		
loupat	loupání	V-at --> N-ání		LINK ALREADY PRESENT
* lupa	loupání	N-a --> N-ání	CHANGE: u -> ou	
* lupat	loupání	V-at --> N-ání	CHANGE: u -> ou	

* mačka	mačkání	N-a --> N-ání		
mačkaný	mačkání	A-ý --> N-í	CHANGE: a -> á	
mačkat	mačkání	V-at --> N-ání		LINK ALREADY PRESENT
* máčka	mačkání	N-a --> N-ání	CHANGE: á -> a	

* meta	metání	N-a --> N-ání		
metaný	metání	A-ý --> N-í	CHANGE: a -> á	
metat	metání	V-at --> N-ání		LINK ALREADY PRESENT

* mícha	míchání	N-a --> N-ání		
míchaný	míchání	A-ý --> N-í	CHANGE: a -> á	
míchat	míchání	V-at --> N-ání		LINK ALREADY PRESENT

* odleva	odlévání	N-a --> N-ání	CHANGE: e -> é	
odlévaný	odlévání	A-ý --> N-í	CHANGE: a -> á	
odlévat	odlévání	V-at --> N-ání		LINK ALREADY PRESENT

* odleva	odlívání	N-a --> N-ání	CHANGE: e -> í	
* odlévat	odlívání	V-at --> N-ání	CHANGE: é -> í	
odlívaný	odlívání	A-ý --> N-í	CHANGE: a -> á	
odlívat	odlívání	V-at --> N-ání		

* opera	opírání	N-a --> N-ání	CHANGE: e -> í	
opíraný	opírání	A-ý --> N-í	CHANGE: a -> á	
opírat	opírání	V-at --> N-ání		LINK ALREADY PRESENT
* opěra	opírání	N-a --> N-ání	CHANGE: ě -> í	

* pepa	pípání	N-a --> N-ání	CHANGE: e -> í	
* pípa	pípání	N-a --> N-ání		
pípaný	pípání	A-ý --> N-í	CHANGE: a -> á	
pípat	pípání	V-at --> N-ání		LINK ALREADY PRESENT

* pitva	pitvání	N-a --> N-ání		
pitvaný	pitvání	A-ý --> N-í	CHANGE: a -> á	
pitvat	pitvání	V-at --> N-ání		LINK ALREADY PRESENT

podaný	podání	A-ý --> N-í	CHANGE: a -> á	
podat	podání	V-at --> N-ání		
* půda	podání	N-a --> N-ání	CHANGE: ů -> o	

podpíraný	podpírání	A-ý --> N-í	CHANGE: a -> á	
podpírat	podpírání	V-at --> N-ání		LINK ALREADY PRESENT
* podpěra	podpírání	N-a --> N-ání	CHANGE: ě -> í	

* poleva	polévání	N-a --> N-ání	CHANGE: e -> é	
polévaný	polévání	A-ý --> N-í	CHANGE: a -> á	
polévat	polévání	V-at --> N-ání		LINK ALREADY PRESENT

pomlouvaný	pomlouvání	A-ý --> N-í	CHANGE: a -> á	
pomlouvat	pomlouvání	V-at --> N-ání		LINK ALREADY PRESENT
* pomluva	pomlouvání	N-a --> N-ání	CHANGE: u -> ou	

porouchaný	porouchání	A-ý --> N-í	CHANGE: a -> á	
porouchat	porouchání	V-at --> N-ání		LINK ALREADY PRESENT
* porucha	porouchání	N-a --> N-ání	CHANGE: u -> ou	

* posila	posílání	N-a --> N-ání	CHANGE: i -> í	
posílaný	posílání	A-ý --> N-í	CHANGE: a -> á	
posílat	posílání	V-at --> N-ání		LINK ALREADY PRESENT

potkaný	potkání	A-ý --> N-í	CHANGE: a -> á	
potkat	potkání	V-at --> N-ání		LINK ALREADY PRESENT
* půtka	potkání	N-a --> N-ání	CHANGE: ů -> o	

poutaný	poutání	A-ý --> N-í	CHANGE: a -> á	
poutat	poutání	V-at --> N-ání		LINK ALREADY PRESENT
* puta	poutání	N-a --> N-ání	CHANGE: u -> ou	

předstíraný	předstírání	A-ý --> N-í	CHANGE: a -> á	
předstírat	předstírání	V-at --> N-ání		LINK ALREADY PRESENT
* předstěra	předstírání	N-a --> N-ání	CHANGE: ě -> í	

* přísaha	přísahání	N-a --> N-ání		
přísahaný	přísahání	A-ý --> N-í	CHANGE: a -> á	
přísahat	přísahání	V-at --> N-ání		LINK ALREADY PRESENT

* sleva	slévání	N-a --> N-ání	CHANGE: e -> é	
slévaný	slévání	A-ý --> N-í	CHANGE: a -> á	
slévat	slévání	V-at --> N-ání		LINK ALREADY PRESENT

* strouha	strouhání	N-a --> N-ání		
strouhaný	strouhání	A-ý --> N-í	CHANGE: a -> á	
strouhat	strouhání	V-at --> N-ání		LINK ALREADY PRESENT
* struha	strouhání	N-a --> N-ání	CHANGE: u -> ou	

* středa	střídání	N-a --> N-ání	CHANGE: e -> í	
* střída	střídání	N-a --> N-ání		
střídaný	střídání	A-ý --> N-í	CHANGE: a -> á	
střídat	střídání	V-at --> N-ání		LINK ALREADY PRESENT

* svita	svítání	N-a --> N-ání	CHANGE: i -> í	
svítaný	svítání	A-ý --> N-í	CHANGE: a -> á	
svítat	svítání	V-at --> N-ání		LINK ALREADY PRESENT

* síra	šírání	N-a --> N-ání	CHANGE: s -> š	
* šerat	šírání	V-at --> N-ání	CHANGE: e -> í	
šíraný	šírání	A-ý --> N-í	CHANGE: a -> á	
šírat	šírání	V-at --> N-ání		LINK ALREADY PRESENT

* třeskat	třískání	V-at --> N-ání	CHANGE: e -> í	
* tříska	třískání	N-a --> N-ání		
třískaný	třískání	A-ý --> N-í	CHANGE: a -> á	
třískat	třískání	V-at --> N-ání		LINK ALREADY PRESENT

* veta	vítání	N-a --> N-ání	CHANGE: e -> í	
vítaný	vítání	A-ý --> N-í	CHANGE: a -> á	
vítat	vítání	V-at --> N-ání		LINK ALREADY PRESENT
* věta	vítání	N-a --> N-ání	CHANGE: ě -> í	

vyspaný	vyspání	A-ý --> N-í	CHANGE: a -> á	
vyspat	vyspání	V-at --> N-ání		LINK ALREADY PRESENT
* výspa	vyspání	N-a --> N-ání	CHANGE: ý -> y	

vyzvaný	vyzvání	A-ý --> N-í	CHANGE: a -> á	
vyzvat	vyzvání	V-at --> N-ání		
* výzva	vyzvání	N-a --> N-ání	CHANGE: ý -> y	

vzpíraný	vzpírání	A-ý --> N-í	CHANGE: a -> á	
vzpírat	vzpírání	V-at --> N-ání		LINK ALREADY PRESENT
* vzpěra	vzpírání	N-a --> N-ání	CHANGE: ě -> í	

zacpaný	zacpání	A-ý --> N-í	CHANGE: a -> á	
zacpat	zacpání	V-at --> N-ání		LINK ALREADY PRESENT
* zácpa	zacpání	N-a --> N-ání	CHANGE: á -> a	

zadaný	zadání	A-ý --> N-í	CHANGE: a -> á	
zadat	zadání	V-at --> N-ání		LINK ALREADY PRESENT
* záda	zadání	N-a --> N-ání	CHANGE: á -> a	

zaplavaný	zaplavání	A-ý --> N-í	CHANGE: a -> á	
zaplavat	zaplavání	V-at --> N-ání		LINK ALREADY PRESENT
* záplava	zaplavání	N-a --> N-ání	CHANGE: á -> a	

* črta	črtání	N-a --> N-ání		
črtaný	črtání	A-ý --> N-í	CHANGE: a -> á	
črtat	črtání	V-at --> N-ání		LINK ALREADY PRESENT

* řeka	říkání	N-a --> N-ání	CHANGE: e -> í	
říkaný	říkání	A-ý --> N-í	CHANGE: a -> á	
říkat	říkání	V-at --> N-ání		
říkat	říkání	V-at --> N-ání		LINK ALREADY PRESENT

* šleha	šlehání	N-a --> N-ání		
šlehaný	šlehání	A-ý --> N-í	CHANGE: a -> á	
šlehat	šlehání	V-at --> N-ání		LINK ALREADY PRESENT

šoupaný	šoupání	A-ý --> N-í	CHANGE: a -> á	
šoupat	šoupání	V-at --> N-ání		
šoupat	šoupání	V-at --> N-ání		LINK ALREADY PRESENT
* šupa	šoupání	N-a --> N-ání	CHANGE: u -> ou	
* šupat	šoupání	V-at --> N-ání	CHANGE: u -> ou	

* žvatla	žvatlání	N-a --> N-ání		
žvatlaný	žvatlání	A-ý --> N-í	CHANGE: a -> á	
žvatlat	žvatlání	V-at --> N-ání		LINK ALREADY PRESENT


