agentománie#N	agent#N	mánie#N
akrylomalba#N	akryl_;R#N	malba#N
aktinodermatitida_;U#N	aktin#N	dermatitida#N
aktinometrie#N	aktin#N	metrie#N
aktinomykóza#N	aktin#N	mykóza#N
!aluminosilikát_;H#N	alumina#N	silikát#N # spis aluminium
!aluminotermický#A	alumina#N	termický#A
!arciopat#N	arci_,s#D	pat#N
!ateroskleróza#N	ater_;L_,t#A	skleróza#N
austroasijský#A	austro#A	asijský#A
austromarxizmus#N	austro#A	marxizmus#N
austroněmecký#A	austro#A	německý#A
austroslavizmus#N	austro#A	slavizmus#N
azbestocement#N	azbest#N	cement#N
baletománie#N	balet#N	mánie#N
bifidobakterie#N	bifida_;L_,t#A	bakterie#N
!bikolaterální#A	bika_;L_^(rostlina)#N	laterální#A
bilirubinometr#N	bilirubin#N	metr#N
bratrovrah#N	bratr#N	vrah#N
bratrovražda#N	bratr#N	vražda#N
burčákochtivý#A	burčák#N	chtivý#A
ceroplastika_;u#N	cera_^(vosk)#N	plastika#N
chyboražba#N	chyba#N	ražba#N
cizojazyčný#A	cizí#A	jazyčný#A
cizosprášení#N	cizí#A	sprášení#N
cizovláda#N	cizí#A	vláda#N
cylindrokónický#A	cylindr#N	kónický#A
cystopyelitida_;U#N	cysta#N	pyelitida_;U#N
daktylogram#N	daktyl#N	gram#N
!darmojed#N	darmo#D	jed#N
denzitometrie#N	denzita#N	metrie#N
dermoplastický#A	dermo#A	plastický#A
dermorespirační#A	dermo#A	respirační#A
dietoterapie#N	dieta#N	terapie#N
dimethylaminobenzaldehyd#N	dimethylamin_,s_^(^DD**dimetylamin)#N	benzaldehyd#N
dlanitodílný#A	dlanitý#A	dílný#A
dlanitosečný#A	dlanitý#A	sečný#A
draselnohlinitý#A	draselný#A	hlinitý#A
draselnoželezitý#A	draselný#A	železitý#A
dynamoelektrický#A	dynamo#N	elektrický#A
dynamometr_;g#N	dynamo#N	metr#N
dynamometrický#A	dynamo#N	metrický#A
dálkoplavec#N	dálka#N	plavec#N
dálkoplaz_,h#N	dálka#N	plaz#N
dělostřelba#N	dělo#N	střelba#N
dělostřelec#N	dělo#N	střelec#N
dřevobraní#N	dřevo#N	braní_^(*3át)#N
dřevodeska#N	dřevo#N	deska#N
dřevodílna#N	dřevo#N	dílna#N
dřevodělný#A	dřevo#N	dělný#A
dřevohlinitý#A	dřevo#N	hlinitý#A
dřevohliněný#A	dřevo#N	hliněný#A
dřevohra#N	dřevo#N	hra_^(dětská;_v_divadle;...)#N
dřevokaz#N	dřevo#N	kaz#N
dřevoklání#N	dřevo#N	klání-1_^(*4t-1)#N
dřevokresba#N	dřevo#N	kresba#N
dřevolátka#N	dřevo#N	látka#N
dřevomalba#N	dřevo#N	malba#N
dřevomateriál#N	dřevo#N	materiál#N
dřevoplyn#N	dřevo#N	plyn#N
dřevoprůmysl#N	dřevo#N	průmysl#N
dřevorytectví#N	dřevo#N	rytectví#N
dřevosklad#N	dřevo#N	sklad#N
dřevostavba#N	dřevo#N	stavba#N
dřevostavitel#N	dřevo#N	stavitel#N
dřevotisk_,a#N	dřevo#N	tisk#N
dřevotříska#N	dřevo#N	tříska#N
dřevouhelný#A	dřevo#N	uhelný#A
dřevovláknitý#A	dřevo#N	vláknitý#A
dřevozpracující#A	dřevo#N	zpracující#A
dřevořez#N	dřevo#N	řez#N
dřevořezba#N	dřevo#N	řezba#N
dřevořezbářství#N	dřevo#N	řezbářství#N
dřevořezání#N	dřevo#N	řezání_^(*3at)#N
dřevoštěpka#N	dřevo#N	štěpka#N
dřevožravý#A	dřevo#N	žravý#A
!elastometr#N	elast#N	metr#N
!elastoplasticita#N	elast#N	plasticita#N
elipsometr_;g#N	elipsa#N	metr#N
embryogeneze#N	embryo#N	geneze#N
embryotransfer#N	embryo#N	transfer#N
enzymoterapie#N	enzym#N	terapie#N
eventostratigrafie_;L#N	event#N	stratigrafie#N
!feratogen#N	ferata_;w_,t_^(ferrata_-_zajištěná_cesta_v_horách)#N	gen#N
fibrinogen#N	fibrin#N	gen#N
fibrinolyzin_;H#N	fibrin#N	lyzin_;H_,s_^(^DD**lyzín)#N
filmotéka#N	film#N	téka#N
filtroventilace#N	filtr#N	ventilace#N
gametogeneze#N	gameta#N	geneze#N
genotyp#N	gen#N	typ#N
granitotrachytický#A	granit#N	trachytický#A
granulometrie#N	granula#N	metrie#N
hlenohnisavý#A	hlen#N	hnisavý#A
hlinitoberylnatý#A	hlinitý#A	berylnatý#A
hlinitodraselný#A	hlinitý#A	draselný#A
hlinitokřemičitan_;H#N	hlinitý#A	křemičitan#N
hlinitopísčitý#A	hlinitý#A	písčitý#A
hlinitovápenatý#A	hlinitý#A	vápenatý#A
hymnograf_,s#N	hymna#N	graf#N
!hyperlinkování#N	hyperlink_;c_,t#N	vání_^(*2t)#N
infobudka_,h#N	info#N	budka#N
infocentrum-1#N	info#N	centrum#N
infodálnice#N	info#N	dálnice#N
infografický#A	info#N	grafický#A
infokancelář#N	info#N	kancelář#N
infokanál#N	info#N	kanál#N
infolinka#N	info#N	linka#N
infopanel#N	info#N	panel#N
infoservis-1#N	info#N	servis#N
infostánek#N	info#N	stánek#N
!introflexe#N	intra#A	flexe#N
!intropunitivita_;U#N	intra#A	punitivita#N
!introverze#N	intra#A	verze#N
inzulinorezistence#N	inzulin_,s_^(^DD**inzulín)#N	rezistence#N
!jazykovitý#A	jazyk#N	vitý_^(*3ít)#A
jazykověda#N	jazyk#N	věda#N
jazykozpyt#N	jazyk#N	zpyt_,a#N
jedinovláda#N	jediný#A	vláda#N
!jednobarevný#A	jedno#D	barevný#A
!jednobuněčný#A	jedno#D	buněčný#A
!jednocestný#A	jedno#D	cestný_^(týkající_se_cesty)#A
!jednociferný#A	jedno#D	ciferný#A
!jednocyklický#A	jedno#D	cyklický#A
!jednofunkční#A	jedno#D	funkční#A
!jednogenerační#A	jedno#D	generační#A
!jednoinstanční#A	jedno#D	instanční#A
!jednojaderný#A	jedno#D	jaderný#A
!jednojazyčný#A	jedno#D	jazyčný#A
!jednoklientský#A	jedno#D	klientský#A
!jednokriteriální#A	jedno#D	kriteriální#A
!jednokvítek_;L#N	jedno#D	kvítek#N
!jednoletý#A	jedno#D	letý#A
!jednomužství#N	jedno#D	mužství#N
!jednomístný#A	jedno#D	místný_^(několikamístný)#A
!jednoměsíční#A	jedno#D	měsíční#A
!jednonápravný#A	jedno#D	nápravný#A
!jednoparametrický#A	jedno#D	parametrický#A
!jednoplemenný#A	jedno#D	plemenný#A
!jednopramenný#A	jedno#D	pramenný#A
!jednoprsťák#N	jedno#D	prsťák#N
!jednopísmenný#A	jedno#D	písmenný#A
!jednosemenný#A	jedno#D	semenný#A
!jednosemestrální#A	jedno#D	semestrální#A
!jednoskalární#A	jedno#D	skalární#A
!jednoslabičný#A	jedno#D	slabičný#A
!jednosměnný#A	jedno#D	směnný#A
!jednostejný#A	jedno#D	stejný#A
!jednostranický#A	jedno#D	stranický#A
!jednostrunný#A	jedno#D	strunný#A
!jednostřižný#A	jedno#D	střižný#A
!jednotvárný#A	jedno#D	tvárný#A
!jednotýdenní#A	jedno#D	týdenní#A
!jednouhlíkatý#A	jedno#D	uhlíkatý#A
!jednouživatelský#A	jedno#D	uživatelský#A
!jednovaječný#A	jedno#D	vaječný#A
!jednoveslice#N	jedno#D	veslice#N
!jednovečerní#A	jedno#D	večerní#A
!jednovláknitý#A	jedno#D	vláknitý#A
!jednovrstevný#A	jedno#D	vrstevný#A
!jednovětevný#A	jedno#D	větevný#A
!jednoznačný#A	jedno#D	značný#A
!jednozvučný#A	jedno#D	zvučný#A
!jednočlenný#A	jedno#D	členný#A
!jednočíselný#A	jedno#D	číselný#A
!jednoženství#N	jedno#D	ženství#N
jihoafghánský#A	jih#N	afghánský#A
jihoafrický#A	jih#N	africký#A
jihoalbánský#A	jih#N	albánský#A
jihoalžírský#A	jih#N	alžírský#A
jihoamerický#A	jih#N	americký#A
jihoanglický#A	jih#N	anglický#A
jihoarabský#A	jih#N	arabský#A
jihoasijský#A	jih#N	asijský#A
jihoatlantický#A	jih#N	atlantický#A
jihoatlantský#A	jih#N	atlantský#A
jihoaustralský#A	jih#N	australský#A
jihobelgický#A	jih#N	belgický#A
jihobrazilský#A	jih#N	brazilský#A
jihobulharský#A	jih#N	bulharský#A
jihochilský#A	jih#N	chilský#A
jihodalmatský#A	jih#N	dalmatský#A
jihoegyptský#A	jih#N	egyptský#A
jihofidžijský#A	jih#N	fidžijský#A
jihofilipínský#A	jih#N	filipínský#A
jihogruzínský#A	jih#N	gruzínský#A
jihoindický#A	jih#N	indický#A
jihoirský#A	jih#N	irský#A
jihoirácký#A	jih#N	irácký#A
jihoislandský#A	jih#N	islandský#A
jihoitalský#A	jih#N	italský#A
jihoizraelský#A	jih#N	izraelský#A
jihojakutský#A	jih#N	jakutský#A
jihojemenský#A	jih#N	jemenský#A
jihokarpatský#A	jih#N	karpatský#A
jihokašmírský#A	jih#N	kašmírský#A
jihokurilský#A	jih#N	kurilský#A
jiholužický#A	jih#N	lužický#A
jihomalajský#A	jih#N	malajský#A
jihomalešický#A	jih#N	malešický#A
jihomandžuský#A	jih#N	mandžuský#A
jihomaďarský#A	jih#N	maďarský#A
jihomexický#A	jih#N	mexický#A
jihonigerijský#A	jih#N	nigerijský#A
jihonikaragujský#A	jih#N	nikaragujský#A
jihoněmecký#A	jih#N	německý#A
jihopacifický#A	jih#N	pacifický#A
jihoperuánský#A	jih#N	peruánský#A
jihoplzeňský#A	jih#N	plzeňský#A
jihopákistánský#A	jih#N	pákistánský#A
jihorumunský#A	jih#N	rumunský#A
jihoruský#A	jih#N	ruský#A
jihosibiřský#A	jih#N	sibiřský#A
jihosicilský#A	jih#N	sicilský#A
jihosrbský#A	jih#N	srbský#A
jihosúdánský#A	jih#N	súdánský#A
jihotchajwanský#A	jih#N	tchajwanský#A
jihothajský#A	jih#N	thajský#A
jihoturecký#A	jih#N	turecký#A
jihotádžický#A	jih#N	tádžický#A
jihoukrajinský#A	jih#N	ukrajinský#A
jihoulsterský#A	jih#N	ulsterský#A
jihouralský#A	jih#N	uralský#A
jihovietnamský#A	jih#N	vietnamský#A
jihozápad#N	jih#N	západ#N
jihoázerbájdžánský#A	jih#N	ázerbájdžánský#A
jihoíránský#A	jih#N	íránský#A
jihočeský#A	jih#N	český#A
jihočečenský#A	jih#N	čečenský#A
jihočínský#A	jih#N	čínský#A
jihořecký#A	jih#N	řecký#A
jihošpanělský#A	jih#N	španělský#A
jihošvédský#A	jih#N	švédský#A
jihošvýcarský#A	jih#N	švýcarský#A
játroslinivka#N	játra#N	slinivka#N
kalyptrogen#N	kalyptra#N	gen#N
každodenní#A	každý#A	denní#A
každoměsíční#A	každý#A	měsíční#A
každopádně#D	každý#A	pádně_^(*1ý)#D
každotýdenní#A	každý#A	týdenní#A
každovečerní#A	každý#A	večerní#A
kilobaud#N	kilo#N	baud#N
kilobit#N	kilo#N	bit#N
kilobyte#N	kilo#N	byte_^([bajt];_8_bitů_[v_počítači])#N
kilocyklus_^(tisíc_cyklů)#N	kilo#N	cyklus#N
kilogram#N	kilo#N	gram#N
kilometr#N	kilo#N	metr#N
kilometráž#N	kilo#N	metráž#N
kilotuna#N	kilo#N	tuna#N
kilovar#N	kilo#N	var#N
kilowatt#N	kilo#N	watt#N
kinoamatér#N	kino#N	amatér#N
kinoaparát_;g#N	kino#N	aparát#N
kinobus#N	kino#N	bus_,t#N
kinocentrum#N	kino#N	centrum#N
kinocilie_;L#N	kino#N	cilie#N
kinodistribuce#N	kino#N	distribuce#N
kinofilm#N	kino#N	film#N
kinohvězda#N	kino#N	hvězda#N
kinokamera#N	kino#N	kamera#N
kinokavárna#N	kino#N	kavárna#N
kinoklub#N	kino#N	klub#N
kinomaniak#N	kino#N	maniak#N
kinosál#N	kino#N	sál#N
kinotechnika#N	kino#N	technika#N
kinotéka#N	kino#N	téka#N
kinouhlík#N	kino#N	uhlík#N
kinozáznam#N	kino#N	záznam#N
kinožurnál#N	kino#N	žurnál#N
kryptoanalýza#N	krypta#N	analýza#N
kryptocitát#N	krypta#N	citát#N
kryptodeprese#N	krypta#N	deprese#N
kryptodiktatura#N	krypta#N	diktatura#N
kryptofašista#N	krypta#N	fašista#N
kryptofederalizmus#N	krypta#N	federalizmus#N
kryptoklima#N	krypta#N	klima#N
kryptokrystalický#A	krypta#N	krystalický#A
kryptomarxistický#A	krypta#N	marxistický#A
kryptoschéma#N	krypta#N	schéma#N
kryptosystém#N	krypta#N	systém#N
kryptovulkanický#A	krypta#N	vulkanický#A
kyanoakrylát#N	kyan#N	akrylát_;H#N
kyanoguanidin#N	kyan#N	guanidin#N
kyanoželezitan_;H#N	kyan#N	železitan#N
kávomilec#N	káva#N	milec_,a#N
kávomlýnek#N	káva#N	mlýnek#N
kávovar#N	káva#N	var#N
!kávovina#N	káva#N	vina#N
laseroterapie#N	laser#N	terapie#N
ledopád#N	led#N	pád#N
lymfoblastický_;U#A	lymfa#N	blastický#A
lymfodrenáž_;U#N	lymfa#N	drenáž#N
lymforetikulární#A	lymfa#N	retikulární#A
lůzovláda#N	lůza#N	vláda#N
makroagregát#N	makro#N	agregát#N
makroanalýza#N	makro#N	analýza#N
makroaplikace#N	makro#N	aplikace#N
makroassembler#N	makro#N	assembler#N
makrobudík#N	makro#N	budík#N
makrocyklus#N	makro#N	cyklus#N
makrodata#N	makro#N	data_^(údaje,_např._v_databázi)#N
makrodefinice#N	makro#N	definice#N
makroelement#N	makro#N	element#N
makroenergetický#A	makro#N	energetický#A
makrofauna#N	makro#N	fauna#N
makrofunkce#N	makro#N	funkce#N
makrofyzika#N	makro#N	fyzika#N
makrofág#N	makro#N	fág_^(virus_napadající_bakterie)#N
makrogameta#N	makro#N	gameta#N
makroglie#N	makro#N	glie_;U#N
makroinstrukce#N	makro#N	instrukce#N
makrojazyk#N	makro#N	jazyk#N
makroklima#N	makro#N	klima#N
makroklávesa#N	makro#N	klávesa#N
!makrolid_;U_^(antibiotikum)#N	makro#N	lid_^(naší_země)#N
!makrolitický#A	makro#N	litický#A
makromanický#A	makro#N	manický#A
makromédium#N	makro#N	médium#N
makromíchání#N	makro#N	míchání_^(*3at)#N
makronukleus#N	makro#N	nukleus#N
makroparazit#N	makro#N	parazit#N
makropeptid_;H#N	makro#N	peptid#N
makroprincip#N	makro#N	princip#N
makroprvek#N	makro#N	prvek#N
makropór#N	makro#N	pór#N
makropřeklad#N	makro#N	překlad#N
makropřekladač#N	makro#N	překladač#N
makropříkaz#N	makro#N	příkaz#N
makroregulace#N	makro#N	regulace#N
makrosféra#N	makro#N	sféra#N
makrosnímek#N	makro#N	snímek#N
makrostav#N	makro#N	stav#N
makrostruktura#N	makro#N	struktura#N
makrosvět#N	makro#N	svět#N
makrosystém#N	makro#N	systém#N
makrotext#N	makro#N	text#N
makrotéma#N	makro#N	téma#N
makroukazatel#N	makro#N	ukazatel#N
makrovegetace#N	makro#N	vegetace#N
makroveličina#N	makro#N	veličina#N
makrovidění#N	makro#N	vidění_^(*2t)#N
makroznak#N	makro#N	znak#N
makrozvuk#N	makro#N	zvuk#N
makrozáběr#N	makro#N	záběr#N
makroúdaj#N	makro#N	údaj#N
!mechanoakustický#A	mechano#A	akustický#A
!mechanografický#A	mechano#A	grafický#A
!mechanoterapie#N	mechano#A	terapie#N
!meningoencefalitida#N	meninga#N	encefalitida#N
!meningomyelitida_;U#N	meninga#N	myelitida#N
methylaminorex#N	methylamin_,s_^(^DD**metylamin)#N	rex#N
mluvoznalec#N	mluva#N	znalec#N
!mrakodrápek#N	mrak#N	drápek#N
mravokárný#A	mrav#N	kárný#A
mravověda_,s#N	mrav#N	věda#N
nachovýtrusný#A	nach#N	výtrusný#A
naftonitril#N	nafta#N	nitril#N
nymfománie#N	nymfa#N	mánie#N
palivoenergetický#A	palivo#N	energetický#A
palivotěsný#A	palivo#N	těsný#A
paměťožravý#A	paměť#N	žravý#A
paralelogram#N	paralela#N	gram#N
!pedocementace#N	ped_;L#N	cementace#N
!pedocentrický#A	ped_;L#N	centrický#A
!pedochemický#A	ped_;L#N	chemický#A
!pedofil#N	ped_;L#N	fil_;b_^(měnová_jednotka)#N
!pedogeneze_;L#N	ped_;L#N	geneze#N
!pedometr#N	ped_;L#N	metr#N
!pedopsychiatrie#N	ped_;L#N	psychiatrie#N
!pedosféra#N	ped_;L#N	sféra#N
pepsinogen_;H#N	pepsin#N	gen#N
pestrobarevný#A	pestrý#A	barevný#A
pivotéka#N	pivo#N	téka#N
pivovar#N	pivo#N	var#N
planetocentrický#A	planeta#N	centrický#A
planetografický#A	planeta#N	grafický#A
pleuroperikarditida_;U#N	pleura#N	perikarditida_;U#N
plynodynamický#A	plyn#N	dynamický#A
plynoinstalace#N	plyn#N	instalace#N
plynoinstalatérský#A	plyn#N	instalatérský#A
plynosilikát#N	plyn#N	silikát#N
plynotěsný#A	plyn#N	těsný#A
plynovzdušný#A	plyn#N	vzdušný#A
plynočistírna#N	plyn#N	čistírna#N
plynožárný#A	plyn#N	žárný#A
plánograf#N	plán#N	graf#N
prdelolezec_,v#N	prdel#N	lezec#N
prdelolezectví#N	prdel#N	lezectví#N
!prvodivizní#A	prvý#A	divizní#A
!prvoinstanční#A	prvý#A	instanční#A
!prvokřesťan#N	prvý#A	křesťan#N
!prvoledvina#N	prvý#A	ledvina#N
!prvolezec#N	prvý#A	lezec#N
!prvoligista#N	prvý#A	ligista#N
!prvomajitel#N	prvý#A	majitel#N
!prvomučedník#N	prvý#A	mučedník#N
!prvonabyvatel#N	prvý#A	nabyvatel#N
!prvopachatel#N	prvý#A	pachatel#N
!prvopříčina#N	prvý#A	příčina#N
!prvoražba#N	prvý#A	ražba#N
!prvorepublikánský#A	prvý#A	republikánský#A
!prvosignatář#N	prvý#A	signatář#N
!prvouživatel#N	prvý#A	uživatel#N
!prvovlastenec#N	prvý#A	vlastenec#N
!prvočinitel#N	prvý#A	činitel#N
!prvožadatel#N	prvý#A	žadatel#N
pryžotextilní#A	pryž#N	textilní#A
puškohled#N	puška#N	hled#N
pyranometr_;g#N	pyran_;H#N	metr#N
písmolijec#N	písmo#N	lijec#N
písmolitecký#A	písmo#N	litecký#A
písmomalíř#N	písmo#N	malíř#N
písmoznalec#N	písmo#N	znalec#N
!pětieurocent#N	pětieuro#N	cent#N
!pětiúhelníkovitý#A	pětiúhelník#N	vitý_^(*3ít)#A
!půlkilogram#N	půlkilo#N	gram#N
!půlkilometr#N	půlkilo#N	metr#N
radioaktivní#A	radio_,a_,s_^(^DD**rádio)#N	aktivní#A
radioamatér#N	radio_,a_,s_^(^DD**rádio)#N	amatér#N
radioanalytický#A	radio_,a_,s_^(^DD**rádio)#N	analytický#A
radioanténa#N	radio_,a_,s_^(^DD**rádio)#N	anténa#N
radioaparát#N	radio_,a_,s_^(^DD**rádio)#N	aparát#N
radiobazar#N	radio_,a_,s_^(^DD**rádio)#N	bazar#N
radiobudík#N	radio_,a_,s_^(^DD**rádio)#N	budík#N
radioburza#N	radio_,a_,s_^(^DD**rádio)#N	burza#N
radiocentrum#N	radio_,a_,s_^(^DD**rádio)#N	centrum#N
radiochemie#N	radio_,a_,s_^(^DD**rádio)#N	chemie#N
radiochirurgie#N	radio_,a_,s_^(^DD**rádio)#N	chirurgie#N
radiodepeše#N	radio_,a_,s_^(^DD**rádio)#N	depeše#N
radiodispečink#N	radio_,a_,s_^(^DD**rádio)#N	dispečink#N
radiodraslík_;H#N	radio_,a_,s_^(^DD**rádio)#N	draslík#N
radiodárek#N	radio_,a_,s_^(^DD**rádio)#N	dárek#N
radioelektrický#A	radio_,a_,s_^(^DD**rádio)#N	elektrický#A
radiofarmakum#N	radio_,a_,s_^(^DD**rádio)#N	farmakum#N
radiofrekvence#N	radio_,a_,s_^(^DD**rádio)#N	frekvence#N
radiofyzik#N	radio_,a_,s_^(^DD**rádio)#N	fyzik#N
radiogalaxie#N	radio_,a_,s_^(^DD**rádio)#N	galaxie#N
radiograficky#D	radio_,a_,s_^(^DD**rádio)#N	graficky_^(*1ý)#D
radiohygienický#A	radio_,a_,s_^(^DD**rádio)#N	hygienický#A
radioinženýrský#A	radio_,a_,s_^(^DD**rádio)#N	inženýrský#A
radioklub#N	radio_,a_,s_^(^DD**rádio)#N	klub#N
radioluminiscence#N	radio_,a_,s_^(^DD**rádio)#N	luminiscence#N
radioléčba#N	radio_,a_,s_^(^DD**rádio)#N	léčba#N
radiomaják#N	radio_,a_,s_^(^DD**rádio)#N	maják#N
radiomateriál#N	radio_,a_,s_^(^DD**rádio)#N	materiál#N
radiomechanik#N	radio_,a_,s_^(^DD**rádio)#N	mechanik#N
radiometrie#N	radio_,a_,s_^(^DD**rádio)#N	metrie#N
radionahrávka#N	radio_,a_,s_^(^DD**rádio)#N	nahrávka#N
radionavigace#N	radio_,a_,s_^(^DD**rádio)#N	navigace#N
radionuklid#N	radio_,a_,s_^(^DD**rádio)#N	nuklid#N
radiopřehrávač#N	radio_,a_,s_^(^DD**rádio)#N	přehrávač#N
radiopřijímač#N	radio_,a_,s_^(^DD**rádio)#N	přijímač#N
radiorezistentní#A	radio_,a_,s_^(^DD**rádio)#N	rezistentní#A
radiosaturační#A	radio_,a_,s_^(^DD**rádio)#N	saturační#A
radiosignál#N	radio_,a_,s_^(^DD**rádio)#N	signál#N
radioskříňka#N	radio_,a_,s_^(^DD**rádio)#N	skříňka#N
radiostanice#N	radio_,a_,s_^(^DD**rádio)#N	stanice#N
radiosterilace#N	radio_,a_,s_^(^DD**rádio)#N	sterilace#N
radiosíť#N	radio_,a_,s_^(^DD**rádio)#N	síť#N
radiotaxi#N	radio_,a_,s_^(^DD**rádio)#N	taxi#N
radiotechnika#N	radio_,a_,s_^(^DD**rádio)#N	technika#N
radiotelegraf#N	radio_,a_,s_^(^DD**rádio)#N	telegraf#N
radiotelegraficky#D	radio_,a_,s_^(^DD**rádio)#N	telegraficky_^(*1ý)#D
radiotelegrafní#A	radio_,a_,s_^(^DD**rádio)#N	telegrafní#A
radiotelemetrie#N	radio_,a_,s_^(^DD**rádio)#N	telemetrie#N
radiotelevizní#A	radio_,a_,s_^(^DD**rádio)#N	televizní#A
radioterapie#N	radio_,a_,s_^(^DD**rádio)#N	terapie#N
radiotext#N	radio_,a_,s_^(^DD**rádio)#N	text#N
radiouhlík_;H#N	radio_,a_,s_^(^DD**rádio)#N	uhlík#N
radioulnární#A	radio_,a_,s_^(^DD**rádio)#N	ulnární#A
radiovlna#N	radio_,a_,s_^(^DD**rádio)#N	vlna#N
radiovybavení#N	radio_,a_,s_^(^DD**rádio)#N	vybavení_^(*3it)#N
radiovysílačka#N	radio_,a_,s_^(^DD**rádio)#N	vysílačka#N
radiovůz#N	radio_,a_,s_^(^DD**rádio)#N	vůz#N
radiozařízení#N	radio_,a_,s_^(^DD**rádio)#N	zařízení_^(*4dit)#N
radiožurnál_;R#N	radio_,a_,s_^(^DD**rádio)#N	žurnál#N
raketoplán#N	raketa#N	plán#N
reflexoterapie#N	reflex#N	terapie#N
rentgenometrie#N	rentgen#N	metrie#N
rentgenoterapie_;U#N	rentgen#N	terapie#N
reprobedna#N	repro#N	bedna#N
reprocentrum#N	repro#N	centrum#N
reprokamera#N	repro#N	kamera#N
reprotechnika#N	repro#N	technika#N
!respirogram#N	respir#N	gram#N
!respirometr#N	respir#N	metr#N
!rinovir#N	rin_;b_,t_^(měnová_jednotka)#N	vir#N
selenocentrický#A	selen#N	centrický#A
selenokyanatan#N	selen#N	kyanatan#N
selenouhličitan#N	selen#N	uhličitan#N
semenožravý#A	semeno#N	žravý#A
semitohamitský#A	semita#N	hamitský#A
sestrovrah#N	sestra#N	vrah#N
sestrovražedkyně#N	sestra#N	vražedkyně#N
sinusometr_;g#N	sinus#N	metr#N
sklokeramika#N	sklo#N	keramika#N
sklolaminát#N	sklo#N	laminát#N
sklomalba#N	sklo#N	malba#N
sklotextilní#A	sklo#N	textilní#A
sklovitráž#N	sklo#N	vitráž#N
sklovláknitý#A	sklo#N	vláknitý#A
službodárce#N	služba#N	dárce#N
spermobanka#N	sperma#N	banka#N
strukturogram#N	struktura#N	gram#N
struskovápenný#A	struska#N	vápenný#A
stálobarevný#A	stálý#A	barevný#A
stálozelený#A	stálý#A	zelený_;o#A
stínobytný#A	stín#N	bytný#A
stínoherní#A	stín#N	herní#A
stínohra#N	stín#N	hra_^(dětská;_v_divadle;...)#N
stínomalba#N	stín#N	malba#N
stínovládní#A	stín#N	vládní#A
!stěrkopísek#N	stěrka#N	písek#N
!střídmopažní#A	střídmý#A	pažní#A
svrchnokambrický#A	svrchní#A	kambrický#A
sylabotónický#A	sylaba_^(slabika)#N	tónický#A
sádrokartón#N	sádra#N	kartón#N
sádrovláknina#N	sádra#N	vláknina#N
síranouhličitý#A	síran#N	uhličitý#A
sírodusičnan#N	síra#N	dusičnan#N
síťocentrismus_,s_^(^DD**síťocentrizmus)#N	síť#N	centrismus_,s_^(^DD**centrizmus)#N
sólohráč#N	sólo#N	hráč#N
sólokampaň#N	sólo#N	kampaň#N
sólokapr#N	sólo#N	kapr#N
sólosměnka#N	sólo#N	směnka#N
sólovýstup#N	sólo#N	výstup#N
!technodiktatura#N	techno_^(hudební_styl)#N	diktatura#N
technofestival#N	techno_^(hudební_styl)#N	festival#N
technohudba#N	techno_^(hudební_styl)#N	hudba#N
technokultura#N	techno_^(hudební_styl)#N	kultura#N
!technopark#N	techno_^(hudební_styl)#N	park#N
!technoplast#N	techno_^(hudební_styl)#N	plast#N
technorytmus#N	techno_^(hudební_styl)#N	rytmus#N
technoscéna#N	techno_^(hudební_styl)#N	scéna#N
technosféra#N	techno_^(hudební_styl)#N	sféra#N
technotaneční#A	techno_^(hudební_styl)#N	taneční-1#A
technověda#N	techno_^(hudební_styl)#N	věda#N
!teleomatika#N	tele#N	matika_,l#N
tellurokyanatan#N	tellur#N	kyanatan#N
tellurouhličitan#N	tellur#N	uhličitan#N
!tentokrát#D	tent_,l_^(cirkusový_stan)#N	krát-2#D
tlakovzdušný#A	tlak#N	vzdušný#A
tracheobakterióza#N	trachea#N	bakterióza_^(choroba_rostlin)#N
tracheomykóza#N	trachea#N	mykóza#N
trafostanice#N	trafo#N	stanice#N
trinitronaftalen#N	trinitro#A	naftalen#N
trypsinogen_;H#N	trypsin#N	gen#N
typometrický#A	typ#N	metrický#A
tyranobijec#N	tyran#N	bijec#N
tyranotvůrce#N	tyran#N	tvůrce#N
tyranovražda#N	tyran#N	vražda#N
tělocvik#N	tělo#N	cvik#N
tělokresba#N	tělo#N	kresba#N
tělověda#N	tělo#N	věda#N
!tříbarvotisk#N	tříbarvý#A	tisk#N
!ultrakrátkovlnný#A	ultrakrátký#A	vlnný#A
umělohedvábný#A	umělý#A	hedvábný#A
umělokamenný#A	umělý#A	kamenný#A
umělovýživář#N	umělý#A	výživář#N
urinoterapie_;U#N	urin_;U#N	terapie#N
valvuloplastika#N	valvula_;U#N	plastika#N
!variometr#N	vari-1_;L#N	metr#N
!vazoparalytický#A	vaz#N	paralytický#A
veršomilec#N	verš#N	milec_,a#N
veřejnoprávní#A	veřejný#A	právní#A
veřejnosprávní#A	veřejný#A	správní_^(např._poplatek;_rada;_řád;...)#A
veřejnozaměstnanecký#A	veřejný#A	zaměstnanecký#A
vlastnoruční#A	vlastní_^(příslušný_k_něčemu)#A	ruční#A
vlastnoústní_,s#A	vlastní_^(příslušný_k_něčemu)#A	ústní#A
vlnobití#N	vlna#N	bití_^(*3ít)#N
vlnotuk#N	vlna#N	tuk#N
vnitroafghánský#A	vnitro#N	afghánský#A
vnitroafrický#A	vnitro#N	africký#A
vnitroalianční#A	vnitro#N	alianční#A
vnitroamerický#A	vnitro#N	americký#A
vnitroarabský#A	vnitro#N	arabský#A
vnitroasijský#A	vnitro#N	asijský#A
vnitrobanka#N	vnitro#N	banka#N
vnitrobrazilský#A	vnitro#N	brazilský#A
vnitrobuněčný#A	vnitro#N	buněčný#A
vnitrobřišní#A	vnitro#N	břišní#A
vnitrocírkevní#A	vnitro#N	církevní#A
vnitrodenní#A	vnitro#N	denní#A
vnitrodružstevní#A	vnitro#N	družstevní#A
vnitrofiremní#A	vnitro#N	firemní#A
vnitroislámský#A	vnitro#N	islámský#A
vnitroizraelský#A	vnitro#N	izraelský#A
vnitrojaderný#A	vnitro#N	jaderný#A
vnitroklimatický#A	vnitro#N	klimatický#A
vnitrolebeční#A	vnitro#N	lebeční#A
vnitroměstský#A	vnitro#N	městský#A
vnitroněmecký#A	vnitro#N	německý#A
vnitropalestinský#A	vnitro#N	palestinský#A
vnitroparlamentní#A	vnitro#N	parlamentní#A
vnitropartajní#A	vnitro#N	partajní#A
vnitroplicní#A	vnitro#N	plicní#A
vnitropražský#A	vnitro#N	pražský#A
vnitropsychický#A	vnitro#N	psychický#A
vnitropůdní#A	vnitro#N	půdní#A
vnitroredakční#A	vnitro#N	redakční#A
vnitroskandinávský#A	vnitro#N	skandinávský#A
vnitrostaveništní#A	vnitro#N	staveništní#A
vnitrostranický#A	vnitro#N	stranický#A
vnitrostruktura#N	vnitro#N	struktura#N
vnitrostátní#A	vnitro#N	státní#A
vnitrosudetský#A	vnitro#N	sudetský#A
vnitrotelevizní#A	vnitro#N	televizní#A
vnitrotělní#A	vnitro#N	tělní#A
vnitrovládní#A	vnitro#N	vládní#A
vnitrozaměstnanecký#A	vnitro#N	zaměstnanecký#A
vnitrozemní#A	vnitro#N	zemní#A
vnitrozemčan_,a#N	vnitro#N	zemčan_,a#N
vnitrozření_,s#N	vnitro#N	zření_^(*3ít)#N
vnitroústavní#A	vnitro#N	ústavní#A
vnitročeský#A	vnitro#N	český#A
vnitrořecký#A	vnitro#N	řecký#A
vnitrožilní#A	vnitro#N	žilní#A
vrubořezba#N	vrub#N	řezba#N
vzduchoelektrický#A	vzduch#N	elektrický#A
vzduchofiltrační#A	vzduch#N	filtrační#A
vzduchomechanický#A	vzduch#N	mechanický#A
!vzduchomil_,a#N	vzduch#N	mil_;b_,t_^(měnová_jednotka)#N
vzduchoplavba#N	vzduch#N	plavba#N
vzduchoprázdný#A	vzduch#N	prázdný#A
vzduchotechnika#N	vzduch#N	technika#N
vzduchotěsný#A	vzduch#N	těsný#A
vzduchoventilace#N	vzduch#N	ventilace#N
vzduchočistící#A	vzduch#N	čistící_^(*3it)#A
vápenatoalkalický#A	vápenatý#A	alkalický#A
vítězoslavit_:T_,a#V	vítěz#N	slavit_:T#V
vítězosláva#N	vítěz#N	sláva#N
!větroplachý_,s#A	větry_^(bolení_břicha)#N	plachý#A
!větroplavba_,a#N	větry_^(bolení_břicha)#N	plavba#N
!větroplavec_,a#N	větry_^(bolení_břicha)#N	plavec#N
!větroprašný_;L#A	větry_^(bolení_břicha)#N	prašný#A
všelikobarevný_,a#A	všeliký#A	barevný#A
zadnotřebaňský#A	zadní#A	třebaňský#A
zemitoalkalický#A	zemitý#A	alkalický#A
zemitoželeznatý#A	zemitý#A	železnatý#A
zkázověstný_,s#A	zkáza#N	věstný_,s#A
zpětnovazební#A	zpětný#A	vazební#A
zpětnovazebný#A	zpětný#A	vazebný#A
zpěvohra#N	zpěv#N	hra_^(dětská;_v_divadle;...)#N
zpěvoprůmysl#N	zpěv#N	průmysl#N
zvukomalba#N	zvuk#N	malba#N
zvukoměřictví#N	zvuk#N	měřictví#N
zvukoměřičství#N	zvuk#N	měřičství#N
zvukosled#N	zvuk#N	sled#N
zvukotechnik#N	zvuk#N	technik#N
zvukotechnika#N	zvuk#N	technika#N
zvukotěsný#A	zvuk#N	těsný#A
zvěrokruh#N	zvěr_,a#N	kruh#N
zvěrokupec_,a#N	zvěr_,a#N	kupec#N
zvěrolékař#N	zvěr_,a#N	lékař#N
zvěromalba_,s#N	zvěr_,a#N	malba#N
zvěromág#N	zvěr_,a#N	mág#N
západoafghánský#A	západ#N	afghánský#A
západoafrický#A	západ#N	africký#A
západoalpský#A	západ#N	alpský#A
západoalžírský#A	západ#N	alžírský#A
západoamerický#A	západ#N	americký#A
západoanglický#A	západ#N	anglický#A
západoargentinský#A	západ#N	argentinský#A
západoatlantský#A	západ#N	atlantský#A
západoaustralský#A	západ#N	australský#A
západobengálský#A	západ#N	bengálský#A
západoberlínský#A	západ#N	berlínský#A
západofinský#A	západ#N	finský#A
západofrancký#A	západ#N	francký#A
západofranský#A	západ#N	franský#A
západofríský#A	západ#N	fríský#A
západogermánský#A	západ#N	germánský#A
západogruzínský#A	západ#N	gruzínský#A
západoindický#A	západ#N	indický#A
západoirský#A	západ#N	irský#A
západoirácký#A	západ#N	irácký#A
západokanadský#A	západ#N	kanadský#A
západokarpatský#A	západ#N	karpatský#A
západokřesťanský#A	západ#N	křesťanský#A
západolibyjský#A	západ#N	libyjský#A
západomexický#A	západ#N	mexický#A
západonilský#A	západ#N	nilský#A
západoněmecký#A	západ#N	německý#A
západopacifický#A	západ#N	pacifický#A
západopennsylvánský#A	západ#N	pennsylvánský#A
západorumunský#A	západ#N	rumunský#A
západoruský#A	západ#N	ruský#A
západosaharský#A	západ#N	saharský#A
západosarajevský#A	západ#N	sarajevský#A
západosemitský#A	západ#N	semitský#A
západosibiřský#A	západ#N	sibiřský#A
západoslezský#A	západ#N	slezský#A
západosrbský#A	západ#N	srbský#A
západosúdánský#A	západ#N	súdánský#A
západotatranský#A	západ#N	tatranský#A
západotexaský#A	západ#N	texaský#A
západoturecký#A	západ#N	turecký#A
západoturkický#A	západ#N	turkický#A
západoukrajinský#A	západ#N	ukrajinský#A
západovenezuelský#A	západ#N	venezuelský#A
západovirginský#A	západ#N	virginský#A
západoíránský#A	západ#N	íránský#A
západočeský#A	západ#N	český#A
západočečenský#A	západ#N	čečenský#A
západočínský#A	západ#N	čínský#A
západořecký#A	západ#N	řecký#A
západořímský#A	západ#N	římský#A
západošvédský#A	západ#N	švédský#A
západošvýcarský#A	západ#N	švýcarský#A
závitořez#N	závit#N	řez#N
čistokrevný#A	čistý#A	krevný#A
čistosrdečný_,a#A	čistý#A	srdečný_^(př._pozdrav,_člověk)#A
!čtvrtodenní#A	čtvrt-2_^(čtvrtina)#N	denní#A
!čtyřkoruna#N	čtyřka#N	runa#N
řiťolezectví_,h#N	řiť#N	lezectví#N
!šestistoletý_,a#A	šestistý#A	letý#A
!šestiúhelníkovitý#A	šestiúhelník#N	vitý_^(*3ít)#A
škrtovláda_,h#N	škrt#N	vláda#N
špiónománie#N	špión#N	mánie#N
štěrkopísek#N	štěrk#N	písek#N
štěrkopísčitý#A	štěrk#N	písčitý#A
šéfkouzelník#N	šéfka_^(*2)#N	uzelník#N
železnatoželezitý_;H#A	železnatý#A	železitý#A
žezlovládný_,s#A	žezlo#N	vládný_,a#A
