Aachenová	Aachen
Aboriginka	Aboriginec
Absolut	absolutní
Acháj	Achaj
Adani	Adana
Adano	Adana
Admiral	admirál
Adrianova	Adrian
Adrián	Adrian
Aksamite	aksamit
Aksamít	aksamit
Alan	Alán
Alan	Alán
Albane	Albany
Albano	Albany
Albina	albína
Albino	albína
Alejo	alej
Alemán	Aleman
Alexandre	Alexandr
Alexandrovci	Alexandrov
Alexandrovič	Alexandrov
Alexandrovský	Alexandrov
Amazonia	Amazonie
Ambrozy	Ambroz
Ambrůz	Ambroz
Amina	amin
Amina	amin
Amine	amin
Anas	ananas
Andrejevský	Andrejev
Andrys	Andrýs
Anne	Anna
Anno	Anna
Antena	anténa
Antonik	Antoník
Antonínka	Antonín
Antonínov	Antonín
Ararat	arat
Archangelsko	Archangel
Argenti	Argentina
Aronin	aron
Arpad	Arpád
Atlante	Atlanta
Atletiko	atletika
Attica	attika
Augustine	Augustin
Augusto	August
Augustýnek	Augustýn
Augustýnka	Augustýn
Azerbajdžan	Ázerbajdžán
Azerbajdžán	Ázerbajdžán,Ázerbájdžán
Ašanink	Ašanin
Ašantsko	ašant
Baban	Babán
Babe	baba
Babe	baba
Babica	Babice
Babický	Babice
Babina	Babice
Babinec	Babice
Babiny	Babice
Babiná	Babice
Babičková	babičkovat
Bachora	bachor
Badyan	badyán
Bagdadí	Bagdád
Bagdádí	Bagdád
Bahmann	Bahman
Bakelite	bakelit
Balakovo	Balakov
Balaďa	balada
Balkan	Balkán
Balšan	Balšán
Ban	bán,báň
Banana	banát
Banovec	Bánovec
Barda	bard
Bardo	bard
Bardo	bard
Barin	Barina
Baroň	baron
Bartak	Barták
Bartolomějová	Bartoloměj
Barton	Bartoň
Bastardo	bastard
Batman	Batmanov
Bauda	baud
Baudo	baud
Bače	bača
Beate	beat
Bechyňa	Bechyně
Bednář	Bednár
Benak	Benák
Benin	Ben
Benát	Benátky
Beranov	beran
Bergenia	Bergen
Bergmann	Bergman
Berl	berle
Bermuda	Bermudy
Bermudez	Bermudy
Bernardo	bernardýn
Bernardy	bernardýn
Bernardí	bernardýn
Betonova	beton
Bezručka	Bezruč
Bezručko	Bezruč
Bečko	bečka
Beň	Ben
Bimbác	bimbat
Birte	Birt
Bizoň	bizon
Blabol	blábol
Blank	Blanka
Blanke	Blanka
Blatno	Blatný
Bledy	bledý
Bochníček	bochník
Bohdanovský	Bohdan
Bohuslavský	Bohuslav
Bohuslávková	Bohuslav
Bohuslávky	Bohuslav
Bojo	boj
Boleslavsko	Boleslav
Bondo	Bondy
Bondone	Bondy
Borodino	Borodin
Bosnay	Bosna
Bostone	Boston
Botana	botanika
Bořice	bořit
Bořita	bořit
Brahma	Bráhma
Brambory	brambor
Brandejský	Brandejs
Brandys	Brandýs
Brandýsko	Brandýs
Brdo	Brdy
Brito	Brit
Brtnička	brtník
Brtníky	brtník
Brtníček	brtník
Brunete	brunet
Brunát	brunátný
Brusnický	brusnice
Bránice	bránit
Brýl	brýle
Bubáček	bubák
Buchan	Buchanan
Buchar	Buchár
Buchář	Buchár
Budínka	Budín
Budínský	Budín
Bukovák	bukovat
Bulgakovová	Bulgakov
Bulíček	bulík
Bumbác	bumbat
Bumbálka	Bumbál
Bunia	Bunin
Buranov	buran
Burián	Burian
Burlák	burlak
Buráň	buran
Buďa	Buda
Bystřický	Bystřice
Bystřina	Bystřice
Bystřina	Bystřice
Bábá	bába,Bába
Běle	Běla
Bělovov	Bělov
Bělský	běl
Břevnice	břevno
Březiny	Březina
Bříza	Březa
Bříza	Březa
Carraro	Carrara
Casanová	Casanova
Ce	cé
Celestica	Celesta
Celestina	Celesta
Ceni	cena
Chalco	Chalch
Chalupný	chalupa
Chan	chán
Chan	chán
Charvat	Charvát
Charvátce	Charvát
Charvátek	Charvát
Charváty	Charvát
Chatt	chata
Chilina	Chile
Chlád	chlad
Chmelka	chmel
Chochole	chochol
Chrastice	Chrasta
Chrastina	Chrasta
Christian	Christián
Christiania	Christián
Chrobáček	chrobák
Chrástecko	Chrástek
Chrástecký	Chrástek
Chrástecký	Chrástek
Chvíla	chvíle
Chábera	Chabera
Chánov	chán
Cichlidae	cichlida
Cigan	Cigán
Cimbal	cimbál
Commodore	Commodor
Commodore	Commodor
Cuc	cucek
Cyrani	Cyrano
Cílka	cíl
Dacán	dacan
Dal	dál
Dalek	daleký
Dalmacie	Dalmácie
Dalmatinec	dalmatin
Danove	Dan
Dauphine	dauphin
Davidovič	Davidov
Dačický	Dačice
Dehtáře	dehtář
Diamantina	diamant
Dietrichsteinský	Dietrichstein
Digital	digitál
Dimitrovka	Dimitrov
Dimitrovo	Dimitrov
Divo	divý
Dlabáč	Dlabač
Dol	důl
Dolana	Dolany
Dolejší	Dolejš
Dolejší	Dolejš
Dolejší	Dolejš
Dolin	Dolina
Dolina	dolinář
Dolinek	doliňák
Domingos	Domingo
Dominick	Dominic
Donate	donace
Dostal	Dostál
Draháň	Drahan
Drobek	drobeček
Drozda	drozd
Drož	drožka
Druide	druid
Dual	duál
Ducati	ducat
Ducato	ducat
Duchač	Ducháč
Durán	Duran
Dynamite	dynamit
Dítě	dít
Dědice	dědina
Dříň	dřín
Eduardo	Eduard
Eliott	Eliot
Elite	elita
Elitka	elita
Empiria	empirie
Ergometrin	ergometrie
Eschauer	Schauer
Extréme	extrém
Eštok	štok
Falk	Falc,falc
Fausto	Faust
Femina	feminní
Ferrari	Ferrara
Ferrari	Ferrara
Ferraro	Ferrara
Fichte	Ficht
Fidelio	Fidel
Filipe	Filip
Filipína	Filipíny
Fiskali	fiskál
Fišera	Fišer
Fleky	flek
Florec	Florena
Florenc	Florencie
Florence	Florencie
Florencia	Florencie
Florenciin	Florencie
Florencio	Florencie
Florenský	Florena
Florent	Florentina
Florentin	Florentina
Florentino	Florentina
Florey	Florena
Floria	Florena
Floriano	Florena,Florian
Florin	Florena
Floriánek	Florian
Foltyn	Foltýn
Fontaine	fontána
Fontana	fontána
Fontana	fontána
Fontane	fontána
Fontani	fontána
Fotografia	fotografie
Frajerová	frajer
Franc	frank,Francie
Franca	Francie
Francaise	Francie
France	Francie
France	Francie
Franci	Francie
Francin	Francie
Francina	Francie
Francine	Francie
Francioni	Francie
Francis	Francie
Francisci	Francie
Francisco	Francie
Francisco	Francie
Francisko	Francie
Franck	frank,Francie
Francke	Francie
Franco	Francie
Franců	frank
Franců	frank
Franka	Franky,Franke,frank
Frankia	Franky
Frankie	Franke,Franky
Franko	Franky
Frantic	František
Frantice	František
Franče	Franke
Frick	Fric
Fryštak	Fryšták
Fryštácko	Fryšták
Fryštáček	Fryšták
Fára	fara
Galanta	galantní
Galante	galantní
Gale	Gal
Gale	Gal
Gale	Gal
Galera	galéra
Galicia	Galicie
Galicin	Galicie
Galileo	Galilea
Galileo	Galilea
Galileo	Galilea
Galén	Galen
Gamina	gamin
Gandhí	Gándhí
Gellnar	Gellner
General	generál
General	generál
Genova	gen
Geodézie	geodezie
Georgievský	Georgiev
Georgijev	Georgij
Gerlache	Gerlach
Germaina	Germain
Germaine	Germain
German	Germán
Gestvík	gesto
Gete	Get
Ghaní	Ghana
Ghání	Ghana
Gilk	Gil
Gira	giro
Glajchová	glajchovat
Grado	grad
Grafite	grafit
Granat	granát
Granite	granit
Greenville	Grenville
Gráf	graf
Gudžarátec	Gudžarát
Gulaš	guláš
Gumotextilka	gumotextil
Gurdžár	Gurdžar
Habánov	habán
Habáň	habán
Habřinka	habřina
Hajduček	hajdučit
Haját	hajat
Haldane	halda
Hale	hala
Hale	hala
Hanna	Hana
Harcovna	harcovat
Hare	Harare
Harmonit	harmonie
Hasištejnský	Hasištejn
Hastrmanová	hastrman
Haussman	Haussmann
Havraň	havran
Haňa	Hana,Haná
Heck	hec
Hecová	hecovat
Heine	Hein
Heini	Hein
Heino	Hein
Hejna	Hejnice,hejno
Hejný	Hejnice,hejno
Hekaté	hekat
Helene	Helena
Herman	Hermann
Hindustan	Hindustán
Hlavatý	hlava,Hlava
Hlemýždí	hlemýžď
Hlinice	Hlinka
Hlinička	Hlinka
Hlinky	Hlinka
Hlouček	hloučit
Hlubinka	hlubina
Hlučínský	Hlučín
Hnaník	hnanec
Hochmann	Hochman
Hodice	hodit
Hodinka	hodinkář
Hodonínka	Hodonín
Holaň	Holan
Holohlavy	holohlavý
Holán	Holan
Holáň	Holan
Honore	honor
Honoré	honor
Horka	horký
Horky	horký,Horka
Horký	Horka
Horne	horna
Hornice	horna
Horno	horna
Hornák	horňák
Hornát	hornatý
Horní	horna
Horník	Hornik
Horný	horna
Horný	horna
Horácko	Horác
Horňáček	horňák
Horšice	horšit
Hovora	hovor
Hovězí	Hověz
Hrabí	hrabě
Hrabětice	Hraběta
Hrach	hrách
Hradiský	Hradisko
Hrant	hrana
Hraník	hraničník
Hrdly	hrdlo
Hroněk	Hroník
Hrozek	Hroza
Hrušky	hruška
Hrácha	hrách
Hubay	huba
Hubna	hubnout
Hudecký	Hudec
Hudek	Hudec
Hulan	hulán
Hulánová	hulán
Humpoláková	humpolák
Hurbanovo	Hurban
Hust	hustý
Husár	husar
Hábr	habr
Háda	hádat
Háje	háj,Háj
Háy	Hay
Hérakleios	Hérakleitos
Hřebecký	hřebec
Hřebek	hřebec
Ignace	Ignác
Ignát	Ignác
Imam	imám
Imobilia	imobilie
Indonesie	Indonésie
Ionov	ion
Irene	Irena
Ischia	ischias
Ivič	Ivičič
Iván	Ivan
Ištvan	Ištván
Jablunka	Jablunkov
Janak	Janák
Jandák	Janda
Jary	jarý
Javorie	Javorin
Javorina	Javorin
Jedlí	jedle
Jelení	Jelena
Jelimán	jeliman
Jesenice	Jesenin
Jeseň	jesen
Jestřábka	jestřáb
Jestřábský	jestřáb
Jevišovicko	Jevišovice
Jihlavák	Jihlava
Jiranek	Jiránek
Jiřinský	jiřina
Jordan	Jordán
Jordan	Jordán
Jordan	Jordán
Joze	Joza
Juanův	Juan
Jude	Judea
Jugoslavie	Jugoslávie
Juliánka	Julián
Juliánov	Julián
Jungman	Jungmann
Juste	justice
Justo	Just
Justy	Just
Justyna	Justýna
Jíno	jíní
Jíně	jíní,jiný
Jůn	Jon
Kabonil	kabonit
Kadett	kadet
Kadár	Kádár
Kaine	Kain
Kajetan	Kajetán
Kajetánka	Kajetán
Kakata	kakat
Kalikst	Kalik
Kalin	Kalinin
Kalinec	Kalinin
Kalinič	Kalinin
Kaly	kalý
Kameno	Kamený
Kamení	Kamený
Kampan	kampaň
Kampelik	kampelička
Kampelík	kampelička
Kamča	Kamčatka
Kanaan	Kanaán
Kanal	kanál
Kanclíř	kancléř
Kannan	Kanaán
Kanoute	kanout
Kanáda	Kanada
Kapelní	kapelničit
Kapilárie	kapilára
Kaprálik	kaprál,Kaprál
Karmazin	Karmazín
Kaste	kasta
Kastilia	Kastilie
Kasáč	Kasák
Kat	kát
Kate	kat
Kateřinice	Kateřina
Kateřinky	Kateřina
Kati	kat
Katyně	Katyna
Kavalíř	kavalír
Kaván	Kavan
Kača	káča
Kača	káča
Kašparec	Kašpar
Kašparů	Kašpar
Kašparů	Kašpar
Kašperk	Kašper
Kašperka	Kašper
Kašperko	Kašper
Kašpersko	Kašper
Kaštanov	kaštan
Kerouack	Kerouac
Keňo	Keňa
Kikujo	Kikuj
Kirovský	Kirov
Klara	Klára
Klat	klát
Klatovák	Klatovy
Kleine	Klein
Kleine	Klein
Klepač	Klepáč
Klepetko	klepeto
Klimíček	Klimek
Klina	klinika
Kline	klinika
Klinka	klinkat
Kloboučky	klobouk
Klofát	klofat
Klokočí	klokoč
Kloos	Klos
Klouza	klouzat
Klár	Klára
Klát	klátit
Klášterka	klášter
Klášterský	klášter
Kmenský	kmen
Kníř	knír
Knězek	kněz
Kněžka	Kněž
Kobylá	kobyla
Kocan	Kocán
Kohak	Kohák
Kohoutice	kohoutit
Koky	koka
Kollar	Kollár
Kolovraty	kolovrat
Kolínský	Kolín
Kon	kůň
Konecký	konec
Konstanc	Konstantin
Konstanca	Konstantin
Konstance	Konstantin
Konstanco	Konstantin
Konstantinky	Konstantin
Konstantinov	Konstantin
Kopanič	kopaničář
Kopaničár	kopaničář
Kopačík	Kopač
Koptík	koptit
Kopáčik	Kopáč
Kopček	kopčit
Kopčík	kopčit
Koral	korál
Koral	korál
Korecký	korec
Kormoran	kormorán
Kosmo	kosmos
Kostelní	Kostelný
Kostka	kostkář
Kosířsko	kosíř
Kotlářová	kotlář
Kotnik	kotník
Kotor	Kotora
Kouk	kouč
Kovačič	Kovač
Kovařovice	Kovařovic
Kozak	kozák
Kozar	Kozár
Kočař	kočár
Kočič	Koč
Kočko	kočka
Kočí	Koč
Kočí	Koč
Koňák	koňak
Kořan	Kořán
Kořenice	kořen
Kořenov	kořen
Košat	košatý
Košicko	Košice
Košilka	košile
Košíky	Košík
Košínov	Košín
Košťal	košťál,Košťál
Košťálkov	košťál,Košťál
Košťálov	Košťál,košťál
Kožušnik	Kožušník
Kracik	Kracík
Krajský	kraj
Krajča	kraj
Krakovič	Krakov
Kral	král,Král
Kramár	Kramář
Krasosmutnění	krasosmutnit
Kraval	kravál
Krejcárek	krejcar
Kristi	Krist
Kristian	Kristián
Kristiania	Kristián
Kristiánov	Kristián
Kristýnek	Kristýna
Kriz	krize
Krizek	krize
Krosnař	krosnář
Krupár	krupař
Kruty	krutý
Krylovo	Krylov
Krystian	Krystián
Králové	Král,král
Krátká	krátký
Kráty	krátký
Kuban	Kubáň
Kubelice	Kubelík
Kubelik	Kubelík
Kubina	Kubin
Kubinský	Kubin
Kubičko	Kubič
Kubáč	Kubač
Kudlata	kudlat
Kudláč	Kudlák
Kumpan	kumpán
Kumšta	kumšt
Kundrat	Kundrát
Kuno	kuna
Kuno	kuna
Kupček	kupčit
Kupčík	kupčit
Kurdí	Kurd
Kuric	kurie
Kurka	okurka
Kušan	Kušán
Kvak	kvák
Kváč	kvák
Květnice	květena
Květy	květ,květena
Kálik	Kalik
Káto	kát
Kýček	kýč
Křemenice	Křemen,křemen
Křenov	Křen,křen
Křenovy	křen,Křen
Křepčík	křepčit
Křetínský	Křetín
Křivský	křivý,Křiva
Křivý	Křiva
Křižanov	Křižan
Křoví	Křovák
Křídla	křídlo
Křížko	kříž,Kříž
Křížová	Kříž,kříž
Kšíra	kšír
Lamini	lamino
Lane	lano
Laně	lano
Laokoón	Láokoón
Lasica	lasice
Laska	láska
Laska	láska
Latin	latina
Latini	latina
Latka	látka
Laudon	Laudonov
Laurinský	Laurin
Lawrenc	Lawrence
Lazár	Lazar
Laďa	Lada
Lebedev	Lebeda
Ledec	Ledeč
Ledek	Ledeč
Ledečko	Ledeč
Ledečky	Ledeč
Lednice	lednit
Ledvinov	Ledvina
Lele	lelek
Lene	Lena
Lene	Lena
Leon	Leona
Leonardo	Leonard
Leone	Leona
Leone	Leona
Leontin	Leontina
Leptač	leptat
Lepšík	lepšit
Leskovský	Leskov
Lesnice	lesnit
Letovy	letovat
Levy	levý
Levý	lev
Lhotky	Lhotka
Liana	liána
Liberal	liberál
Libertín	libertin
Liběchovky	Liběchov
Liechtensteinsko	Liechtenstein
Lind	Linda
Lindák	Linda
Lipiny	Lipina
Lisový	lis
Litecký	litec
Litoměřic	Litoměřice
Lnáře	lnář
Lombard	Lombardie
Lombardo	lombard,Lombardie
Lomnica	Lomnice
Lomnicko	Lomnice
Lonek	Loník
Loněk	Loník
Lorcy	Lorca
Loudát	loudat
Louky	louka
Loučky	Loučka
Love	lov
Lubinka	Lubina
Lubomíra	Lubomír
Lucian	Lucián
Lukavecko	Lukavec
Lukšik	Lukšík
Lupenice	lupenitý
Lusitánie	Lusitán
Lučenecko	Lučenec
Luží	Lužice
Láček	láčka
Líny	líný
Líní	líný
Líšno	Líšný
Macháč	Machač
Madian	madián
Madonna	Madona
Madras	Madrás
Magdalena	Magdaléna
Makovička	Makov
Makovský	Makov
Makový	Makov
Malecký	Malec
Malecí	Malec
Malik	Málik
Malin	malina
Malátný	Malát
Malínský	Malín
Mandl	mandle
Manka	manko
Marcia	Marcin
Marec	Marek
Marina	Maria
Marine	Maria
Marine	Maria
Marino	Maria
Marino	Maria
Marinák	mariňák
Markytánová	markytán
Marte	Mart
Marte	Mart
Martin	Martinov,Martín
Martine	Martin
Martini	Martin
Martino	Martin
Martins	Martin
Martinů	Martin
Marty	Mart
Martynov	Martyn
Martí	Mart
Marvan	Marván
Mary	máry
Masar	Masár
Matějek	Matějík
Maurj	Maurja
Mayo	May,Mao
Mazát	mazat
Mechová	mechovatý
Medica	Medina
Medicejský	Medicej
Medvědov	medvěd
Melvile	Melvill
Melč	Melk
Memorial	memoriál
Mero	Meroe
Merunka	meruňka
Merč	merk
Metal	metál
Meteora	meteor
Mezuláník	mezulán
Michalik	Michalič
Michalovce	Michalov
Michelangeli	Michelangelo
Micheline	Michelin
Milan	Milán
Milica	milice
Milický	milice
Milička	milice
Milovy	milice
Minas	Minos
Minaříček	Minařík
Mineral	minerál
Mino	mina
Minoos	Minos
Minářík	Minařík
Miron	Mironov
Mitač	Mitáč
Mithridates	Mithridatés
Mlynár	Mlynář
Mníchov	Mnichov
Mojžiš	Mojžíš
Mons	monský
Montána	Montana
Morrisson	Morrison
Mouline	Moulin
Mraz	mráz
Mária	Maria
Míla	míle
Mílka	míle
Míra	mír
Měchuřinka	měchuřina
Mělice	mělký
Mělka	mělký
Mělnice	Mělník,mělnit
Měňany	měňavý
Měřička	měřit
Najmann	Najman
Namibe	Namibie
Nardo	nard
Nate	Nat
Nate	Nat
Navarro	Navarra
Neckář	neckař
Nepal	Nepál
Nepilý	Nepil
Neptune	Neptun
Neptune	Neptun
Netolický	Netolice
Neurastenin	neurastenie
Nešťastný	nešťastník
Nice	Nick
Nicky	Nick
Nicky	Nick
Nikotina	nikotin
Niké	Nick
Nič	ničit
Nora	Nor
Nouza	nouze
Nova	nový
Novak	Novák
Novo	nový
Nádeníček	nádeník
Návara	Navara
Níké	Nick
Němčický	Němčice
Obruby	obruba
Oceánie	oceán
Oldřiš	Oldříš
Olin	Olina
Olive	Oliva,oliva
Oloví	olovo
Opal	opál
Opal	opál
Organ	orgán
Osex	sex
Osmanov	Osman
Osmin	osmina
Ostrovský	ostrov
Osum	Sum
Osvětimsko	Osvětim
Pakistán	Pákistán
Palace	palác
Palák	palác
Pandžáb	Paňdžáb
Panev	pánev
Panta	pantáta
Panta	pantáta
Pantani	pantáta
Pantano	pantáta
Papa	papá,papat
Pardubický	Pardubice
Partizan	partizán
Pascale	pascal,Pascal
Pascale	pascal,Pascal
Pavlič	Pavlov
Pechač	Pecháč
Pele	Pelé
Pennsylvanie	Pennsylvánie
Pensylvánie	Pennsylvánie
Penta	pentle
Perk	pero
Pestřice	pestřit
Petran	Petrán
Petráč	Petrák
Petráň	Petrán
Piava	Piave
Pilo	Pila,pila
Pitter	Piter
Pivonka	Pivoňka
Platini	platina
Platonov	Platon
Plavka	Plávka
Plechač	Plecháč
Plát	plátno
Pláň	plán
Pochylová	pochylovat
Podhoráček	podhorák
Podhájí	Podháj
Podolán	Podolan
Podzemník	podzemní
Podzemný	podzemní
Poděbrad	Poděbrady
Pokojov	pokoj
Poledna	poledne
Polík	políček
Políkno	políknout
Pomněnice	pomněnka
Pomněnkář	pomněnka
Poseidonia	Poseidon
Post	půst
Post	půst
Požar	požár,Požár
Prace	práce
Prat	prát
Pravy	pravý
Prochazka	Procházka
Propper	Popper
Prou	Proust
Pulc	pult
Pátík	pátek
Pávov	páv
Páč	páčit
Píca	píce
Píka	píča
Pískatý	pískat
Pěnka	pěna
Pětík	pětník
Přibyslavský	Přibyslav
Příčovy	příčit
Pšenica	pšenice
Quijote	Quijot
Rachmanin	Rachmaninov
Rachmanov	Rachmaninov
Radoň	radon
Radošiná	Radošin
Raděj	Radějov
Rakové	Rakovník
Rambouský	Rambous
Ramus	rámus
Rana	rána
Randa	Randák
Raná	rána
Rataje	rataj
Ratajský	rataj
Raymann	Rayman
Raýman	Rayman
Raňkov	Rankov
Relief	reliéf
Reto	ret
Rimbaudová	Rimbaud
Riva	Rive
Roberti	Robert
Roberto	Robert
Rohanov	Rohan
Rohový	rohovatý
Roháče	Roháč
Rojek	Rojík
Rojo	roj
Rokytá	Rokyta
Romanovov	Romanov
Rost	růst
Rubin	rubín
Rude	Ruda
Rudy	rudý
Rudá	Ruda
Ruse	rusý
Ruse	rusý
Rutin	rutina
Rybař	Rybář
Rychtová	rychtovat
Rytířsko	rytíř
Ryšava	ryšavý
Révay	réva
Sabine	Sabina
Sabini	Sabina
Sabinov	Sabina
Sabinský	Sabina
Sakramento	sakrament
Saky	sako
Sal	sál
Sal	sál
Salámí	salám
Samaritan	Samaritán
Samek	samec
Samos	Sámos
Samsonov	Samson
Sandra	Sandro
Sane	saně
Sano	saně
Santa	Santana
Santa	Santana
Santa	Santana
Saní	saně
Satir	satira
Schuman	Schumann
Sebastian	Sebastián
Sedlatý	sedlat
Sedlecký	Sedlec
Semice	semický
Seminole	Seminol
Sergijevský	Sergijev
Serpentine	serpent
Seňo	seno
Signal	signál
Silica	silice
Silone	silon
Silvestro	Silvestrov
Silvestrová	Silvestrov
Sisák	Sisa
Sitař	sitár
Sivák	Siva
Skala	skála,Skála
Skalica	Skalice
Skalický	Skalice
Skalička	Skalice
Skalnický	Skalník
Sklenár	Sklenář
Skrovnice	skrovný
Skupá	Skupa
Skutecký	skutek
Skyva	skýva
Skřivaň	skřivan
Skřínský	skříň
Slade	sladký
Slade	sladký
Slatiny	slatina
Slavonice	Slavonie
Slavoňov	Slavonie
Slavíček	slavík
Slezak	Slezák
Slonin	slon
Sloupský	sloup
Smek	smeč
Smet	smetí
Smets	smetí
Smolensko	Smolen
Smutny	smutný,Smutný
Sochora	sochor,Sochor
Solany	Solana
Solferino	Solferina
Soliman	Solimán
Solniční	solnice
Solár	solar
Sonata	sonáta
Sopko	sopka
Spinek	Spina
Spořice	spořit
Srní	Srník
Stalino	Stalin
Staněk	Staník
Stine	Stin
Stine	Stin
Straňánek	Straňan
Strnady	strnad
Stráňa	strana
Stráňan	Straňan
Studénky	Studénka
Stáník	Staník
Středozemě	středozemí
Střevlíček	střevlík
Střížov	stříž,Stříž
Sucháň	Suchan
Sultan	sultán
Svitava	Svitavy
Svéraz	svéráz
Svítkov	svítit
Světnica	světnice
Světnička	světnice
Světnov	světnice
Světí	svět
Sylvan	Sylván
Syrov	syrový
Sáde	Sádek
Sádecký	Sádek
Sák	sak
Sámara	Samara
Sání	saně
Sátí	sát
Sáňka	sáňkář
Sín	síň
Sísa	Sisa
Sítiny	sítina
Sítá	sítina
Sůva	sova,Sova
Tabáček	tabák
Tajo	taj
Tana	tank
Tano	tanout
Tanzánie	Tanzanie
Tara	tára
Taranová	taranovat
Tata	táta,Tate
Tata	táta,Tate
Tatce	Tate
Tatek	Tate
Tatár	Tatar
Tchan	tchán
Tela	tele
Telemarka	telemark
Teplický	Teplice
Tercier	tercie
Teren	terén
Terminalia	terminál
Tetovo	tetovat
Theodore	Theodor
Tichon	Tichonov
Tisá	Tisa
Titan	Titán
Total	totál
Trentini	Trentin
Trentino	Trentin,Trent
Trentino	Trentin,Trent
Trento	Trent,Trentin
Trenčínsko	Trenčín
Tristán	Tristan
Trojak	Troják
Trojna	trojka
Tune	tuna
Tuppy	tupý
Turbin	turbína
Turbine	turbína
Turner	turnér
Turský	Tursko
Tutt	tutový,Tutu
Tutty	tutový
Téra	tér
TýTý	týt
Týl	Tyl
Týle	týl
Týna	týn
Týne	týn
Týnec	týn
Týnice	týn
Těšínský	Těšín
Třebeč	Třebíč
Třebáň	Třebaň
Třebíčko	Třebíč
Třeštice	třeštit
Udeřice	udeřit
Ulický	ulice
Unička	unie
Urban	Urbán
Urbářová	urbář
Valenta	Valentýn,Valentina
Valente	Valentina
Valente	Valentina
Valente	Valentina
Valentia	Valentina,Valentin
Valentine	Valentina,Valentin
Valentine	Valentina,Valentin
Valentini	Valentina,Valentin
Valentino	Valentina,Valentin
Valníček	valník
Vane	vana
Varhaník	varhánek
Vartovna	vartovat
Veen	ven
Vegeta	vegetovat
Velenovy	Velen
Velkoněmecko	velkoněmec
Verbová	verbovat
Verlaine	Verlain
Vilno	vilný
Vilímeč	Vilím
Vinay	vina
Vinařice	vinařit
Vinklar	Vinklár
Vino	vina
Vino	vina
Virgina	Virginie
Virginia	Virginie
Viscontiové	Visconti
Vladimirovna	Vladimir
Vladimirovo	Vladimir
Vlasta	vlast
Vládek	vládný
Vokal	vokál,Vokál
Volan	volán
Vonica	vonice
Voslař	oslař
Vostruha	struha,ostruha
Vratislávka	Vratislav
Vrána	Vrana
Vráto	vrátit
Vulkan	vulkán
Vyškovský	Vyškov
Václavov	Václav
Václaví	Václav
Vála	Vala
Vítů	vít,Vít
Vítů	vít,Vít
Věnecký	věnec
Věnek	věnec
Vůjtěch	Vojtěch
Wait	Waits
Washingtonia	Washington
Washingtonians	Washington
Wellingtonia	Wellington
Westfálsko	Westfál
Westwoodowá	Westwood
Whitmann	Whitman
Zadin	zadina
Zajaroš	Jaroš
Zbožnice	zbožnit
Zdeňa	Zdena
Zdeňa	Zdena
Zdeňo	Zdena
Zenica	zenit
Zerzan	Zerzán
Zerzáň	Zerzán
Zlosyň	zlosyn
Zornice	zornit
Zuno	Zuna
Zykán	Zykan
Zábraní	Zábrana
Záhora	Záhor
Záhorí	Záhor
Záhoř	záhoří
Zátko	zátka
Závitkovský	závitka
Zítko	zíta
absolutný	absolutní
abstraktno	abstraktní
abstraktno	abstraktní
acetylen	acetylén
akacie	akácie
aktuář	aktuár
alan	Alán
albánsko	albánský
aligátoří	aligátor
alpínka	alpínkář
amalgovna	amalgovat
amina	amin
amino	amin
androidí	android
angolo	Angola
argentit	Argentina
arijský	árijský
arkebuzýr	arkebuza
aspirín	aspirin
atmosférik	atmosféra
automodelářství	automodelář
autooprava	autoopravář
baby	baba
baby	baba
bafuňářství	bafuňář
balvanování	balvan
balónovitý	balón
ban	bán,báň
bardo	bard
bat	bát
batman	Batmanov
bednárna	Bednár
benzen	benzín
benzen	benzín
benzin	benzín
beraniční	beranit
bernardýní	bernardýn
bezpáteřnatý	bezpáteřní
biootop	biotop
bitumenovaný	bitumen
blank	Blanka
blatnička	Blatnice
boliviano	Bolivián
bombarďáky	bombarďák
bootový	bootovat
borlandí	Borland
borůvkovo	borůvka
božkost	Božka
brahma	Bráhma
brdo	Brdy
brokařka	brokař
brýlky	brýle
buchar	Buchár
buchar	Buchár
bucharinec	Bucharin
bukureštský	Bukurešť
básnířství	básníř
bědák	běda
bělinový	Bělina
běličký	Bělov
bělo	Běla
bělorus	Bělorusko
břevnoví	břevno
březoví	březí
censurový	censurovat
charvátka	Charvát
chatt	chata
chetito	Chetita
chladno	chladnice
chlupáček	Chlupáč
cholerae	cholera
chrastice	Chrasta
chromitý	ochromit
chrásteček	Chrástek
chumelice	chumel
cibetčí	cibet
cliftonka	Clifton
cuc	cucek
cvičný	cvičit
cár	car
daimonion	Daimon
dalajláma	dalajlama
dalmatinec	dalmatin
dan	Dán
dan	Dán
darí	Dárí
dementia	dementi
denaturovna	denaturovat
desetiprstý	desetiprstový
desátníček	desátník
detektorářství	detektorář
determinizmus	determinismus
devítice	devítka
devětašedesátka	devětašedesátník
deziluzní	deziluze
diblíček	diblík,Diblík
diference	diferencovat
digitalin	digitál
diplomatiční	diplomatika
direktorář	direktor
diskotékovka	diskotéka
dispense	dispens
dispenze	dispenz
divinace	Divina
dol	důl
dolinatý	Dolina
doliňačka	doliňák
doosídlenec	dosídlenec
dosud	osud
dovolenkářka	dovolenkář
dribler	driblér
drobek	drobeček
drobíček	drobeček
dršťkář	dršťka
ducatý	ducat
dvojpremiér	dvojpremiéra
dvoulet	dvouletý
dírný	Dírná
dít	dítě
ekostratigrafie	stratigrafie
ekotoxikologie	toxikologie
električka	elektrický
elektroopravna	elektrooprava
eremita	Eremit
ergometrin	ergometrie
eter	éter
eurokomunismus	eurokomunizmus
exhibit	exhibovat
fabriční	fabrika
facetový	facetovat
falckrabě	falckrabí
fantaz	fantazie
fauní	fauna
fedosejevec	Fedosejev
fedrovní	fedrovat
fefrmincka	fefrmincový
feromagnetismus	feromagnetizmus
ferrari	Ferrara
figurina	figurína
filantropin	filantropie
filosofos	filosofie
filé	filc
finale	finále
finka	Fink
finálka	finále
fischeri	Fischer
fischerky	Fischer
fiála	Fiala,fiala
flemingovka	Fleming
flitrovávaně	flitrovat
flitrovávatelně	flitrovat
florencit	Florencie
florenus	Florena
florin	Florena
floriánský	Florian
fontani	fontána
formalizmus	formalismus
formař	forma
fotbál	fotbal
fotometricky	fotometrie
fousky	fous,Fous
franco	Francie
franko	Franky
freerider	freeride
freerider	freeride
frivolitkování	frivolita
fríska	Frísko
fundamentalizmus	fundamentalismus
galeje	galejní
galérie	galerie,galéra
generálie	generál
generálka	generál
generálsko	generál
genin	gen
geodézie	geodezie
gerlachy	Gerlach
giboně	gibon
glazovna	glazovat
gradovna	gradovat
granula	granule
granátit	granát
handle	Handl,handl
handle	Handl,handl
harcový	harcovat
harmonit	harmonie
havlovec	Havlov
hedváb	hedvábí
hermafrodití	hermafrodit
hezko	hezký
hnáta	hnát,Hnát,hnát
hodovna	hodovat
hodovní	hodovat
horní	horna
hospitální	hospital
hranostajník	hranostaj
hranostají	hranostaj
hromaďák	Hromada,hromada
hrubovat	ohrubovat
hrudovatý	hrudovat
hrudí	hrudovat
humanizmus	humanismus
hurtovnice	hurtovat
husto	hustý
hypostáze	hypostaze
intarzit	intarzie
intelový	Intel
inzulin	inzulín
izolacionizmus	neoizolacionizmus
jansenista	jansenita
jatka	jatky
jedinký	jediný
jednice	jednička
jednotvárný	zjednotvárnit
jemno	jemný
jeseň	jesen
jirchárna	jircha
jorkšírský	jorkšír
justy	Just
jár	Jar
kachlářství	kachlář
kalič	Kalik
kalorimetricky	kalorimetrie
kampán	kampan
kamzíče	kamzík
kariera	kariéra
karmazin	Karmazín
kartouzek	kartouza
kena	Keňa
keramikář	keramika
klempírna	klempíř
klepač	Klepáč
klinička	klinika
klubkovitý	klubko
klubky	klubko
klát	klátit
klátět	klátit,klát
kněží	Kněž
kognace	kognát
kometka	kometa
komiský	komise
komička	komika
kompenzovna	kompenzovat
komplementární	komplementář
komínovitý	komín
konga	Kongo
konga	Kongo
konkrétno	konkrétní
konstance	Konstantin
konstantan	konstanta,Konstantin
konstruktivizmus	neokonstruktivizmus
kontokont	konto
konvalinka	Konvalina
kopulové	kopulovat
korintka	Korint
korálky	korál,korálkář
korálkářství	korálkář
kosmo	kosmos
kosmopolit	kosmopolita,kosmopolitický
kosmopolitnost	kosmopolita
kotlař	kotlář
koučka	kouč
kočí	Koč
kočí	Koč
košťátkovávaně	košťátkovat
košťátkovávatelně	košťátkovat
kožedělnictví	kožedělný
krkatý	krkat
kroječek	Kroječ
krokodýlkovitý	krokodýl
kryptokomunismus	kryptokomunizmus
královehradecký	královéhradecký
králíče	Králík
králčin	Král,král
krát	krátký
krátecký	krátký
kuklice	kuklit
kyblíčkovávaně	kyblíčkovat
kyblíčkovávatelně	kyblíčkovat
kypřice	kypřit
kyselo	Kysela
kytára	kytara
káčko	káča
křehko	křehký
křivský	křivý,Křiva
křižný	Křiž
latino	latina
ledek	Ledeč
ledvinář	Ledvina
leone	Leona
leptač	leptat
leva	levý
levity	Levit
levno	levný
levno	levný
lhostejno	lhostejný
likérna	likérník
likérníček	likérník
liliputánče	lilipután
liliputí	liliput
limita	limit
limonádovka	limonáda
lino	linout
lobelin	lobelka
louč	Loučka
love	lov
luninec	Lunin
lysáček	Lysák
líhnař	líhňař
lůs	los
madonna	Madona
magneto	magnet
malorážný	malorážní
manažér	manažer
manažér	manažer
mandarin	mandarín
manganan	mangan
mangrove	mangrový
maně	Mání
marina	Maria
markrabě	markrabí
marmeládovna	marmeláda
martini	Martin
materiálno	materiál
mařice	mařit
medica	Medina
megalománie	megalomanie
meruňkovo	meruňka
metastáze	metastáza
mikrofišový	mikrofišovat
milička	milice
mindráček	mindrák
mini	Minos
minimonografie	monografie
minižáček	minižák
miškař	miškář
mláto	mlátit
mlékovitý	mléko
montanní	Montana
montánní	Montana
mozet	mozek
mufloně	muflon
multimiliardový	multimiliardář
multivitamin	multivitamín
máje	máj
mán	man
místy	místo
nabalíčkovávaně	nabalíčkovat
nabalíčkovávatelně	nabalíčkovat
nacionále	nacionální
nagana	Nagano
neandertalec	neandertálec
nekompetence	kompetence
neokonstruktivismus	konstruktivismus
neosocialismus	socialismus
neosurrealismus	surrealismus
neplodnost	zneplodnit
nepořádnost	nepořádník
neprůhlednost	zneprůhlednit
nepálsko	Nepál
nepřehlednost	znepřehlednit
nepříjemnost	znepříjemnit
nevděčnost	nevděčník
nezaměstnanost	nezaměstnaný
nezaměstnatelnost	nezaměstnaný
nezaměstnavatelnost	nezaměstnaný
nigero	Niger
nirvana	nirvána
nocležné	nocležna
nosálí	Nosál
notař	notář
nova	nový
novosymbolizmus	neosymbolizmus
nude	nuda
nápravnice	Nápravník
odhadné	odhadnout
odmalovávaně	odmalovat
odtučnět	odtučnit
oflitrovávaně	oflitrovat
oflitrovávatelně	oflitrovat
ohněstrojný	ohněstrůjný
oligarch	oligarchie
oliví	oliva,Oliva
oman	Omán
ooplazma	plazma
oosféra	sféra
orchestrovávaně	orchestrovat
orchestrovávatelně	orchestrovat
ordinární	ordinář
ordner	ordnér
osmačtyřicátiny	osmačtyřicátník
osmitisícový	osmitisícovka
ostatní	ostat
otecko	otec
ouředníček	Ouředník
ozub	zub
paleogeografie	paleografie
papaja	papája
par	pár
para	pára
para	pára
parte	part
pavláč	pavlač
pecnářství	pecnář
penicilin	penicilín
pension	pensionovat
penál	penále
penální	penále
perk	pero
piké	Pikt
piáno	piano
plantace	plantat
platinovo	platina
platnéřství	platnéř
plavka	Plávka
plejtvák	plejtvat
plocký	Ploc
pobočný	poboční
podhájí	Podháj
podpůrce	odpůrce
podsední	Podsedník
poflitrovávaně	poflitrovat
poflitrovávatelně	poflitrovat
pohodný	pohodnout
polypropylén	polypropylen
polypropylénový	polypropylen
popelna	popelka
popelčí	popelka
post	půst
post	půst
pozdní	Pozdník
pozitívní	pozitivní
pořád	pořad
prohibicionistický	prohibicionista
prohibitní	prohibice
projezd	průjezd
provazolezení	provazolezec
provozní	provoz
provozní	provoz
prsť	prst
prápor	prapor
psychično	psychika
psychotronička	psychotronika
puchýřka	puchýř
punc	punk
purkrabě	purkrabí
purpurový	purpur
pusta	pustý
pyrománie	pyromanie
pákistánsko	Pákistán
páže	paže
píárko	píár
póvlizovávaně	póvlizovat
póvlizovávatelně	póvlizovat
pěkno	pěkný
pětadevadesátka	pětadevadesátník
pětaosmdesátka	pětaosmdesátník
pětasedmdesátka	pětasedmdesátník
pětatřicátiny	pětatřicátník
pětačtyřicátiny	pětačtyřicátník
pětašedesátka	pětašedesátník
předčítač	předčítat
přenýtovávaně	přenýtovat
přenýtovávatelně	přenýtovat
přesilný	přesila
přešraňkovávaně	přešraňkovat
přešraňkovávatelně	přešraňkovat
přeštíhlý	štíhlý
přiblblo	přiblblý
pšenický	pšenice
radio	rádio
rajcovní	rajcovat
raubířina	raubíř
raubířství	raubíř
regália	regál
regálie	regál
religionostika	religionistika
remonstrace	remonstrant
representační	representace
roentgenka	Roentgen
roentgenův	Roentgen
rostlinolékářský	rostlinolékař
rozbroj	zbroj
rubato	rubat
rubikovka	Rubikov
rutin	rutina
rutinář	rutina
rychlomluvka	rychlomluva
ryšavo	ryšavý
ráno	rána
sacharina	sacharin
samaritan	Samaritán
samolepicí	samolepící
sanktusní	sanktusák
sebeobhajný	sebeobhajovat
sebeobnova	sebeobnovovat
sebeobnovení	sebeobnovovat
sebeobětovný	sebeobětovat
sebeodcizený	sebeodcizovat
sebeohrožení	sebeohrožovat
sebeorganizace	sebeorganizovat
sebeoslovení	sebeoslovovat
sebeospravedlnění	sebeospravedlňovat
sebeosvobození	sebeosvobozovat
sebeovlivnění	sebeovlivňovat
seberealizace	seberealizovat
sebereflektivní	sebereflektovat
sebestylizace	sebestylizovat
sebetrýznivý	sebetrýznitel
sebetrýznění	sebetrýznitel
sebeuzdravení	sebeuzdravovat
sebevyplnění	sebevyplňovat
sebezesměšnění	sebezesměšňovat
sebeztrapnění	sebeztrapňovat
sebezviditelnění	sebezviditelňovat
sedmapadesátka	sedmapadesátník
sekvoje	sekvoj
silický	silice
siliko	silika
singulare	singulár
sisál	sisal
skejťačka	skejťák
skulinatý	skulina
skřetí	skřet
sleď	sled
slinutý	slina
sociálno	sociální
solani	Solana
solník	solnice
sommeliérský	sommeliér
sorbový	sorbovat
souběžka	souběžný
souček	součin
special	speciál
spin	Spina
spinus	Spina
spolupůsobnost	spolupůsobit
spolutrpící	spolutrpitel
spolutrpící	spolutrpitel
srbochorvátský	Srbochorvat
staničník	Staník
statista	statistika
stehlíček	Stehlík
stolický	stolice
stotisíc	stotisící
strečový	strečovat
strůj	stroj
státo	stát,stát,stát
sumatrae	Sumatra
surovo	surový
surrealizmus	neosurrealizmus
surrrealismus	surrealismus
svatý	svat
svrchnice	svrchní
svrškař	svrškář
svědečný	svědek
symbolizmus	neosymbolizmus
synod	synoda
sítí	sít
sůva	sova,Sova
tajemnůstka	tajemnůstkář
tajtrlíček	tajtrlík
tata	táta,Tate
tatí	Tate,tát
temporálie	temporální
teriéří	teriér
termití	termit
teslo	Tesla
tetřeví	tetřev
thonetka	Thonet
tibeto	Tibet
titulka	titul
tradicionalisty	tradicionalistický
tragikomično	tragikomika
tresť	trest
trinitární	trinitář
triál	trial
troglodytsví	troglodyt
trojitý	trojice
trojí	trojice
trávař	tráva
trávníkářství	trávníkář
turbina	turbína
tuto	tutový,Tutu
tyl	týl
těžko	těžký
třasořitný	třasořitka
třiatřicátník	třicátník
třmení	třmen
uherskohradištský	uherskohradišťský
ulický	ulice
ultraformalizmus	ultraformalismus
unikát	unikat
upíří	upír
uranan	Uran
vagonka	vagonkář
vagonový	vagonovat
valencienka	Valencien
valenciánka	Valencián
valentýnování	Valentýn
valin	Valina
vat	vát
vazodilatace	vázodilatace
vazokonstrikce	vázokonstrikce
vedro	Vedra
vegeta	vegetovat
vegetárna	vegetář
vejměnek	vejměník
velkoagrární	velkoagrárník
velkošmelina	velkošmelinář
verbovné	verbovat
verbovní	verbovat
verbovní	verbovat
verbovní	verbovat
vesmíreček	vesmír
veverče	veverka
vinařina	vinařit
vincentka	Vincent
vino	vina
virginiana	Virginie
virginál	virginal
vitrina	vitrína
vitálný	vitální
vlasovitý	Vlasov
vlaštovče	vlaštovka
vlaštůvka	vlaštovka
vlásnice	vlásnička
vlídno	vlídný
vodoměrka	vodoměr
vopravit	dovopravit
vosel	osel
vraskatý	vraskat
vroucno	vroucný
vráně	vrána
vysmívač	vysměvač
vysádrovávaně	vysádrovat
vysádrovávatelně	vysádrovat
vysáňkovávaně	vysáňkovat
vzdušní	vzdušnice
vzorkovna	vzorkovat
vzpomínáček	vzpomínat
vzteky	vztek
vápenička	Vápeník,vápeník
váreční	várečný
véča	véčko
výjezdný	výjezda
výmětný	výmět
výstředný	výstřední
výtopný	výtopna
výzvuk	zvuk
větevnice	větev
větevní	větev
vřetení	vřeteno
wait	Waits
workholička	workholik
zaktuálnět	zaktuálnit
zamčitý	zamčít
zatravnatit	zatravnatět
zbankrotit	zbankrotět
zdrava	zdravý
zelenkův	Zelenkov
zenice	zenit
zextensivnět	zextensivnit
zhavranit	zhavranět
zhudebnět	zhudebnit
zkrutný	zkrutnout
zludařelý	zludařit
zludrařelý	zludrařit
zmaloměšťáčtělý	zmaloměšťáčtět
znamenavost	znamenat
znojný	znoj
znovuprojednání	znovuprojednat
znovuzalesňování	znovuzalesnit
zobkatý	zobkat
zplnomocník	zplnomocnit
zrost	Zrůst
zvostatní	zvostat
záhora	Záhor
záhumenec	záhumenka,záhumení
záhumenice	záhumení
záhumní	záhumení
záhvozdí	záhvozd
zákeří	zákeřný
zápecní	zápecník
zápřezka	přezka
zápůjčna	zápůjční
zástěnek	zástěna
zástění	zástěna
záškodné	záškodný
zřit	zřít
Ávila	Avila
ágama	agama
ájatolláh	ajatolláh
ážio	ažio
ústrojitý	ústroj
ústrojní	ústroj
ústrojí	ústroj
útulna	útulný
úžlab	úžlabí
Časta	častý
Čecháčková	čecháček
Čekanov	Čekan
Čelákovicko	Čelákovice
Čepek	čepec
Čepice	čepit
Černička	Černík
Černobýl	Černobyl
Černovcy	Černov
Černovka	Černov
Černíky	Černík
Černínsko	Černín
Černínský	Černín
Černíny	Černín
Černíč	Černík
Červenkov	Červenka
Červenkov	Červenka
Čtyřkoly	čtyřkolý
Čáslavský	Čáslav
čap	čáp
čapatý	čapat
časoměřický	časoměřič
černobýl	Černobyl
černooký	Černo
černočerno	Černo
červotočí	červotoč
čičina	čina
čtyřkolkář	čtyřkolkař
čtyřproud	čtyřproudý
ňádro	ňadro
Ředice	ředina
Řehnice	řehnit
Řevnice	řevnit
Řečický	Řečice
řevnice	řevnit
řevný	řevnit
Šah	šáh
Šan	Šanov
Šanca	šance
Šarovy	šarovat
Šašecí	šašek
Šebele	Šebela
Šerkov	šerka
Šibeník	šibenice
Šilhan	Šilhán
Šimo	Šima
Šimáně	Šima
Šira	širý
Škatula	škatule
Šlosár	Šlosar
Šošok	šok
Špagetka	špageta
Španěly	Španěl
Špendlíček	špendlík
Špicl	špice
Špiner	Špinar
Špitt	špice
Špitálka	špitál
Špitálsko	špitál
Špitálský	špitál
Štírek	štír
Štítina	štítit
Štítné	štítit
Štítný	štít,štítit
Štíty	štít,štítit
Štěno	štěně
Štěpánov	Štěpán
Štětice	štětina
Štětinský	štětina
Štětka	štětina
Štětsko	štět
Štětí	štět
Šuráň	Šuran
Švejkovský	Švejk
Švestková	švestka
Švihovsko	Švihov
Šíša	Šiša
šablonář	šablona
šacunk	šacuňk
šafránovitý	šafrán
šakalí	šakal
šarka	Šárka
šedobílo	šedobílý
šedohnědo	šedohnědý
šedošedý	šedý
ševcovna	Ševcov
šibenický	šibenice
školometný	školomet
šminka	šmink
šmrncovní	šmrnc
šmír	šmírař
šmíra	šmírovat,šmírař
šmírařina	šmírařit
španělsko	Španěl
špendličí	špendlík
špica	špice,špicl
špinka	Špina
šraňkovávaně	šraňkovat
štíře	štír
štětovka	štětina
šustí	Šust
švestkovo	švestka
švidratý	švidrat
švih	Švihov
švihovka	Švihov
šách	šach
šíša	Šiša
ťápa	ťápat
Žaluda	žaludek
Žalý	žalost
Žatecký	Žatec
Ždanová	Ždanov
Ždánov	Ždanov
Želí	želé
Žemla	žemle
Žertvy	žertva
Žeňa	žena
Žežulková	žežulka
Živič	živit
Živko	Živkov
žeberný	žebernatý
žemla	žemle
žengla	žengle
žernosek	Žernoseky
žernový	žernov
žežulkovatý	žežulka
žitnice	Žitný
žďářený	žďářit
