Abraham	Abrahám
Abrahám	Abraham
Alexandr	Alexandrov
Alexandrov	Alexandr
Alexej	Alexejev
Alexejev	Alexej
Almohada	Almohád
Almohád	Almohada
Andrej	Andrejs
Andrejs	Andrej
Anna	Annan
Annan	Annen,Anna
Annen	Annan
Astrachaň	astrachán
Augustin	Augustýn
Augustýn	Augustin
Babice	babit
Babák	baba
Babík	babičkovat,babit
Bantu	bantovat
Bardot	bard
Benák	Benátky
Benátky	Benák
Blatnice	blata,Blatný
Blatný	blata,Blatnice,bláto
Bob	nabob
Bombaj	bomba
Bond	Bondy
Bondy	Bond
Boudný	bouda
Brandejs	Brandýs
Brandýs	Brandejs
Brod	brodit
Brook	brok
Brooker	broker
Brunej	brunet
Buda	budovat
Bába	baba
Bárt	Bárta
Bárta	Bárt
Bíl	bílý,běl
Bój	bóje
Běla	Bělina,běl,Bělov
Bělina	Běla,běl,Bělov
Bělov	běl,Bělík,Bělina,Běla
Bělík	běl,Bělov
Břehov	břeh
Březa	bříza,březí
Chalupník	chalupa
Chrasta	chrastit
Cibula	cibule
Dan	Dán,daň
David	Davidov
Davidov	David,davidián
Dlabač	dlabat
Dolina	dolinář,doliňák
Dominic	Dominik
Dominik	Dominic
Drda	Drdák
Drdák	Drda
Drozdov	drozd
Duša	duše
Dán	Dan,daň
Dírná	díra
Fantomas	fantom
Fin	Fink
Fink	Fin
Florena	Florentina,Florian,Florencie
Florencie	Florentina,Florena
Florentina	Florena,Florencie
Florian	Florena
Francie	frank
Franke	Franky,frank
Franky	frank,Franke,frankismus
František	frank
Fric	Frič
Frič	Fric
Fryg	Frýg
Frýg	Fryg
Gajda	gajdy
Gal	Gál,gall
Gent	agent
Gota	Gott
Gott	Gota
Gál	Gal
Halič	halit,halit
Hana	Haná
Haná	Hana
Havaj	Havana
Havana	Havaj
Hašler	hašlerka
Hejnice	hejno
Helvét	helvet,helvít
Hispanie	Hispánie
Hispánie	Hispanie
Hlinka	Hlinsko
Hlinsko	Hlinka
Hlohov	hloh
Hora	horor,horna
Horka	horký
Horniak	Hornik
Hornik	Horniak
Hověz	hovězí
Hrab	hrabě
Hrabák	hrabat,Hrabánek
Hrabánek	Hrabák
Hron	Hroník
Hroník	Hron
Hroza	hrůza
Hvězdář	hvězda
Háj	hájit
Hřebeč	hřebec,hřebit,hřeb
Jan	Ján
Janoš	Jánoš
Java	Jáva
Jelena	jelenář,jelen
Jesenin	jesen
Jinek	jiný,jíní
Jirous	Jirout
Jirout	Jirous
Jiří	jiřina
Johan	johanita
Juda	judo
Jurač	Jurák
Jurák	Jurač
Ján	Jan
Jánoš	Janoš
Jáva	Java
Kamenec	Kamený
Kamený	Kamenec
Kanaán	kanec
Kasák	kasa,kasat
Kladno	kladný
Klimák	klima
Klusák	klusat
Klučov	klučit
Klíma	klima
Kohl	Kohlík
Kohlík	Kohl
Konstantin	konstanta
Kopač	Kopáč
Kopernik	Koperník
Koperník	Kopernik
Kopeč	kopec
Kopáč	Kopač
Korea	korec
Kosovo	kos
Kostelný	kostel
Kosák	kosa
Kovač	Kováč,kov
Kováč	Kovač,kov
Kozár	koza
Koč	kočí,kočka
Koňařík	koňařit
Kořista	kořist
Košice	Košík
Košík	Košice
Krakonoš	nakrakonošovat
Krejčík	krejčí
Krn	Krnov
Krnov	Krn
Král	Králík,Královák,Králik
Králik	Králík,Král,král
Královák	Králík,Král,král
Králík	Králik,Královák,Král,král
Krč	krk,krčit
Kuba	Kubák
Kubač	Kubák
Kubin	Kubín,Kubič
Kubič	kubík,Kubin
Kubák	Kuba,Kubač
Kubín	Kubin
Kuchar	Kuchár
Kuchyňa	kuchyně
Kuchár	Kuchar
Kunc	Kunka
Kunka	Kunc
Kysela	kyselý
Káraný	kárat
Křepela	křepelka
Křiva	křivý,Křivák,Křivan
Křivan	Křiva
Křivák	Křiva,křivý
Křiž	kříž,Kříž
Kříž	Křiž
Kůst	kost,košt
Laník	Láník
Laškov	laškovat
Lebeda	lebedit
Lena	len,Lenin
Lenin	lenit,len,Lena
Leona	Leontina
Leontina	Leona
Lepík	lepit
Letov	letovat
Levit	levý
Lhota	Lhotka
Lhotka	Lhota
Libye	Libý,libý
Libý	Libye
Litva	litec
Lobeč	lob
Lombardie	lombard
Lomič	lomit
Loos	los
Loučka	loučit,Loučný,louka
Loučný	loučit,Loučka,louka
Lucern	lucerna
Ludvík	Ludvíkov
Ludvíkov	Ludvík
Luženice	Lužice
Lužice	Luženice
Lyko	lýko
Lynch	Lynchov
Lynchov	Lynch
Láník	Laník,lán
Lízal	lízat
Lýd	Lýdie
Lýdie	Lýd
Magdalena	Magdaléna
Magdaléna	Magdalena
Magic	magie
Malát	malátný
Mann	man
Mansfeld	Mansfield
Mansfield	Mansfeld
Mao	May
Marathon	Marathón
Marathón	Marathon
Marek	Mareček
Mareček	Marek
Maria	Marija,Marie,mariáš
Marie	Maria
Marija	Maria
Marten	Martín,Martin,Martinov
Martin	Martinov,Martín,Marten
Martinov	Martin,Martín,Marten
Martín	Marten,Martin,Martinov
Masár	masař
Mater	mateř
May	Mao
Medek	medit
Medina	medit
Meliš	Melišík
Melišík	Meliš
Menšík	menšit,menšina
Michal	Michalov
Michalič	Michalovič
Michalov	Michalovič,Michal
Michalovič	Michalov,Michalič
Mikes	Mikis
Mikis	Mikes
Mikloš	Mikloško
Mikloško	Mikloš
Mikulič	Mikulík
Mikuláš	mikulášenec
Mikulík	Mikulič
Minos	minus,mina
Mináč	mina
Mitrov	Mitrovic
Mitrovic	Mitrov
Mnichov	mnich
Modra	modrý
Monet	moneta
Montana	montovat
Morava	Moravany,Moravsko
Moravany	Morava
Moravsko	Morava
Motýlek	motýl
Méd	med
Míla	míle
Mína	mina
Mělník	mělnit,mělký
Nat	vně
Nick	nit,nový
Nitran	nitrace
Nizozemsko	Nizozemí
Nizozemí	Nizozemsko
Nor	nora
Novák	nový
Oborný	Zborný,Voborný
Ola	Zola
Oset	Osetie,set,osev
Osetie	Oset
Ořechov	ořech
Pacifik	pacifikovat
Palata	Palau
Palau	Palata
Pan	pán
Panák	paňák
Papák	papá
Peck	pec,pecka
Perout	Peru
Peru	Perout
Petrarca	Petrarka
Petrarka	Petrarca
Petržela	petržel
Piave	piano
Placht	plachta
Plánka	plán
Poledník	poledne
Polena	poleno
Pop	op
Popel	popelka
Portugalsko	portugal
Provázek	provázet
Puk	puč
Pásek	pás,pást
Roger	Rogers
Rogers	Roger
Rojka	roj
Rol	role
Roman	Román,román,Romanov
Romanov	Roman,Román,román
Román	Roman,Romanov
Ruda	rudý
Rulík	rulička
Ráb	rab
Sadov	sadovník
Sandino	sandinista
Sardinie	sardinka,sardinkář
Scot	Scott
Scott	Scot
Severa	sever
Siva	sivý
Slanec	slanit
Slepička	slepičář
Slezsko	slez
Smola	smůla
Smíchov	smích
Soliman	Solimán
Solimán	Soliman
Spina	Spinoza
Spinoza	Spina
Srník	srnec
Stalin	Stalinov
Stalinov	Stalin
Stin	stín
Stone	stonek,stonat
Studený	stud,studit
Stříž	střiž
Sura	surový
Svatý	svat
Sviny	svině
Tate	tát,táta
Teka	tečka
Telč	tele
Titán	titan
Tomáš	Tomášov
Tomášov	Tomáš
Trent	Trentin
Trentin	Trent
Trenčan	Trenčín
Trenčín	Trenčan
Trnka	trn
Turan	Turánek
Turánek	Turan
Tutu	tutový
Tyl	týl
Tyr	Týr
Týr	Tyr
Urbán	urbánní
Val	válka
Valencien	Valencián
Valencián	Valentinián,Valencien
Valentin	Valentina,Valentinián,Valentýn
Valentina	Valentin,Valentýn
Valentinián	Valentin,Valencián
Valentýn	Valentin,Valentina
Vaník	Vaněk
Vaněk	Vaník
Vietnam	vietnamka
Vinklár	vinklář
Vlach	Vlachov
Vlachov	Vlach
Vladimir	Vladimír
Vladimír	Vladimir
Vlasov	vlas
Vlk	vlčit
Voborný	Oborný
Vocel	ocel
Voda	Vodák
Vodák	voda,Voda
Vondrouš	Vondruš
Vondruš	Vondrouš
Vrana	vrána,Vraný
Vraný	Vrana,vrána
Vrzák	vrzat
Váh	váha
Válek	válka
Vápeník	vápeničit,vápenět
Vína	víno
Věra	víra
Wahháb	wahhábita
Zapata	pata
Zborný	Oborný
Zdena	Zdeněk
Zdeněk	Zdena
Zimák	zima
Zita	zíta
Zlín	zlínět
Zmij	zmije
Zola	Ola
Zrůst	vzrůst
Zuckerman	Zuckermann
Zuckermann	Zuckerman
Zuza	Zuzák,Zuzana
Zuzana	Zuza
Zuzák	Zuza
Zábel	Ábel
Zámečník	zámečničit
Závora	závorář
Zázvora	zázvor
absolutní	zabsolutnit
aditivní	aditivovat
aditivovat	aditivní
agent	Gent
akce	akcie
akcie	akce
aktin	aktiv
aktiv	aktivní,aktin
aktivní	aktiv
aktualisovat	zaktualisovat
albín	albína
albína	albín
alkalisovat	zalkalisovat
amalgam	amalgám
amalgám	amalgam
amortisovat	zamortisovat
analysovat	zanalysovat,vyanalysovat
anténa	anténář
anténář	anténa
aranžér	aranžírovat
aranžírovat	aranžér
armatura	armaturář
armaturář	armatura
asimilovat	assimilovat
aspirin	aspirovat
aspirovat	aspirin
assimilovat	asimilovat
astrachán	Astrachaň
aut	auto
auto	aut
automatisovat	doautomatisovat,zautomatisovat
autorisovat	zautorisovat
avisovat	visovat
avízo	avízovat
avízovat	avízo
baba	Bába,bába,Babák
babit	Babice,Babík
babičkovat	Babík
babičkovatět	zbabičkovatět
bafunář	bafuňář
bafuňařit	bafuňář
bafuňář	bafunář,bafuňařit
balon	balonář
balonář	balon
banka	baňka,báň,bán
bantovat	Bantu
banální	banát
banán	banát
banát	banální,banán
bard	Bardot
baterie	baterkář
baterkář	baterie
batůžkařit	batůžkář
batůžkář	batůžkařit
bačkora	bačkorář
bačkorář	bačkora
baňka	banka
bekat	békat
benediktin	benediktýn
benediktýn	benediktin
beran	beranit
beranit	beran
bečka	bé
biobrambora	brambor
bipolarizovat	bipolární
bipolární	bipolarizovat
bit	bít
biřmovanec	biřmovat
biřmovat	biřmovanec
blata	Blatný,Blatnice
blb	blbý
blbý	blb
blyštit	blýštit,blyštět
blyštět	blyštit
bláto	Blatný
blýštit	blyštit
bob	nabob
bolševisovat	zbolševisovat
bomba	Bombaj
bouda	Boudný
brambor	biobrambora
briketa	briketář
briketář	briketa
brnkat	přebrnkat
brodit	Brod
brok	Brook
broker	Brooker
brunet	Brunej,brunátný
brunátný	brunet
buchtovatět	zbuchtovatět
budovat	Buda
buldok	buldočit
buldočit	buldok
bába	baba
bádat	nabádat
bán	báň,banka
báň	bán,banka
bé	bečka
békat	bekat
bílý	Bíl
bít	bit,bítník
bítník	bít
bóje	Bój
býk	býčit
býčit	býk
běl	Bělov,Bíl,Bělina,Bělík,Běla
bředat	vybředat,zabředat,rozbředat
břeh	Břehov
březí	Březa
bříza	Březa
censurovat	vycensurovat,zcensurovat,docensurovat,odcensurovat
centralisovat	zcentralisovat,docentralisovat
cesionář	cessionář
cessionář	cesionář
chalupa	Chalupník
chan	chán
charakterisovat	vycharakterisovat,zcharakterisovat
chat	chata
chata	chat
chlad	chladnice
chladnice	chlad
chlámat	vychlámat
chrastit	Chrasta
chrom	chróm
chroptit	chroptět
chroptět	chroptit
chroupat	chrupat
chrupat	chroupat
chróm	chrom
chvalořeč	chvalořečit
chvalořečit	chvalořeč
chán	chan
chřoupat	chřupat
chřupat	chřoupat
cibule	Cibula
ciselovat	vyciselovat
citron	citrón
citrus	citrusář
citrusář	citrus
citrón	citron
cvočkař	cvočkář
cvočkář	cvočkař
davidián	Davidov
daň	Dan,Dán
debrujár	debrujář
debrujář	debrujár
decentralisovat	přecentralisovat,dodecentralisovat
dehydrovat	rehydrovat
deka	dekovat
dekovat	deka
demobilisovat	domobilisovat
demokratisovat	zdemokratisovat
demoralisovat	zdemoralisovat
denunciovat	denuncovat
denuncovat	denunciovat
desorganisovat	zdesorganisovat
desátek	desátník
desátník	desátek
diferenciovat	diferencovat
diferencovat	diferenciovat
dimense	dimenze
dimenze	dimense
dispens	dispenz,dispensovat
dispensovat	dispens
dispenz	dispens
distanc	distance
distance	distanc
diversifikovat	zdiversifikovat,dodiversifikovat
dlabat	Dlabač
dmychat	dmýchat
dmýchat	dmychat
dna	dno
dno	dna
doautomatisovat	odautomatisovat,zautomatisovat,automatisovat
docensurovat	procensurovat,odcensurovat,censurovat
docentralisovat	zcentralisovat,centralisovat
dochutit	ochutit
docpat	procpat
dodecentralisovat	decentralisovat
dodiversifikovat	diversifikovat,zdiversifikovat
doinicialisovat	inicialisovat,odinicialisovat,zinicialisovat,nainicialisovat,rozinicialisovat
dokadit	kadit
doklimatisovat	odklimatisovat
dokládat	ukládat,kládat
dokonsumovat	prokonsumovat,konsumovat,přikonsumovat
dokrakonošovat	nakrakonošovat
dokrojit	okrojit
dokrvit	prokrvit
dokvítat	zkvítat
dole	důl
dolinář	Dolina
doliňák	Dolina
domejšlet	promejšlet,pomejšlet
domobilisovat	mobilisovat,pomobilisovat,omobilisovat,promobilisovat,zmobilisovat,zamobilisovat,demobilisovat
donormalisovat	pronormalisovat,normalisovat
doplítat	vyplítat,proplítat,zaplítat
doprovodit	vyprovodit
dopřádat	opřádat,zapřádat,upřádat,vypřádat
dosedat	posedat
dosignalisovat	signalisovat,odsignalisovat,zasignalisovat,prosignalisovat
dostabilisovat	stabilisovat,ustabilisovat,přistabilisovat,nastabilisovat
dostat	ostat
dostrukturalisovat	strukturalisovat,nastrukturalisovat
dostřihat	střihat,nastřihat,odstřihat
dostříhnout	stříhnout,nastříhnout,ustříhnout
dosychat	osychat,dosýchat,prosychat
dosynchronisovat	nasynchronisovat,usynchronisovat,přisynchronisovat,přesynchronisovat,sesynchronisovat
dosystematisovat	systematisovat,nasystematisovat,rozsystematisovat,přesystematisovat
dosystemisovat	systemisovat
dosýchat	dosychat,osýchat,prosýchat
dotýkat	protýkat
doufat	zoufat
dout	out,zout
dovalorisovat	valorisovat
dovaselinovat	vaselinovat,provaselinovat
dovitaminisovat	ovitaminisovat,vitaminisovat,odvitaminisovat
dovrtit	uvrtit
dovulkanisovat	zavulkanisovat,vulkanisovat
dovyšívat	zavyšívat
dovíjet	províjet
dočmuchat	pročmuchat,čmuchat
doškicnout	oškicnout
dredovatět	zdredovatět
drenovat	drénovat
drobet	drobit
drobit	drobet
drozd	Drozdov
drožka	drožkařit
drožkařit	drožka
družit	družička
družička	družit
drén	drénovat
drénovat	drén,drenovat
duše	Duša
dvojit	dvojí,dvojka
dvojka	dvojí,dvojkař,dvojit,dvojný
dvojkař	dvojka
dvojnásobek	dvojnásobit
dvojnásobit	dvojnásobek,násobit
dvojný	dvojí,dvojka
dvojí	dvojit,dvojka,dvojný
démon	démonie
démonie	démon
díra	Dírná
dít	dítě
dítě	dít
dědina	dědit
dědit	dědina
dřevosochat	dřevosochař
dřevosochař	dřevosochat
dštít	štít
důl	dole
elektron	elektronika
elektronika	elektron
expres	exprese
exprese	expres
fabrika	fabrikovat
fabrikovat	fabrika
fajfka	fajfkář,fajfkař
fajfkař	fajfkář,fajfka
fajfkář	fajfkař,fajfka
falsifikovat	zfalsifikovat
fanfaron	fanfarón
fanfarón	fanfaron
fantom	fantóm,Fantomas
fantóm	fantom
fara	fárat
fasit	fasovat
fasovat	fasit
faun	fauna
fauna	faun
fašírka	fašírovat
fašírovat	fašírka
fen	fén
fikce	fík
fil	filc
filc	fil
filosof	filosofie
filosofie	filosof
fintit	fintovat
fintovat	fintit
firnovatět	zfirnovatět
flitrovat	oflitrovat
flám	fláma
fláma	flám
fotografie	fotografovat
fotografovat	fotografie
frank	Franky,Francie,Franke,František
frankismus	Franky
fárat	fara
fén	fen
fík	fikce
gajdy	Gajda
galerie	galéra
gall	Gal
galéra	galerie
generalisovat	vygeneralisovat,zgeneralisovat
geomorfologie	morfologie
germanisovat	zgermanisovat
gesce	gesto
gesto	gesce
grad	gradovat
gradovat	grad
grafika	grafičit
grafičit	grafika
gubernie	gubernium
gubernium	gubernie
halda	haldař
haldař	halda
halit	Halič
halit	Halič
hamburger	hamburgr
hamburgr	hamburger
hanit	hanět
hanět	hanit
harmonie	harmonika
harmonika	harmonie
harmonisovat	zharmonisovat
hašlerka	Hašler
hec	hecovat
hecovat	hec
hejno	Hejnice
helvet	helvít,Helvét
helvít	helvet,Helvét
hendikepovat	hendikepový
hendikepový	hendikepovat
heroin	heroina
heroina	heroin
historisovat	zhistorisovat
hlad	hladit
hladit	hlad
hledat	hlédat
hloh	Hlohov
hlouček	hloučit
hloučit	hlouček
hlédat	zhlédat,hledat,vyhlédat
hníst	hnít
hnít	hníst
hobl	hoblina
hoblina	hobl
hodina	hodit,hodinkář
hodinkář	hodina
hodit	hodina
hokej	žokej
hora	horor,horna
horký	Horka,horor
horna	hornatý,hora,Hora
hornatý	horna,horňák
horolezec	horolezení
horolezení	horolezec
horor	hora,Hora,horký
horňák	hornatý
hospitant	hospitovat
hospitovat	hospitant
hospoda	hospodář
hospodář	hospoda
houpnout	zhoupnout,rozhoupnout
hovězí	Hověz
hoře	hořec
hořec	hořet,hoře
hořet	hořec
hrabat	Hrabák
hrabě	Hrab
hroch	hrot
hrot	hroch
hrůza	Hroza
humanisovat	zhumanisovat
hvozd	hvozdit
hvozdit	hvozd
hvězda	Hvězdář
háj	hájit
hájit	háj,Háj
hřeb	hřebec,Hřebeč
hřebec	Hřebeč,hřeb,hřebit
hřebit	hřebec,Hřebeč
industrialisovat	zindustrialisovat
inicialisovat	nainicialisovat,doinicialisovat,zinicialisovat,přeinicialisovat,rozinicialisovat,odinicialisovat
intendance	intendant
intendant	intendance
interna	interní,internovat
internovat	interna,interní
interní	interna,internovat
inventarisovat	zinventarisovat
jachtařit	zajachtařit
janičár	janičář
janičář	janičár
jelen	Jelena,jelenář
jelenář	Jelena,jelen
jesen	Jesenin
jet	jít
jiný	jíní,Jinek
jitro	jitřit
jitřit	jitro
jiřina	Jiří
johanita	Johan
jorkšír	yorkšír
judo	Juda
jíní	jiný,Jinek
jít	jet
kabonit	kabonět
kabonět	kabonit
kacéř	kacíř
kacíř	kacéř
kadet	kadit
kadit	dokadit,kadet
kakao	kakat
kakat	kakao
kampan	kampaň
kampaň	kampan
kanec	Kanaán
kapela	kapelničit
kapelničit	kapela
kapitalisovat	zkapitalisovat
kapitál	kapitála
kapitála	kapitál
kapuca	kapuce
kapuce	kapuca
karban	karbanit
karbanit	karban
karbon	karbonář
karbonát	karbonář
karbonář	karbonát,karbon
kasa	Kasák,kasat
kasat	Kasák,kasa
kat	kát
katalogisovat	zakatalogisovat,zkatalogisovat
kaštan	kaštanář
kaštanář	kaštan
kladný	Kladno
klasicisovat	zklasicisovat
klasika	klasikář
klasikář	klasika
klavír	klavírník
klavírník	klavír
kleč	klečet
klečet	kleč
klid	klidit
klidit	klid
klihovatět	zklihovatět
klima	Klimák,Klíma
klimatisovat	zaklimatisovat,překlimatisovat
klinika	klinkat
klinkat	klinika
klon	klonit
klonit	klon
klopotit	naklopotit
klub	klubko
klubko	klub
klusat	Klusák
klučit	Klučov
kláda	kládat
kládat	kláda,dokládat,zakládat
klát	klátit
klátit	klát
klín	klínit
klínit	klín
kmen	kmín
kmotrovatět	zkmotrovatět
kmín	kmen
kolona	kolonie
kolonie	kolona
kolonisovat	zkolonisovat
kompars	komparz
komparz	kompars
komprese	kompresovat
kompresovat	komprese
kompromis	kompromisník
kompromisník	kompromis
komunismus	komunita
komunita	komunismus
konat	konec
kondensovat	zkondensovat
konec	konat
konfekce	konfekcionář
konfekcionář	konfekce
konkretisovat	zkonkretisovat
konkrétní	zkonkrétnit
konservovat	zakonservovat,zkonservovat
konstanta	Konstantin
konstruktivismus	konstruktivistický
konstruktivistický	konstruktivismus
konsumovat	dokonsumovat,vykonsumovat,prokonsumovat
kontinuovat	kontovat
konto	kontovat
kontovat	konto,kontinuovat
kontoár	kontura
kontrakt	kontrast
kontrast	kontrakt
kontura	kontoár
konzervativní	zkonzervativnět
kopa	kopí
kopec	Kopeč
kopie	kopit
kopit	kopie
kopt	koptit
koptit	kopt
kopí	kopčit,kopa
kopčit	kopí
kora	kůra
korec	Korea
korekce	korektní
korektní	korekce
korepetitovat	korepetovat
korepetovat	korepetitovat
korál	korálkář
korálkář	korál
kos	Kosovo,kosý
kosa	kosý,Kosák
kosmopolita	kosmopolitický
kosmopolitický	kosmopolita
kost	Kůst,košt
kostel	Kostelný
kosý	kosa,kos
kov	Kováč,Kovač
koza	kozák,Kozár
kozák	koza
kočka	Koč
kočí	Koč
koňařit	Koňařík
kořist	Kořista
koš	rozkoš
košt	koště,kost,Kůst
koště	košt
krakat	krákat
krejčí	Krejčík
krepatět	zkrepatět
kritisovat	zakritisovat
krk	Krč
krkat	vykrkat
krojit	okrojit
krok	kročit
krosna	krosnář
krosnář	krosna
kročit	krok,nakročit
krystalisovat	vykrystalisovat
krákat	krakat
král	Králík,Královák,Králik
krása	krást
krást	krása
kráter	krátký
krátký	kráter
krčit	Krč
kubík	Kubič
kuchyně	Kuchyňa
kulisa	kulisář
kulisář	kulisa
kur	kura
kura	kur
kvačit	kvák
kvák	kvačit
květ	květena
květena	květ
kyselý	Kysela
kánoe	kánon
kánon	kánoe
kára	kárat
kárat	Káraný,kára
kát	kat,káva
káva	kát
křapat	křápat
křepelka	Křepela
křeč	křeček
křeček	křeč
křivý	Křiva,Křivák
křápat	křapat
kříž	Křiž
kůr	kůra
kůra	kůr,kora
lahev	láhev
lakýr	lakýrna
lakýrna	lakýr
lata	látka,latina
latina	lata
lavice	lavina
lavina	lavice
laškovat	Laškov
lebedit	Lebeda
legie	legovat
legovat	legie
lehkomyslný	zlehkomyslnět
len	Lenin,Lena
lenit	Lenin
lepit	Lepík
leptat	leptař
leptař	leptat
letovat	Letov,letět
letět	letovat
lev	levý
levný	levý
levý	lev,Levit,levný
libý	Libye
lid	lidnit
lidnit	lid
likvida	likvidovat
likvidovat	likvida
likér	likérník
likérník	likér
lilek	lilie
lilie	lilek,liliář
liliář	lilie
linkař	linkařit
linkařit	linkař
litec	litice,Litva
litice	litec
lob	Lobeč
lombard	Lombardie
lomit	Lomič
los	losos,Loos
losos	los
louh	louže
louka	Loučka,Loučný
loutka	loutna
loutna	loutka
loučit	Loučka,Loučný
louže	louh
lucerna	Lucern
lupenitý	lupenka
lupenka	lupenitý
láce	látka,láčka
láhev	lahev
lán	Láník
lát	látka,látat
látat	lát
látka	lata,lát,láce
láčka	láce
lék	léč
léč	lék
líhat	líhnout,vylíhat
líhnout	líhat,líhňař
líhňař	líhnout
línat	líný
líný	línat
lípa	lípat
lípat	lípa
lít	lítý,líto
líto	lítý,lít
lítý	lít,líto
lízat	Lízal
lýko	Lyko
magie	Magic
malátný	Malát
man	Mann
mandant	mandát
mandl	mandle
mandle	mandl
mandát	mandant
mariáš	Maria
masa	maso
masař	Masár
masiv	masív
maso	masa
mast	mást
masív	masiv
mateř	Mater
mech	mechovatý
mechanisovat	zmechanisovat
mechovatý	mech
med	Méd
medicina	medicína
medicína	medicina
medit	Medina,Medek
menšina	menšit,Menšík
menšit	Menšík,menšina
merk	merčit
merčit	merk
metalika	metalista
metalista	metalika
mezinárodní	zmezinárodnit
meč	míč
mikulášenec	Mikuláš
mimika	mimikry
mimikry	mimika,mimino
mimino	mimikry
mina	minuta,Mináč,Mína,minus,Minos
minus	Minos,mina
minuta	mina
mnich	Mnichov
mnohonásobek	zmnohonásobit
mobilisovat	namobilisovat,vymobilisovat,domobilisovat,zamobilisovat,přemobilisovat,pomobilisovat,zmobilisovat,omobilisovat,promobilisovat
modernisovat	zmodernisovat
modrý	Modra
mok	moč
moneta	Monet
monopolisovat	zmonopolisovat
montovat	Montana
morfologie	geomorfologie
motorisovat	zmotorisovat
motýl	Motýlek,motýlkář
motýlkář	motýl
moč	mok
mrcasatit	mrcasatět
mrcasatět	mrcasatit
multiprogram	multiprogramovat
multiprogramovat	multiprogram
mánie	mánička
mánička	mánie
mást	mast
míle	Míla,mělký
mír	mířit
mísa	mísit
mísit	mísa,místo
místo	mísit
míč	meč
mířit	mír
mýt	mýto
mýto	mýt
mělký	míle,Mělník
mělnit	Mělník
městnat	zaměstnat
nabahňovat	pobahňovat
nabob	bob,Bob
nabádat	bádat
nacensurovat	zacensurovat
nachcat	přechcat
nadbíhat	podbíhat,odbíhat
nadcházet	podcházet
nadlábnout	vydlábnout
nadzdvihat	nazdvihat
nainicialisovat	inicialisovat,doinicialisovat,zinicialisovat,přeinicialisovat
naklopotit	klopotit
nakolejit	vykolejit
nakrakonošovat	dokrakonošovat,Krakonoš
nakročit	zakročit,kročit
nalétat	nalétnout
nalétat	nalétnout
nalétnout	nalétat,nalétat
namobilisovat	mobilisovat,pomobilisovat
napchat	zapchat
napodobit	zpodobit,vypodobit
napomínat	zapomínat,opomínat
napřahat	vypřahat,zapřahat
naschránit	uschránit,schránět
naskýtat	skýtat
nasmrádnout	vysmrádnout
nastabilisovat	stabilisovat,zastabilisovat,ustabilisovat,dostabilisovat,přistabilisovat
nastehnout	zastehnout
nastrukturalisovat	strukturalisovat,dostrukturalisovat,zastrukturalisovat
nastýlat	zastýlat
nastřihat	střihat,zastřihat,dostřihat
nastříhnout	stříhnout,ustříhnout,přestříhnout,zastříhnout,dostříhnout
nasynchronisovat	usynchronisovat,dosynchronisovat,přisynchronisovat,přesynchronisovat,sesynchronisovat
nasystematisovat	systematisovat,dosystematisovat,přesystematisovat
naturalisovat	znaturalisovat
naturismus	turismus
navaselinovat	vaselinovat
navitaminisovat	vitaminisovat,zvitaminisovat
navlhat	zavlhat
nazdvihat	nadzdvihat
nazvedat	zvedat
načrtat	črtat
načít	začít,začít,začít
naškicnout	oškicnout
negativní	znegativnět
nervóznit	znervóznět
neutralisovat	zneutralisovat
nit	nový,Nick,nítit
nitrace	Nitran
nobilis	nobilisovat
nobilisovat	nobilis,znobilisovat
nora	Nor
normalisovat	donormalisovat,přenormalisovat,pronormalisovat,znormalisovat
novinařit	vinařit
nový	Novák,nit,Nick
nuda	nudle
nudle	nuda
národohospodář	vodohospodář
násobit	dvojnásobit
nítit	nit
oblbit	zblbit
ocel	Vocel
ochládat	prochládat
ochutit	dochutit,přichutit
odautomatisovat	zautomatisovat,doautomatisovat
odbíhat	podbíhat,nadbíhat
odcensurovat	zcensurovat,docensurovat,censurovat,vycensurovat
odcukernit	vycukernit
odcírkevnit	zcírkevnit
odestýlat	podestýlat
odestřít	podestřít
odinicialisovat	doinicialisovat,rozinicialisovat,inicialisovat,zinicialisovat
odjednoznačnit	zjednoznačnit
odklimatisovat	doklimatisovat
odlistit	zalistit
odlétnout	podlétnout
odmobilisovat	omobilisovat,vymobilisovat
odplevelit	plevelit
odprdelit	vyprdelit
odprůmyslnit	zprůmyslnit,zprůmyslnět
odpínat	podpínat
odpřahat	vypřahat
odpřírodnit	zpřírodnit
odrat	prodrat
odsignalisovat	signalisovat,dosignalisovat
odstředit	středit
odstřihat	dostřihat
odtínat	podtínat
odundat	zadundat,vydundat
oduševnit	produševnit,zduševnit
odvitaminisovat	ovitaminisovat,dovitaminisovat,zvitaminisovat
oficiál	oficiální
oficiální	oficiál
oflitrovat	flitrovat,poflitrovat
okrojit	dokrojit,prokrojit,krojit
okrouhnout	zkrouhnout
okrvavit	zkrvavit
okysličit	prokysličit
omdlet	zmdlet
omobilisovat	umobilisovat,promobilisovat,zmobilisovat,odmobilisovat,domobilisovat,zamobilisovat,mobilisovat
omrzat	promrzat
omráčit	zmráčit
omítat	promítat
onikat	vnikat,unikat,pronikat
op	Pop,pop
oploštit	zploštit,sploštit
oploštět	zploštět
opláchnout	pláchnout,propláchnout,vypláchnout,spláchnout
opláknout	upláknout
oplítat	proplítat,uplítat,zaplítat
opomínat	napomínat,zapomínat
oponovat	proponovat
oprostit	zprostit,zprostit,vyprostit
optimalisovat	zoptimalisovat
opylit	zapylit
opál	opálka
opálka	opál
opřádat	zapřádat,upřádat,dopřádat,vypřádat,rozpřádat,spřádat
orace	orat
orat	orace
ordinovat	ordinář
ordinář	ordinovat
orodovat	orodovník
orodovník	orodovat
osa	vosa
osev	Oset
ostat	dostat
ostruha	struha
osud	sud
osychat	dosychat,prosychat,osýchat,přisychat,sesychat,rozsychat
osýchat	dosýchat,prosýchat,osychat,usýchat
otep	tep
otipnout	tipnout
otleskat	tleskat
otrsat	trsat
out	dout,zout
ovadat	uvadat
oves	ves
ovitaminisovat	dovitaminisovat,vitaminisovat,odvitaminisovat,přivitaminisovat,zvitaminisovat
ozdravět	zdravět
očurat	čurat
ořech	Ořechov
oškicnout	doškicnout,naškicnout,přeškicnout
ošklíbat	pošklíbat,ušklíbat
ošpláchnout	vyšpláchnout
oťupat	ťupat,poťupat
ožvykovat	požvykovat
pacifikovat	Pacifik
paleničář	páleničář
pan	pán
panorama	panoráma
panoráma	panorama
papat	papá
papá	papat,papája,Papák
papája	papá
parafin	parafín
parafín	parafin
paralysovat	zparalysovat
parazit	parazitit
parazitit	parazit
part	parta
parta	part
paráda	parádovat
parádovat	paráda
pas	pás,zápas
pasivní	pasivovat
pasivovat	pasivní
past	pást,pasta
pasta	past,pastvit
pastvit	pasta
pata	Zapata
patro	patrona
patron	patrona
patrona	patron,patro
paňák	Panák
pažit	vypažit
pec	Peck
pecka	Peck
pendl	pendlovat
pendlovat	pendl
persiflovat	zpersiflovat
pestřit	zpestřit
petržel	Petržela
piano	Piave
pikantní	zpikantnit
pindat	rozpindat
placatý	plácat
plachta	Placht
plakat	plakát
plakát	plakat
plasknout	splasknout
platina	platit
platit	platina
plevelit	odplevelit
plečka	plečkař
plečkař	plečka
plynit	zplynět
plácat	placatý
pláchnout	vypláchnout,opláchnout,propláchnout
plán	Plánka
plát	plátno
plát	plátno
plátno	plát,plát
pobahňovat	nabahňovat
pocpat	procpat
podbíhat	nadbíhat,odbíhat
podcházet	nadcházet
podestýlat	odestýlat
podestřít	odestřít
podloudničit	podloudný
podloudný	podloudničit
podlétnout	odlétnout,podlétávat
podlétávat	podlétnout
podpínat	odpínat
podsada	podsadit
podsadit	podsada
podtínat	odtínat
poflitrovat	oflitrovat
pokatoličit	pokatoličtit
pokatoličtit	pokatoličit
polarisovat	zpolarisovat
pole	polní
poledne	Poledník
polemisovat	zapolemisovat
poleno	Polena
police	policie,políček
policie	police
polní	pole
polétat	zapolétat
políček	police
pomejšlet	domejšlet
pomník	pomníkář
pomníkář	pomník
pomobilisovat	mobilisovat,domobilisovat,namobilisovat,zmobilisovat
ponoukat	poňoukat
pop	op
popel	popelka
popelka	Popel,popel
popularisovat	zpopularisovat
populární	zpopulárnit
portugal	Portugalsko
posedat	dosedat
pospíchat	spíchat
postupný	postupář
postupář	postupný
posunek	posuněk
posuněk	posunek
pozapomínat	zapomínat
pozemek	pozemský
pozemský	pozemek
pozápadnit	pozápadnět
pozápadnět	pozápadnit
pozřít	zřít
poňoukat	ponoukat
pošklíbat	ošklíbat
pošťouchat	šťouchat
poťupat	oťupat,ťupat
požitkařit	požitkář
požitkář	požitkařit
požvykovat	ožvykovat
pradlář	prádlař
prahnout	zapráhnout
praskat	práskat
pravděpodobný	zpravděpodobnit
pravovárečný	právovárečný
praštit	praštět
praštět	praštit
precisovat	zaprecisovat,vyprecisovat
premiér	premiéra
premiéra	premiér
procensurovat	docensurovat
prochládat	ochládat
procpat	pocpat,docpat
prodrat	odrat
produchovnit	produchovnět
produchovnět	produchovnit
produševnit	oduševnit
profesionalisovat	zprofesionalisovat
progres	progrese
progrese	progres
prokonsumovat	dokonsumovat,přikonsumovat,rozkonsumovat,konsumovat
prokrojit	okrojit
prokrvit	dokrvit
prokysličit	okysličit
promejšlet	domejšlet
promobilisovat	omobilisovat,zmobilisovat,umobilisovat,rozmobilisovat,domobilisovat,mobilisovat
promrzat	omrzat
promykat	promýkat
promítat	omítat
promýkat	promykat
pronikat	onikat
pronormalisovat	donormalisovat,normalisovat
propláchnout	pláchnout,opláchnout,vypláchnout
proplítat	oplítat,zaplítat,uplítat,vyplítat,doplítat
proponovat	oponovat
prosignalisovat	signalisovat,dosignalisovat
prosychat	osychat,prosýchat,dosychat
prosýchat	prosychat,osýchat,dosýchat
protivit	protivný
protivný	protivit
protýkat	dotýkat
proud	proudit
proudit	proud
provaselinovat	dovaselinovat
provlhat	vlhat
provoz	provozář
provozář	provoz
provázet	Provázek
províjet	dovíjet
pročmuchat	dočmuchat,čmuchat
pročísnout	čísnout
pryštit	prýštit
práce	prát
prádlař	pradlář
práskat	praskat
prát	práce
právovárečný	pravovárečný
prýmka	prýmkář
prýmkář	prýmka
prýštit	pryštit,prýštět
prýštět	prýštit
puncovat	punk
punk	punč,punkt,puncovat
punkt	punk,punč,punktovat
punktovat	punkt
punč	punk,punkt
puč	pučit,Puk
pučet	pučit
pučit	puč,pučet
páleničář	paleničář
pán	pan,Pan
pár	pára
pára	pár
párkař	párkář
párkář	párkař
pás	Pásek,pas
pást	past,Pásek
páter	páteř
páteř	páter
píce	píča,píka
píka	píča,píce
písek	píst
píst	písek,pěst
pít	pět
píča	píka,píce
pórovatět	zpórovatět
pěna	pěnice
pěnice	pěna
pěst	píst
pět	pít,pětník
pětník	pět
přebrnkat	brnkat
přecentralisovat	decentralisovat
přechcat	nachcat,zechcat
předebíhat	předeběhnout
předeběhnout	předebíhat
předkládat	vzkládat
přehoupnout	vhoupnout
přeinicialisovat	inicialisovat,reinicialisovat,nainicialisovat
přejezdný	zájezdný
překlimatisovat	klimatisovat,přiklimatisovat
přemobilisovat	mobilisovat,vymobilisovat,zmobilisovat,přimobilisovat,rozmobilisovat,zamobilisovat
přenormalisovat	normalisovat
přeorganisovat	reorganisovat,zreorganisovat
přeplítat	vyplítat,zaplítat
přepodstatnit	zpodstatnit
přepřahat	vypřahat,vpřahat
přespecialisovat	zespecialisovat,specialisovat
přesrat	přisrat
přestříhnout	nastříhnout,stříhnout,ustříhnout
přesychat	přesýchat,rozesychat,přisychat
přesynchronisovat	přisynchronisovat,nasynchronisovat,sesynchronisovat,resynchronisovat,usynchronisovat,dosynchronisovat
přesystematisovat	systematisovat,dosystematisovat,nasystematisovat
přesýchat	přesychat
převlek	převlečný
převlečný	převlek
přezvěřit	zazvěřit
přeškicnout	oškicnout
přichutit	ochutit
přiklimatisovat	zaklimatisovat,překlimatisovat
přikonsumovat	prokonsumovat,dokonsumovat
přimobilisovat	přemobilisovat
připodobit	připodobnit
připodobnit	připodobit
přisrat	přesrat
přistabilisovat	stabilisovat,ustabilisovat,dostabilisovat,nastabilisovat
přisychat	přisýchat,osychat,přesychat
přisynchronisovat	přesynchronisovat,nasynchronisovat,dosynchronisovat,sesynchronisovat,usynchronisovat
přisýchat	přisychat
přivitaminisovat	ovitaminisovat
přivykat	vykat
přát	přít
příjemnit	příjemný,zpříjemnět
příjemný	příjemnit
přísnit	přísnět
přísnět	přísnit
přít	přítel,přát
přítel	přít
rab	Ráb
rabi	rabiák
rabiák	rabiát,rabi
rabiát	rabiák
rachat	ráchat
rafika	rafičit
rafičit	rafika
rajka	ráj
raný	rána
realisovat	zrealisovat
recidiva	recidivovat
recidivovat	recidiva
rehydrovat	dehydrovat
reinicialisovat	přeinicialisovat
rekrut	rekrutovat
rekrutovat	rekrut
remíz	remíza
remíza	remíz
renta	rentovat
rentovat	renta
reorganisovat	zreorganisovat,přeorganisovat
resynchronisovat	přesynchronisovat
retina	retinovat
retinovat	retina
revanš	revanšovat
revanšovat	revanš
revolucionisovat	zrevolucionisovat
reální	reálný
reálný	reální
rešerše	rešeršovat
rešeršovat	rešerše
roh	rohovatý
rohovatý	roh,rohovník
rohovník	rohovatý
roj	Rojka
role	Rol
rolničit	rolnička
rolnička	rolničit
román	Roman,Romanov
roura	rourař
rourař	roura
rozbojník	zbojník
rozbíhat	zbíhat
rozbředat	bředat,vybředat
rozbřesknout	zabřesknout
rozcensurovat	zcensurovat
rozchvátit	zchvátit
rozcitlivit	zcitlivit,rozcitlivět
rozcitlivět	zcitlivět,rozcitlivit
rozedrat	zedrat
rozesrat	zesrat
rozesychat	rozesýchat,rozsychat,přesychat
rozesýchat	rozesychat,rozsýchat
rozgeneralisovat	zgeneralisovat
rozhlédat	zhlédat
rozhojnit	zhojnit
rozhoupnout	zhoupnout,houpnout
rozinicialisovat	zinicialisovat,doinicialisovat,inicialisovat,odinicialisovat
rozjařit	zjařit
rozkonsumovat	prokonsumovat
rozkoš	koš
rozkvítat	zkvítat
rozlítit	rozlítnout
rozlítnout	rozlítit
rozmobilisovat	zmobilisovat,promobilisovat,umobilisovat,vymobilisovat,přemobilisovat
rozmrzat	zmrzat
rozmáčknout	zmačknout
rozněžnět	zněžnět
rozohnit	zohnit
rozpindat	pindat
rozplamenit	zplamenit
rozprostranit	uprostranit
rozptýlit	zptýlit
rozpřahat	rozpřáhat,vypřahat
rozpřádat	zapřádat,opřádat
rozpřáhat	rozpřahat
rozradostnět	zradostnět
rozresonovat	zresonovat
rozsocha	socha
rozsychat	rozsýchat,rozesychat,osychat
rozsystematisovat	systematisovat,dosystematisovat
rozsýchat	rozsychat,rozesýchat
roztrojit	ztrojit
roztrpčit	ztrpčit
rozvichřit	vichřit
rozvzpomínat	vzpomínat
rudý	Ruda
rulička	Rulík
rychlobruslař	rychlobruslit
rychlobruslit	rychlobruslař
rychta	rychtovat
rychtovat	rychta
ráchat	rachat
ráj	rajka
rám	rámě
rámě	rám
rána	raný
rétor	rétorika
rétorika	rétor
sadovník	Sadov
samec	samet
samet	samec
sandinista	Sandino
sardinka	sardinkář,Sardinie
sardinkář	sardinka,Sardinie
schránět	naschránit,uschránit
sebeparodie	sebeparodizovat
sebeparodizovat	sebeparodie
sebeuspokojit	sebeuspokovat
sebeuspokovat	sebeuspokojit
sekvence	sekvencovat
sekvencovat	sekvence
selekce	selektiva
selektiva	selektovat,selekce
selektovat	selektiva
senzibil	senzibilní
senzibilní	senzibil
senzitiv	senzitivní
senzitivní	senzitiv
sesmekat	smekat
sesychat	osychat
sesynchronisovat	přesynchronisovat,přisynchronisovat,nasynchronisovat,usynchronisovat,dosynchronisovat
set	Oset
sever	Severa
sešikmit	zešikmit
signalisovat	dosignalisovat,odsignalisovat,zasignalisovat,prosignalisovat
silice	silika
silika	silice
sinus	siný
siný	sinus
sirý	síra
sivý	Siva
skandalisovat	zeskandalisovat
sklepník	usklepnit
skýtat	naskýtat
slad	sladký,sladit
sladit	sladký,slad
sladký	sladit,slad
sladovničit	sladovník
sladovník	sladovničit
slanit	Slanec
slavit	slavík
slavík	slavit
slepičář	Slepička
slez	Slezsko
sloupkař	sloupkář
sloupkář	sloupkař
smekat	sesmekat
smradit	zasmradit
smích	Smíchov
smůla	Smola
socha	rozsocha
specialisovat	přespecialisovat,zespecialisovat
spedice	speditér
speditér	spedice
splasknout	plasknout
sploštit	zploštit,oploštit
spláchnout	opláchnout,vypláchnout
spolkař	spolkařit
spolkařit	spolkař
spolufinacovat	spolufinancovat
spolufinancovat	spolufinacovat
spoluodpovídat	spoluzodpovídat
spoluzodpovídat	spoluodpovídat
spor	spora,sporý
spora	spor,sporý
sporý	spora,spor
spravedlivý	spravedlný
spravedlný	spravedlivý
spíchat	pospíchat,spěchat
spěchat	spíchat
spřádat	opřádat
srnec	Srník
stabilisovat	dostabilisovat,nastabilisovat,přistabilisovat,ustabilisovat,zastabilisovat
standardisovat	zestandardisovat
statika	statistika
statistika	statika
sterilisovat	vysterilisovat
sterilní	sterilovat
sterilovat	sterilní
stonat	Stone,stonek
stonek	Stone,stonat
stop	stopa
stopa	stop
stoper	stopér
stopér	stoper
stroj	strojit
strojit	stroj
strouhat	vystrouhat
struha	ostruha
strukturalisovat	dostrukturalisovat,nastrukturalisovat,zastrukturalisovat
stud	studit,studovat,studený,Studený
studený	stud,studit
studit	stud,Studený,studený
studovat	stud
stylisovat	vystylisovat
stánkař	stánkařit
stánkařit	stánkař
stáž	stážovat
stážovat	stáž
stín	Stin
stěhovat	stěhovák
stěhovák	stěhovat
střebat	vstřebat
středit	odstředit
střihat	nastřihat,dostřihat
střiž	stříž,Stříž
stříhnout	ustříhnout,nastříhnout,dostříhnout,přestříhnout,vostříhat
stříž	střiž
subvence	subvencovat
subvencovat	subvence
sud	osud
supat	zupat
surový	Sura
svat	Svatý,svatý
svatý	svat
svině	Sviny
svor	svora
svora	svor
svrbit	svrbět
svrbět	svrbit
svítit	světnice
svědek	svědit,svědět
svědit	svědět,svědek
svědět	svědit,svědek
svět	světnice
světnice	svět,svítit
swing	swingovat
swingovat	swing
symbolisovat	zesymbolisovat
sympatisovat	zesympatisovat,zasympatisovat
systematisovat	nasystematisovat,dosystematisovat,přesystematisovat,rozsystematisovat
systemisovat	dosystemisovat
síra	sirý
sít	sítina
sítina	sít
taj	tajný
tajný	taj
tanec	tank
tank	tanout,tanec
tanout	tank
technika	techno,zootechnika
techno	technika
tele	Telč
tendr	tendrovat
tendrovat	tendr
tep	otep
terorisovat	zterorisovat
teta	tetovat
tetovat	teta
teč	tečka
tečka	Teka,teč
tiper	tipér
tipnout	otipnout
tipér	tiper
titan	Titán
tleskat	otleskat
tmívat	vytmívat
totál	totální
totální	totál
trafika	trafikařit
trafikařit	trafika
travař	tráva
trn	Trnka
trojice	trojka
trojka	trojčit,trojice
trojčit	trojka
trsat	otrsat
tráva	travař
turismus	naturismus
turner	turnér
turnér	turner
tutový	Tutu
tvaroh	tvarohář
tvarohář	tvaroh
tvářet	tvářit
tvářit	tvářet
tykat	zatykat
tyč	tyčit
tyčit	tyč,vytýčit
tát	Tate,táta
táta	Tate,tát
tón	tónika
tónika	tón
týl	Tyl
třeskat	třískat
třískat	třeskat
ubreptnout	zabreptnout
uchechtnout	zachechtnout
uchichtnout	zachichtnout
uchroupnout	zachroupnout
udice	udit
udit	udice
udomácnit	udomácnět
udomácnět	udomácnit,zdomácnět
uklihnout	zklihnout
ukládat	dokládat
ukrvavit	zkrvavit
ultramaraton	ultramaratón
ultramaratón	ultramaraton
umobilisovat	omobilisovat,zmobilisovat,promobilisovat,rozmobilisovat
unie	unita
unikat	onikat
unita	unie
upláknout	opláknout
uplítat	oplítat,proplítat,zaplítat
upovšechnit	zpovšechnit
upravdit	zpravdit
uprostranit	rozprostranit
upřádat	opřádat,zapřádat,dopřádat,vypřádat
urbánní	Urbán
urputník	urputný
urputný	urputník
uryšit	urýšit
urýšit	uryšit
uschránit	naschránit,schránět
usklepnit	sklepník
uskromnit	zeskromnit
ustabilisovat	stabilisovat,dostabilisovat,nastabilisovat,přistabilisovat,zastabilisovat
ustříhnout	stříhnout,nastříhnout,dostříhnout,přestříhnout
usynchronisovat	nasynchronisovat,dosynchronisovat,přisynchronisovat,přesynchronisovat,sesynchronisovat
usýchat	osýchat
utilisovat	zutilisovat
utilita	utilitář
utilitář	utilita
utrakvisovat	zutrakvisovat
uvadat	ovadat
uvrtit	dovrtit
uvykat	vykat
uvědomit	zvědomit
učlověčit	zčlověčit
uřknout	zařknout
ušedat	zšedat
ušklíbat	ošklíbat,zašklíbat
uškrouknout	zaškrouknout
uštkat	uštknout
uštknout	uštkat
ušukat	šukat
uživotnit	zživotnit
vachta	vachtat,vachtař
vachtat	vachtař,vachta
vachtař	vachtat,vachta
vagabund	vagabundit
vagabundit	vagabund
vagant	vagantit
vagantit	vagant
valorisovat	dovalorisovat
var	várka
varhanit	varhanět,varhaničit
varhaničit	varhanit
varhany	varhánek
varhanět	varhanit
varhánek	varhany
variance	varianta
varianta	variance
varta	vartovat
vartovat	varta
vaselinovat	dovaselinovat,navaselinovat
vdova	vdovit
vdovit	vdova
vdychat	vdýchat
vdýchat	vdychat
vegetit	vegetář,vegetovat
vegetovat	vegetář,vegetit
vegetář	vegetovat,vegetit
vejměnkář	vejměník
vejměník	vejměnkář
velebník	zvelebnit
velkostatek	velkostatkář
velkostatkář	velkostatek
ventil	ventilovat
ventilovat	ventil
ves	oves
vhoupnout	přehoupnout
vichřit	rozvichřit
vietnamka	Vietnam
vila	vilný
vilný	vila
vinařit	novinařit
vinklář	Vinklár
visitovat	zvisitovat
visitýrovat	zvisitýrovat
visovat	avisovat
vitaminisovat	ovitaminisovat,zvitaminisovat,dovitaminisovat,navitaminisovat
vlas	Vlasov
vlekat	vlékat
vlhat	provlhat,zavlhat
vlk	vlčit
vládat	vládný
vládný	vovládnout,vládat
vlékat	vlekat
vlčet	vlčit
vlčit	vlčet,Vlk,vlk
vnikat	onikat
vně	vát,Nat
voda	Vodák
vodohospodář	národohospodář
voj	vojna
vojevoda	vojevodit
vojevodit	vojevoda
vojna	voj
vole	vůle,volný
volný	vole
vosa	osa
vostříhat	stříhnout
vovládnout	vládný
vpřahat	vpřáhat,přepřahat
vpřáhat	vpřahat
vrap	vráp
vraštit	vráštit
vrhat	vyvrhat,zavrhat
vrzat	Vrzák
vrána	Vrana,Vraný
vráp	vrap
vráskatět	vráskovatět
vráskovatět	vráskatět
vráštit	vraštit
vsahat	vsáhat
vstřebat	střebat
vsáhat	vsahat
vtip	vtipkař
vtipkař	vtipkařit,vtip
vtipkařit	vtipkař
vulgarisovat	zavulgarisovat
vulkanisovat	zavulkanisovat,zvulkanisovat,dovulkanisovat
vyanalysovat	analysovat,zanalysovat
vybledat	zbledat
vyblízat	vyblíznout
vyblíznout	vyblízat
vyboulovat	zboulovat
vybreptnout	zabreptnout
vybulat	zbulat,zabulat
vybíhat	zbíhat
vyběsit	zběsit
vybředat	bředat,zabředat,rozbředat
vycensurovat	censurovat,odcensurovat
vycharakterisovat	charakterisovat,zcharakterisovat
vychlámat	chlámat
vychlípit	vychlípět
vychlípět	vychlípit
vychvistnout	vychvístnout
vychvátit	zchvátit
vychvístnout	vychvistnout
vyciselovat	ciselovat
vycukernit	zcukernit,odcukernit
vydlažit	vydlážit
vydlábnout	nadlábnout
vydlážit	vydlažit
vydundat	odundat
vydřevit	vydřevnit
vydřevnit	vydřevit
vyeskamotovat	zaeskamotovat
vygeneralisovat	zgeneralisovat,generalisovat
vyhládnout	zhládnout
vyhlédat	vzhlédat,zhlédat,hlédat
vyhvězdit	zhvězdit
vyjiknout	vyjíknout
vyjíknout	vyjiknout
vykat	uvykat,přivykat
vykolejit	nakolejit
vykonsumovat	konsumovat
vykrkat	krkat
vykrystalisovat	krystalisovat,zkrystalisovat
vykvitnout	vykvítnout
vykvítnout	vykvitnout
vylíhat	líhat
vymanout	zmanout
vymobilisovat	mobilisovat,přemobilisovat,zamobilisovat,zmobilisovat,odmobilisovat,rozmobilisovat
vymutýrovat	zmutýrovat
vymědlit	změdlit
vyobloučit	zobloučit
vyoslit	vyvoslit
vypartykařit	zpartykařit,zapartykařit
vypažit	pažit
vypeřit	zpeřit
vyplanit	zplanit
vyplavět	zplavět
vypláchnout	pláchnout,opláchnout,propláchnout,spláchnout
vyplítat	zaplítat,přeplítat,doplítat,proplítat
vypodobit	zpodobit,napodobit,vypodobnit
vypodobnit	zpodobnit,vypodobit
vyprahat	vypráhat,zprahat
vyprdelit	odprdelit
vyprecisovat	zaprecisovat,precisovat
vyprostit	zprostit,zprostit,oprostit
vyprovodit	doprovodit
vypráhat	vyprahat
vypulerovat	vypulérovat
vypulérovat	vypulerovat
vypíčit	zpíčit
vypřahat	zapřahat,napřahat,přepřahat,odpřahat,rozpřahat
vypřádat	zapřádat,dopřádat,opřádat,upřádat
vyresonovat	zresonovat
vysmrádnout	nasmrádnout
vysterilisovat	sterilisovat
vystrouhat	strouhat
vystylisovat	stylisovat
vysychat	vysýchat,zasychat
vysámečkovat	vysámkovat
vysámkovat	vysámečkovat
vysýchat	vysychat,zasýchat
vyteplit	zteplit
vytmívat	tmívat
vytýčit	tyčit
vyvoslit	vyoslit
vyvrhat	vrhat,zvrhat
vyvrtit	zavrtit
vyzírat	zírat
vyčouhat	čouhat
vyšpláchnout	ošpláchnout
vyštráchat	štrachat
vyšustět	všustět
vzdušnice	vzdušnit
vzdušnit	vzdušnice,vzdušnět
vzdušnět	vzdušnit
vzdýmat	zdýmat
vzhlédat	vyhlédat
vzkládat	předkládat
vzkvetnout	vzkvétnout
vzkvétnout	vzkvetnout
vzorkař	vzorkář
vzorkář	vzorkař
vzpomínat	rozvzpomínat
vzpěčovat	zpěčovat
vzrůst	Zrůst
vzájemný	zájemný
váha	váhař,Váh
váhař	váha
válka	Val,Válek
vápeničit	vápeník,Vápeník
vápeník	vápeničit,vápenět
vápenět	Vápeník,vápeník
várka	var
vát	vně
váza	vázat
vázat	váza
víno	Vína,věno
víra	Věra
výzbroj	zbroj
věno	víno
věta	větit,větev
větev	věta,větit
větit	věta,větev
vštípit	štípit
všustět	vyšustět
vůl	vůle
vůle	vůl,vole
wahhábita	Wahháb
yorkšír	jorkšír
zaarchaisovat	zarchaisovat
zabahnět	zbahnět
zabreptnout	ubreptnout,vybreptnout
zabsolutnit	zabsolutnět,absolutní
zabsolutnět	zabsolutnit
zabstraktnit	zabstraktnět
zabstraktnět	zabstraktnit
zabulat	zbulat,vybulat
zabředat	bředat,vybředat
zabřesknout	rozbřesknout
zacensurovat	nacensurovat
zachechtnout	uchechtnout
zachichtnout	uchichtnout
zachroupnout	uchroupnout
zachrustit	zachrustět
zachrustět	zachrustit
zadostičinit	zadostčinit
zadostčinit	zadostičinit
zadundat	odundat
zaeskamotovat	vyeskamotovat
zajachtařit	jachtařit
zakademičtit	zakademičtět
zakademičtět	zakademičtit
zakatalogisovat	katalogisovat,zkatalogisovat
zaklimatisovat	klimatisovat,přiklimatisovat
zakládat	zakládač,kládat
zakládač	zakládat
zakonservovat	konservovat,zkonservovat
zakrabit	zkrabit
zakritisovat	kritisovat
zakročit	nakročit
zakrvavit	zakrvit
zakrvit	zakrvavit
zaktivnit	zaktivnět
zaktivnět	zaktivnit
zaktualisovat	aktualisovat
zalistit	odlistit
zalkalisovat	alkalisovat
zamobilisovat	mobilisovat,vymobilisovat,omobilisovat,přemobilisovat,domobilisovat
zamortisovat	amortisovat
zaměstnat	městnat
zanalysovat	analysovat,vyanalysovat
zapartykařit	zpartykařit,vypartykařit
zapchat	napchat,zapchnout
zapchnout	zapchat
zaplítat	proplítat,vyplítat,uplítat,oplítat,přeplítat,doplítat
zapolemisovat	polemisovat
zapolitisovat	zpolitisovat
zapolétat	polétat
zapomínat	pozapomínat,napomínat,opomínat
zaprecisovat	precisovat,vyprecisovat
zapráhnout	zpráhnout,prahnout
zapsychologisovat	zpsychologisovat
zapylit	opylit
zapřahat	vypřahat,napřahat
zapřádat	opřádat,vypřádat,upřádat,dopřádat,rozpřádat
zarchaisovat	zaarchaisovat
zasignalisovat	signalisovat,dosignalisovat
zasmradit	smradit
zastabilisovat	nastabilisovat,stabilisovat,ustabilisovat
zastehnout	nastehnout
zastesknout	zastýsknout
zastrakatět	zestrakatět
zastrukturalisovat	nastrukturalisovat,strukturalisovat
zastýlat	nastýlat
zastýsknout	zastesknout
zastřihat	nastřihat
zastříbrnět	zestříbrnět
zastříhnout	nastříhnout
zasychat	zasýchat,vysychat
zasympatisovat	sympatisovat,zesympatisovat
zasýchat	zasychat,vysýchat
zatykat	tykat
zautomatisovat	odautomatisovat,doautomatisovat,automatisovat
zautorisovat	autorisovat
zavazet	zavazit
zavazit	zavazet
zavlahnout	zavláhnout
zavlhat	navlhat,vlhat
zavláhnout	zavlahnout
zavrhat	vrhat
zavrtit	vyvrtit
zavulgarisovat	vulgarisovat
zavulkanisovat	vulkanisovat,dovulkanisovat,zvulkanisovat
zavyšívat	dovyšívat
zazvěřit	přezvěřit
začít	načít
začít	načít
začít	načít
zařknout	uřknout
zašklíbat	ušklíbat
zaškrouknout	uškrouknout
zašperovat	zašpérovat
zašpérovat	zašperovat
zaštkat	zaštknout
zaštknout	zaštkat
zbabičkovatět	babičkovatět
zbahnět	zabahnět
zbanálnit	zbanálnět
zbanálnět	zbanálnit
zbezpečit	zbezpečnit
zbezpečnit	zbezpečit
zblbit	zblbět,oblbit
zblbět	zblbit
zbledat	vybledat
zbodřet	zbodřit
zbodřit	zbodřet
zbojničit	zbojník
zbojník	zbojničit,rozbojník
zbolševisovat	bolševisovat
zboulovat	vyboulovat
zbroj	výzbroj
zbuchtovatět	buchtovatět
zbulat	vybulat,zabulat
zbídnit	zbídnět
zbídnět	zbídnit
zbíhat	rozbíhat,vybíhat
zběsit	vyběsit
zcensurovat	rozcensurovat,odcensurovat,censurovat
zcentralisovat	centralisovat,docentralisovat
zcharakterisovat	vycharakterisovat,charakterisovat
zchudobnět	zchudobňovat
zchudobňovat	zchudobnět
zchvátit	rozchvátit,vychvátit
zcitlivit	rozcitlivit,zcitlivět
zcitlivět	rozcitlivět,zcitlivit
zcivilnit	zcivilnět
zcivilnět	zcivilnit
zcukernit	zcukernět,vycukernit
zcukernět	zcukernit
zcírkevnit	odcírkevnit
zdefinitisovat	zdefinitizovat,zdefinitivnit
zdefinitivnit	zdefinitizovat,zdefinitisovat
zdefinitizovat	zdefinitisovat,zdefinitivnit
zdemokratisovat	demokratisovat
zdemoralisovat	demoralisovat
zdesateronásobit	zdesateronásobnit
zdesateronásobnit	zdesateronásobit
zdesorganisovat	desorganisovat
zdiversifikovat	diversifikovat,dodiversifikovat
zdomácnit	zdomácnět
zdomácnět	zdomácnit,udomácnět
zdravkat	zdrávkat
zdravět	ozdravět
zdredovatět	dredovatět
zdrobnit	zdrobnět
zdrobnět	zdrobnit
zdrávkat	zdravkat
zduchovnit	zduchovnět
zduchovnět	zduchovnit
zduševnit	zduševnět,oduševnit
zduševnět	zduševnit
zdýmat	vzdýmat
zdětštit	zdětštět
zdětštět	zdětštit
zdůstojnit	zdůstojnět
zdůstojnět	zdůstojnit
zdůvěrnit	zdůvěrnět
zdůvěrnět	zdůvěrnit
zechcat	přechcat
zedrat	rozedrat
zesentimentálnit	zesentimentálnět
zesentimentálnět	zesentimentálnit
zesilnit	zesilnět
zesilnět	zesilnit
zesinavět	zsinavět
zeskandalisovat	skandalisovat
zeskelnit	zeskelnět
zeskelnět	zeskelnit
zeskromnit	zeskromnět,uskromnit
zeskromnět	zeskromnit
zeskrovnit	zeskrovnět
zeskrovnět	zeskrovnit
zeslavnostnit	zeslavnostnět
zeslavnostnět	zeslavnostnit
zesličnit	zesličnět
zesličnět	zesličnit
zeslovanštit	zeslovanštět
zeslovanštět	zeslovanštit
zespecialisovat	přespecialisovat,specialisovat
zespolečenštit	zespolečenštět
zespolečenštět	zespolečenštit
zesrat	rozesrat
zestandardisovat	standardisovat
zesteronásobit	zesteronásobnit
zesteronásobnit	zesteronásobit
zestonásobit	zestonásobnit
zestonásobnit	zestonásobit
zestrakatět	zastrakatět
zestraničtit	zestraničtět
zestraničtět	zestraničtit
zestručnit	zestručnět
zestručnět	zestručnit
zestříbrnět	zastříbrnět
zesubjektisovat	zesubjektivisovat
zesubjektivisovat	zesubjektisovat
zesvátečnit	zesvátečnět
zesvátečnět	zesvátečnit
zesvětačet	zesvětačit
zesvětačit	zesvětačet
zesvětštit	zesvětštět
zesvětštět	zesvětštit
zesymbolisovat	symbolisovat
zesympatisovat	sympatisovat,zasympatisovat
zesyrovatět	zesýrovatět
zesýrovatět	zesyrovatět
zevropštit	zevropštět
zevropštět	zevropštit
zevšeobecnit	zevšeobecnět
zevšeobecnět	zevšeobecnit
zextenzívnit	zextenzívnět
zextenzívnět	zextenzívnit
zezvířečtit	zezvířečtět
zezvířečtět	zezvířečtit
zešesteronásobit	zšesteronásobit
zešikmit	sešikmit
zešupinkovatět	zešupinovatět,šupinkovatět
zešupinovatět	zešupinkovatět
zfalsifikovat	falsifikovat
zfanfrnit	zfanfrnět
zfanfrnět	zfanfrnit
zfirnovatět	firnovatět
zgeneralisovat	rozgeneralisovat,vygeneralisovat,generalisovat
zgermanisovat	germanisovat
zharmonisovat	harmonisovat
zhistorisovat	historisovat
zhloupět	zhlupět
zhlupit	zhlupět
zhlupět	zhlupit,zhloupět
zhládnout	vyhládnout
zhlédat	hlédat,rozhlédat,vyhlédat
zhmotnit	zhmotnět
zhmotnět	zhmotnit
zhojnit	zhojnět,rozhojnit
zhojnět	zhojnit
zhorečnit	zhorečnět
zhorečnět	zhorečnit
zhoupnout	rozhoupnout,houpnout
zhranatit	zhranatět
zhranatět	zhranatit
zhrdinštit	zhrdinštět
zhrdinštět	zhrdinštit
zhrubit	zhrubět
zhrubět	zhrubit
zhumanisovat	humanisovat
zhvězdit	vyhvězdit
zhybnit	zhybnět
zhybnět	zhybnit
zima	Zimák
zindustrialisovat	industrialisovat
zinicialisovat	rozinicialisovat,inicialisovat,doinicialisovat,odinicialisovat,nainicialisovat
zintensivnit	zintensivnět,zintensivňovat
zintensivnět	zintensivnit,zintensivňovat
zintensivňovat	zintensivnit,zintensivnět
zintenzivnět	zintenzívnět,zintenzivňovat
zintenzivňovat	zintenzivnět
zintenzívnit	zintenzívnět
zintenzívnět	zintenzívnit,zintenzivnět
zintimnit	zintimnět
zintimnět	zintimnit
zinventarisovat	inventarisovat
zjařit	rozjařit
zjednostranit	zjednostranět
zjednostranět	zjednostranit
zjednotvárnit	zjednotvárnět
zjednotvárnět	zjednotvárnit
zjednoznačnit	odjednoznačnit
zkapitalisovat	kapitalisovat
zkatalogisovat	katalogisovat,zakatalogisovat
zklasicisovat	klasicisovat
zklasičtit	zklasičtět
zklasičtět	zklasičtit
zklihnout	uklihnout
zklihovatět	klihovatět
zkmotrovatět	kmotrovatět
zkolonisovat	kolonisovat
zkondensovat	kondensovat
zkonkretisovat	konkretisovat
zkonkrétnit	zkonkrétnět,konkrétní
zkonkrétnět	zkonkrétnit
zkonservovat	konservovat,zakonservovat
zkonvenčnit	zkonvenčnět
zkonvenčnět	zkonvenčnit
zkonzervativnět	konzervativní
zkouzelnit	zkouzelnět
zkouzelnět	zkouzelnit
zkrabit	zakrabit
zkrepatět	krepatět
zkrouhnout	okrouhnout
zkrvavit	zkrvit,okrvavit,ukrvavit
zkrvit	zkrvavit
zkrystalisovat	vykrystalisovat
zkulturnit	zkulturnět
zkulturnět	zkulturnit
zkvítat	rozkvítat,dokvítat
zlacinit	zlacinět
zlacinět	zlacinit
zlahodnit	zlahodnět
zlahodnět	zlahodnit
zlakotnit	zlakotnět
zlakotnět	zlakotnit
zlehkomyslnět	lehkomyslný
zliterárnit	zliterárnět
zliterárnět	zliterárnit
zlogičtit	zlogičtět
zlogičtět	zlogičtit
zludračet	zludračit
zludračit	zludračet
zlyričtit	zlyričtět
zlyričtět	zlyričtit
zlíbeznit	zlíbeznět
zlíbeznět	zlíbeznit
zlínět	Zlín
zlít	zlítit
zlítit	zlít
zmalichernit	zmalichernět
zmalichernět	zmalichernit
zmalit	zmálit
zmalomocnit	zmalomocnět
zmalomocnět	zmalomocnit
zmanout	vymanout
zmatnit	zmatnět
zmatnět	zmatnit
zmačknout	rozmáčknout
zmdlet	omdlet
zmechanisovat	mechanisovat
zmelodičtit	zmelodičtět
zmelodičtět	zmelodičtit
zmezinárodnit	zmezinárodnět,mezinárodní
zmezinárodnět	zmezinárodnit
zmije	Zmij
zmilosrdnit	zmilosrdnět
zmilosrdnět	zmilosrdnit
zmilostnit	zmilostnět
zmilostnět	zmilostnit
zmléčnit	zmléčnět
zmléčnět	zmléčnit
zmnohonásobit	zmnohonásobnit,mnohonásobek
zmnohonásobnit	zmnohonásobit
zmobilisovat	rozmobilisovat,umobilisovat,omobilisovat,promobilisovat,vymobilisovat,přemobilisovat,mobilisovat,domobilisovat,pomobilisovat
zmocnit	zmocnět
zmocnět	zmocnit
zmodernisovat	modernisovat
zmonopolisovat	monopolisovat
zmotorisovat	motorisovat
zmrzat	rozmrzat
zmrzoutět	zmrzutět
zmrzutět	zmrzoutět
zmráčit	omráčit
zmutýrovat	vymutýrovat
zmužštit	zmužštět
zmužštět	zmužštit
zmálit	zmalit
změdlit	vymědlit
změlčet	změlčit
změlčit	změlčet
změšťáčtit	změšťáčtět
změšťáčtět	změšťáčtit
znamenat	znamení
znamení	znamenat
znatel	znát
znaturalisovat	naturalisovat
znecitlivit	znecitlivět
znecitlivět	znecitlivit
znedůvěřit	znedůvěřivět
znedůvěřivět	znedůvěřit
znegativnět	negativní
znehybnit	znehybnět
znehybnět	znehybnit
zneklidnit	zneklidnět
zneklidnět	zneklidnit
znemravnit	znemravnět
znemravnět	znemravnit
znepravidelnit	znepravidelnět
znepravidelnět	znepravidelnit
zneprůchodnit	zneprůchodnět
zneprůchodnět	zneprůchodnit
znepříjemnit	znepříjemnět
znepříjemnět	znepříjemnit
znepřítomnět	znepřítomňovat
znepřítomňovat	znepřítomnět
znervosnit	znervosnět,znervosňovat
znervosnět	znervosnit
znervosňovat	znervosnit
znervóznět	nervóznit
zneutralisovat	neutralisovat
znevolnit	znevolničit
znevolničit	znevolnit
znicotnět	znicotňovat
znicotňovat	znicotnět
zniternit	zniternět
zniternět	zniternit
znobilisovat	nobilisovat
znoj	znojit
znojit	znoj
znormalisovat	normalisovat
znovubudovat	znovuzbudovat
znovudosadit	znovuosadit
znovuosadit	znovudosadit
znovuvybudovat	znovuzbudovat
znovuzbudovat	znovuvybudovat,znovubudovat
znádhernit	znádhernět
znádhernět	znádhernit
znát	znatel
zněkolikanásobit	zněkolikanásobnit
zněkolikanásobnit	zněkolikanásobit
zněmit	zněmět
zněmět	zněmit
zněžnit	zněžnět
zněžnět	zněžnit,rozněžnět
zobjektisovat	zobjektivisovat
zobjektivisovat	zobjektisovat
zobloučit	vyobloučit
zobyčejnit	zobyčejnět
zobyčejnět	zobyčejnit
zobčanštit	zobčanštět
zobčanštět	zobčanštit
zodbornit	zodbornět
zodborničtit	zodborničtět
zodborničtět	zodborničtit
zodbornět	zodbornit
zoficiálnit	zoficiálnět
zoficiálnět	zoficiálnit
zohebnit	zohebnět
zohebnět	zohebnit
zohnit	rozohnit
zohyzdnit	zohyzdnět
zohyzdnět	zohyzdnit
zootechnika	technika
zoptimalisovat	optimalisovat
zoufat	doufat
zout	out,dout
zpadesátinásobit	zpadesátinásobnit
zpadesátinásobnit	zpadesátinásobit
zparalysovat	paralysovat
zparchantit	zparchantět
zparchantět	zparchantit
zpartykařit	zapartykařit,vypartykařit
zpasivnit	zpasivnět
zpasivnět	zpasivnit
zpateronásobit	zpateronásobnit
zpateronásobnit	zpateronásobit
zpersiflovat	persiflovat
zpestřet	zpestřit
zpestřit	pestřit,zpestřet
zpeřit	vypeřit
zpikantnit	zpikantnět,pikantní
zpikantnět	zpikantnit
zplacatit	zplacatět
zplacatět	zplacatit
zplamenit	zplamenět,rozplamenit
zplamenět	zplamenit
zplanit	vyplanit
zplastičtit	zplastičtět
zplastičtět	zplastičtit
zplavět	vyplavět
zplodnit	zplodnět
zplodnět	zplodnit
zploštit	oploštit,sploštit
zploštět	oploštět
zplynět	plynit
zpodobit	vypodobit,napodobit
zpodobnit	vypodobnit
zpodstatnit	zpodstatnět,přepodstatnit
zpodstatnět	zpodstatnit
zpolarisovat	polarisovat
zpolitisovat	zapolitisovat
zpopruhovatět	zpruhovatět
zpopularisovat	popularisovat
zpopulárnit	zpopulárnět,populární
zpopulárnět	zpopulárnit
zposvátnit	zposvátnět
zposvátnět	zposvátnit
zpovrchnit	zpovrchnět
zpovrchnět	zpovrchnit
zpovšechnit	zpovšechnět,upovšechnit
zpovšechnět	zpovšechnit
zprahat	vyprahat
zpraktičtit	zpraktičtět
zpraktičtět	zpraktičtit
zpravdit	upravdit
zpravděpodobnit	pravděpodobný
zpravidelnit	zpravidelnět
zpravidelnět	zpravidelnit
zprimitisovat	zprimitivisovat
zprimitivisovat	zprimitisovat
zprimitivnit	zprimitivnět
zprimitivnět	zprimitivnit
zprofesionalisovat	profesionalisovat
zprostit	oprostit,vyprostit
zprostit	oprostit,vyprostit
zprostonárodnit	zprostonárodnět
zprostonárodnět	zprostonárodnit
zprotivnět	zprotivňovat
zprotivňovat	zprotivnět
zpruhovatět	zpopruhovatět
zpružnit	zpružnět
zpružnět	zpružnit
zpráhnout	zapráhnout
zprůchodnit	zprůchodnět
zprůchodnět	zprůchodnit
zprůmyslnit	zprůmyslnět,odprůmyslnit
zprůmyslnět	zprůmyslnit,odprůmyslnit
zprůzračnit	zprůzračnět
zprůzračnět	zprůzračnit
zpsychologisovat	zapsychologisovat
zptýlit	rozptýlit
zpychat	zpýchat
zpíčit	vypíčit
zpórovatět	pórovatět
zpýchat	zpychat
zpěknit	zpěknět
zpěknět	zpěknit
zpět	zpětit
zpětit	zpět
zpěčit	zpěčovat
zpěčovat	zpěčit,vzpěčovat
zpříjemnět	příjemnit
zpřírodnit	odpřírodnit
zpřístupnit	zpřístupnět
zpřístupnět	zpřístupnit
zpřítomnit	zpřítomnět
zpřítomnět	zpřítomnit
zpřízvučnit	zpřízvučnět
zpřízvučnět	zpřízvučnit
zpříšernit	zpříšernět
zpříšernět	zpříšernit
způvabnit	způvabnět
způvabnět	způvabnit
zrabiátnit	zrabiátnět
zrabiátnět	zrabiátnit
zradostnit	zradostnět
zradostnět	rozradostnět,zradostnit
zrašelinět	zrašeliňovat
zrašeliňovat	zrašelinět
zrealisovat	realisovat
zrealističtit	zrealističtět
zrealističtět	zrealističtit
zreorganisovat	reorganisovat,přeorganisovat
zresonovat	rozresonovat,vyresonovat
zrevolucionisovat	revolucionisovat
zreálnit	zreálnět
zreálnět	zreálnit
zrohatit	zrohatět
zrohatět	zrohatit
zromantičtit	zromantičtět
zromantičtět	zromantičtit
zrozkošnit	zrozkošnět
zrozkošnět	zrozkošnit
zsinavět	zesinavět
ztajemnit	ztajemnět
ztajemnět	ztajemnit
zteatrálnit	zteatrálnět
zteatrálnět	zteatrálnit
ztechničtit	ztechničtět
ztechničtět	ztechničtit
ztekutit	ztekutět
ztekutět	ztekutit
zteplit	vyteplit
zterorisovat	terorisovat
ztisíceronásobit	ztisíceronásobnit
ztisíceronásobnit	ztisíceronásobit
ztitěrnit	ztitěrnět
ztitěrnět	ztitěrnit
ztrojit	roztrojit
ztrojnásobit	ztrojnásobnit
ztrojnásobnit	ztrojnásobit
ztrpčet	ztrpčit
ztrpčit	roztrpčit,ztrpčet
ztrudnit	ztrudnět
ztrudnět	ztrudnit
zuhelnit	zuhelnět
zuhelnět	zuhelnit
zumělečtit	zumělečtět
zumělečtět	zumělečtit
zunkat	zuňkat
zupat	supat
zutilisovat	utilisovat
zutrakvisovat	utrakvisovat
zuňkat	zunkat
zvedat	nazvedat
zvelebnit	velebník
zvisitovat	visitovat
zvisitýrovat	visitýrovat
zvitaminisovat	ovitaminisovat,vitaminisovat,navitaminisovat,odvitaminisovat
zvniternit	zvniternět
zvniternět	zvniternit
zvnitřnit	zvnitřnět
zvnitřnět	zvnitřnit
zvrhat	vyvrhat
zvulgárnit	zvulgárnět
zvulgárnět	zvulgárnit
zvulkanisovat	vulkanisovat,zavulkanisovat
zvážnit	zvážnět
zvážnět	zvážnit
zvýraznit	zvýraznět
zvýraznět	zvýraznit
zvýznamnit	zvýznamnět
zvýznamnět	zvýznamnit
zvěcnit	zvěcnět
zvěcnět	zvěcnit
zvědečtit	zvědečtět
zvědečtět	zvědečtit
zvědomit	uvědomit
zvěr	zvěř
zvěř	zvěr
záhoř	záhoří
záhoří	záhoř
záhumenka	záhumení
záhumení	záhumenka
zájemný	vzájemný
zájezdný	přejezdný
základ	základna
základna	základ
zámečničit	Zámečník
zápas	pas
zásvětný	zásvětí
zásvětí	zásvětný
závoj	závojnatý
závojnatý	závoj
závorář	Závora
zázvor	Zázvora
zírat	vyzírat
zíta	Zita
zúrodnit	zúrodnět
zúrodnět	zúrodnit
zútulnět	útulnit
zúzkostnit	zúzkostnět
zúzkostnět	zúzkostnit
zčechisovat	čechisovat
zčlověčit	zčlověčtit,učlověčit
zčlověčtit	zčlověčit
zřemeslnit	řemeslnět
zřít	pozřít
zšedat	ušedat
zšesteronásobit	zešesteronásobit
zživotnit	uživotnit
Ábel	Zábel
Ázerbajdžán	Ázerbájdžán
Ázerbájdžán	Ázerbajdžán
úchylka	úchylkařit
úchylkařit	úchylka
úhoř	úhořit
úhořit	úhoř
ústupkařit	ústupkář
ústupkář	ústupkařit
útulnit	zútulnět,útulný
útulný	útulnit
úvodníkařit	úvodníkář
úvodníkář	úvodníkařit
Čech	Čechov
Čechov	Čech
Čechák	čecháček
Černo	černý,Černov
Černov	Černo
Čihák	čihač
Čunek	čuník
čachrařit	čachrář
čachrář	čachrařit
časomíra	časoměr
časoměr	časomíra,časoměřič
časoměřič	časoměr
častý	část
čechisovat	zčechisovat
čecháček	Čechák
čerchman	čerchmant
čerchmant	čerchman
černý	Černo
čihač	Čihák
čin	čina
čina	čin
čistý	číst
čiřit	čířit
čmuchat	dočmuchat,pročmuchat
čnít	čnět
čnět	čnít
čouhat	vyčouhat
črtat	načrtat
čtyřnásobek	čtyřnásobit
čtyřnásobit	čtyřnásobek
čuník	Čunek
čurat	očurat
část	častý
čísnout	pročísnout
číst	čistý
čířit	čiřit
Řek	řeka
Řihák	Říhák
Říhák	Řihák
řeka	Řek
řemeslnět	zřemeslnit
Šamánek	šaman
Šan	Šanov,šanovat
Šanov	Šan,šanovat
Šima	Šimák,Šíma
Šimon	Šimoník
Šimoník	Šimon,Šimůnek
Šimák	Šima
Šimůnek	Šimoník
Špetík	špetka
Špina	špína,Špinar,špice,špicl
Špinar	Špina
Štýr	štír
Štětkař	štětkář,štětina
Šíma	Šima
šaman	Šamánek
šanovat	Šan,Šanov
šat	šaty,šátek
šaty	šat
škrob	škrobit
škrobit	škrob
škvíra	škvířit
škvířit	škvíra
šlak	šlakovat
šlakovat	šlak
šmelc	šmelcovat
šmelcovat	šmelc
šmírař	šmírařit,šmírovat
šmírařit	šmírař
šmírovat	šmírař
šohaj	šohajík
šohajík	šohaj
špendlík	špendlíkář
špendlíkář	špendlík
špetka	Špetík,špetnout
špetnout	špetka
špic	špice,špicl
špice	špicl,špic,Špina
špicl	špice,špic,Špina
špína	Špina
šrot	šrotit
šrotit	šrot
štrachat	vyštráchat
štípit	vštípit
štír	štířit,Štýr
štít	štítit,štět,dštít
štítit	štít,štět,štětina
štířit	štír
štěnice	štěně
štěně	štěnice
štět	štít,štětina,štítit,štětkář
štětina	štětkář,štět,Štětkař,štítit
štětkář	Štětkař,štětina,štět
šukat	ušukat
šupinkovatět	zešupinkovatět
šál	šálit
šálit	šál
šátek	šat
šťouchat	pošťouchat
ťapat	ťápat
ťupat	oťupat,poťupat
ťápat	ťapat
Žitný	žito
Živkov	živit
Žižka	Žižkov
Žižkov	Žižka
žal	žalost
žalost	žal
žalud	žaludek
žaludek	žalud
žalář	žalářit
žalářit	žalář
žduchat	žďuchat
žito	Žitný,žít
živit	Živkov
žokej	hokej
žvastat	žvástat
žvástat	žvastat
žít	žito
žďuchat	žduchat
