Abraham	Abrahám
Abrahám	Abraham
Adam	Adamík
Alexandr	Alexandrov
Alexej	Alexejev
Aleš	Leš
Almohada	Almohád
Andrej	Andrejs,Andrejev
Andrejs	Andrej
Anna	Annan,Annen,ananas,antika,Antily
Antily	antika
Antonín	Antoník
Apollón	Apollon
Argos	argot
Astrachaň	astrachán
Asýrie	Sýrie,Assyr
Avila	vila
Bach	bachař
Barbora	barbar
Bardot	bard
Barma	barman,baryum,barbar,bard,Bardejov
Baťa	Baťka
Blatný	blata,Blatnice,bláto
Bolívar	Bolívie
Bond	Bondy
Boole	boule
Borat	borec
Bosna	bos
Brno	brnět
Brod	brodit
Brook	brok
Brooker	broker
Broum	Broumov
Brunej	brunet
Brusel	brusle
Buda	budovat
Bury	burza,jury,urbura,Burjat,Burda
Bába	baba
Bárt	Bárta
Bárta	Bárt
Bój	bóje
Běla	Bělina,běl
Bělov	běl
Břehov	břeh
Březa	bříza,březí
Champagne	Žampach
Chile	chinin,chýlit,Chelm,chiliasmus
Chrasta	chrastit
Cibula	cibule
Dan	Dán,daň
David	Davidov
Davidov	David
Dolina	dolinář
Dominik	Dominic
Dora	Sura,vzdor
Drda	Drdák
Duša	duše
Dán	Dan
Dárí	dar,dařit
Dírná	díra
Ela	clo,alt
Erós	šos,kros,xerox
Etrurie	retrahovat
Eva	Evans
Fikar	fikat
Florencie	Florentina,Florena,Florian
Francie	frank,Franke,Franky,František,Franic,frankismus
Franke	Franky
Franky	frank,Franke,frankismus,Francie
František	frank,Francie,Franky,Franic,frankismus,Franke
Fryg	Frýg
Frýg	Fryg
Gajda	gajdy
Gal	Gál
Gent	agent
Gota	Gott,Gotha
Gotha	Gota
Gott	Gota
Gál	Gal
Halič	halit,halit
Hana	Haná,hanit
Haná	Hana
Hašek	hašiš,hašovat
Hašler	hašlerka
Hejnice	hejno
Henoch	Henry
Herakleitos	Hérakleitos
Hispanie	Hispánie
Hispánie	Hispanie
Hlava	Hlaváč
Hlinsko	Hlinka
Hora	horor,horna,hůra,horký,horovat,Horác,Horka,hoře,hornatý
Horka	horký
Hověz	hovězí
Hrab	hrabě
Hroza	hrůza
Hus	husa
Hérakleitos	Herakleitos
Hřebeč	hřebec
Ikar	kar,Oskar
Izrael	izraelita
Jan	Ján,Janečka
Janoš	Jánoš
Jar	jarý
Java	Jáva
Jelena	jelenář,jelen
Jesus	jas,jesen,jez,jeskyně,jistý,jezovita,jed,jezíd,jeseter,Jesenin,jíst,bas,jednička,bestie,Njasa,ves,Jersey,jizva,jezero,jesle,visnout,eses,jasan,ježek,jak,předjezd,převis,jezeďák,visovat,jediný,jíška,Hess,jikra,projekt,jevit,zjasnit,viset,pojezd,jet,Jinek,deismus,vosa,Jidáš,řasa,Jasper,viks,jih,jam,losos,Java,visatý,přesný,pas,bez,whisky,zjízvit
Jiljí	jiný,jíní,jíl,Jinek,jinačit,vila,víla,bit,obilí,vilný,jít,jih,zajínit,vina,bílý,slina
Jinek	jiný,jíní
Jirous	Jirout
Jirout	Jirous
Jiří	jiřina
Joga	jóga
Joyce	oj
Juda	judo,Judea
Judea	Juda,judo,Judita
Just	justice,justovat
Jáma	Jamajka,jam
Ján	Jan
Jánoš	Janoš
Jáva	Java,jatky
Kamený	Kamenec
Kanaán	kanec,kanovník,kanál
Kant	kanout
Karel	Karen,Karela,kar,Karlik,kára,kariéra
Karela	Karel,Karen
Kartágo	kartáč,karta,Karter,kartotéka
Kladno	kladný,kláda,kládat
Klíma	klima,klímat
Kohl	Kohlík
Kongo	konec,konat,koncese,konev,kůň,koňařit,koncil,Koňařík,konto,koncesovat,koňak,kontinuovat,kontinent,ikona,košt,konsul,Koniáš,koncedovat,kůže,kondice,nést,Kott,kongres,konsola,zátinek,Kůst,Nikon,kost,kontovat,úkon,kontakt,King,Koperník,Kopernik,koště,neón,kontejner,kontoár,necky,kynik,konsonovat,kolo,konvář,kongrua,Kunc,zezákonit,křeček,kostkář,oko,sonet,přezka,koncept,Kunka,překovit,neřest,konšel,zinek,koza,skunk,koncert,kontura,kontrovat
Konstantin	konstanta
Kopač	Kopáč
Kopernik	Koperník
Koperník	Kopernik
Kopáč	Kopač
Korea	korec
Kosovo	kos
Kott	kotník
Kovač	Kováč
Kováč	Kovač
Kozár	koza
Koč	kočí,kočka
Košice	Košík
Košta	koště
Krakonoš	nakrakonošovat,dokrakonošovat
Krejčík	krejčí
Krn	Krnov
Krnov	Krn
Králik	Králík
Královák	Králík,Král,král
Králík	Králik,Královák
Krč	krk,krčit
Kuba	Kubák,Kubač
Kuchar	Kuchár
Kuchyňa	kuchyně
Kuchár	Kuchar
Kypr	kyprý,kypřit,kopr,zkypřet
Kysela	kyselý
Křepela	křepelka
Křiva	křivý,Křivák
Křivák	Křiva,křivý
Kůst	kost
Labe	lábat
Ladislav	Vladislav
Lange	lano,Laník
Laník	Láník
Laura	lazura
Lena	len
Lenin	lenit,len,Lena
Leona	Leontina
Leontina	Leona
Levit	levý
Leš	lešení
Lhota	Lhotka,lhůta
Liba	Libý,libý,Libye
Libye	Libý,libý,Liba
Libérie	Liberec,liberovat,libý,Libý
Libý	Libye,Liba
Litva	litec
Lojza	lůj
Lombardie	lombard
Louny	Loun
Loučka	loučit
Lucern	lucerna,Lucie,Lucián,Luter,luterán
Ludvík	Ludvíkov
Lyko	lýko
Láník	Laník
Lída	lid,Ledeč,led
Lízal	lízat
Lýd	Lýdie
Lýdie	Lýd
Magdalena	Magdaléna
Magdaléna	Magdalena
Mali	malý,malina
Malta	maltárna
Malát	malátný
Manet	man
Mann	man
Mansfeld	Mansfield
Mansfield	Mansfeld
Mao	May,mat,Mání,mávat,mnout,mast,mák,sedma,mást,mazat,máj,Masný,Máša,mošt
Marathon	Marathón,Marátha
Marathón	Marathon,Marátha
Marek	Mareček
Mareček	Marek
Maria	Marija,Marie,mariáš
Marie	Maria,mařit,Marek,Marija,mariňák,Mareš,mariáš,Mars,Maroko,Mareček,markýz,markovat,máry,marod
Mars	Marek,Marie,Maria,máry,Marcos,Mareš,Marx,markýz,markovat,Maryna
Marten	Martín
Martin	Martinov,Martín,Marten
Martinov	Martin,Martín
Martín	Marten,Martin
Maryna	máry
Masný	masa
Masár	masař
Mater	mateř
Matouš	Mattuš,Matoš
Medek	medit,Medina,med
Meroe	merk
Mesa	mísa,mést
Michal	Michalov,Michalič,Michael
Mikes	Mikis
Mikloš	Mikloško
Mikuláš	mikulášenec,Mikoláš
Mikulík	Mikulič
Minos	minus,mina,minuta,Mináč,Mína,Ming,mince,mimino,minomet,osmina,menšina,Mitis
Modra	modrý,Modrák
Monako	Monet
Monet	moneta
Morava	Moravany,Moravsko,Moravan
Moravany	Morava
Moravsko	Morava
Motýlek	motýl
Mácha	máchat
Mání	mánička,man,mánie,Mánes,May,mat,mávat,Manet,mák,manko,Mao,zmanout,máj,vymanout,namanout,Mann,Máša,Maňas,maňas,mnout,mango,malý,mošt,manekýn,Omán,Manila,máčet,macek,vymanit,zamanout,Mali,mačkář,Mína,rozmanitý,mást,umanout,mast,matka,Maňovice,men,míč,Macov,zmátnout,mandát,Masný,Aman,mandant,meč,mina,moč,malina,mapa,amant,dýně,malovat,rozmar,dát,matika,mazat,most,mangan,mošna,Dan,moci,mařit,Menšík,rozmáčknout,Mácha,Roman,mínit,mašle,namáčknout,mnich,Rayman,Málik,vymáčknout,dynamo,menšina,máma,Macák,máry,daněk,podmanit,Malič,dna,Manuela,román,Román,mateř,monský,pomátnout,Najman,pomalý,Maur,mít,milý,minuta,sedma,Malec,Monet,vát,masa,Mňačko,Melk,Dán,zmačknout,zmálit,Ming,um,menšit,zmatit,Mars,maso,mrně,manuál,minus,Monako,Méty,namátnout,Míla,Makov,Mináč,domáčknout,vana,mandel,manažovat,močka,míle,zoomovat,zeman,dařit,macecha,rýma,moc,daň,Mikes,mělký,měkký,Maryna,zmenout,soma,přední,vně,příroda,duše,Maria,odmáčknout,dům,mince,máchat,maska,Yale,Mencl,maják,Marek,Minos,jíní,dno,múza,Romanov,mašina,Daan,masař,muset,zmáhnout,Malát,promáčknout,mlčet,den,dar,Mazák,magnát,přímo,mok,Anna,doba,Madona,dout,banát,Mater,máslo,romantika,Machyna,manifest,rozmarýn,promoce,Malín,zmatnit,Don,Malta
Méd	med
Míla	míle
Mína	mina
Mělník	mělnit
Nat	vně,nový,oj,nynat,vát,nit,necky,pot,půst,cé,znát,Novák
Nazaret	nazarén
Nick	nit,nový
Nietsche	Nietzsche
Nikola	Mikola
Nizozemsko	Nizozemí
Nor	nora
Novák	nový
Oborný	Zborný,Voborný
Odry	drzý,Dora,podrost,dres,drúz
Ola	Zola,olovo,Olina
Olymp	Olympie
Olympie	Olymp
Opasek	opak
Ota	cé,otec,oko,attika,Stin,antika,atika,nota,ovce
Paka	pakt,pak
Palau	Palata
Pan	pán,propan
Pankrác	punkrock,panker,pancíř,pančovat,panda,panter,panika,Pan,pan,pantáta
Parma	rýma,Pareto,Párs
Pašta	paštika
Peck	pec,pecka
Pelé	Pelin
Perout	Peru
Persie	persistovat,pero,perioda
Peru	Perout,Perun,pero,Perota,Peruán
Petrarca	Petrarka,Petrák
Placht	plachta
Pluto	pluk,plátno
Polena	poleno
Polsko	pole,police,polní,políček,policie,půl
Pop	op
Portugalsko	portugal
Praha	prahnout,práh,zapráhnout,zápraž,pražit,vyprahat
Prajz	Praj
Proteus	protéza
Provence	zvencnout,Vencl,prevence,ventil
Provázek	provázet
Puk	puč
Pásek	pás,pást,pásnout,pak
Rojka	roj
Roman	Román,román,Romanov
Romanov	Roman
Román	Roman
Roub	roubit
Ruda	rudý
Rulík	rulička
Ráb	rab
Scot	Scott
Scott	Scot
Semily	semita
Severa	sever
Siva	sivý
Skála	Skalka
Slavia	Slávie,slavit,Sláva,Slavník,slavík,Slovinsko
Slepička	slepičář
Slezsko	slez
Slávie	slavit,slavík,Sláva,Slavia
Smola	smůla
Smíchov	smích
Sokrates	Sókratés
Soliman	Solimán
Solimán	Soliman
Sparta	parta,pasparta
Srna	srnec,Srník
Stalin	Stalinov
Stalinov	Stalin
Stone	stonek,stonat
Stříbro	stříbřit,Stříbrný
Sudek	Sudety,sud
Sula	sulc
Sura	surový
Svatý	svat
Sviny	svině
Sókratés	Sokrates
Sýrie	sýr,Asýrie,sýřit,série,syrový,síra,Smrk,smrk,syrečkář,srp,Srp,sirý
Tate	tát,táta
Teige	Teigov
Teka	tečka
Telč	tele
Tisa	Tisov,tisíc
Tomáš	Tomášov
Tomášov	Tomáš
Tonga	tonout,tango,Oton,tonus
Trent	Trentin
Trenčín	Trenčan
Trója	Troják,trojice,trojka
Tursko	Turek,Turkit,turkický
Tutu	tutový
Tyl	týl
Tyr	Týr
Týr	Tyr
Updike	update
Val	válka
Vala	Val,válka
Valentin	Valentina
Valentina	Valentin
Vaník	Vaněk
Vaněk	Vaník,vana
Vela	velký,novela
Vietnam	vietnamka
Vlach	Vlachov
Voborný	Oborný
Voda	Vodák,vodovod
Vodák	voda,Voda
Vondra	Vondrák
Vondrouš	Vondruš
Vondruš	Vondrouš
Votus	tu,Lotus,vkus,okus,votovat,vous,tuš,Roztoky
Vrana	vrána,Vraný
Vraný	Vrana,vrána
Vrba	Vrbata
Váh	váha,váhař
Válek	válka,Valeč
Vína	víno,vina
Věra	víra,věrovat
Wells	Welles
Wild	Wilde
Zambie	ambit
Zapata	pata
Zborný	Oborný
Zdena	Zdeněk
Zdeněk	Zdena
Zita	zíta
Zlín	zlínět
Zmij	zmije
Zola	Ola
Zrůst	vzrůst
Zuza	Zuzák,Zuzana
Zuzana	Zuza,Zuzák
Zuzák	Zuza
Záhor	záhoří,záhoř
Závada	zavadat
Závora	závorář
Zázvora	zázvor
absolutní	zabsolutnit
agent	Gent
agrese	regrese
akce	akcie,aktin
akcie	akce,aktiv
aktiv	aktivní,aktin
aktivní	aktiv,aktin
alarm	alarmovat
album	albuminóza,Albany
albín	albína
alogismus	neologismus
amalgam	amalgám
amalgám	amalgam
amortisovat	zamortisovat
analysovat	zanalysovat
anténa	anténář
apotéka	apatie,apatekář,protéza,Teka,antitéza,Zapata,Azték,Potter,patetika,tečka
armatura	armaturář
asimilovat	assimilovat
ateismus	teismus
aut	auto
auto	aut
avízo	avízovat
azyl	lůj,Doyle,oj
baba	Bába,bába,Babák
babičkovatět	zbabičkovatět
bachor	báchorka,bachař
bahno	zabahnout
bakterie	baterie
balet	baletit
balonář	balon
balzám	balzamiko
banka	baňka,báň,bán,nabančit,banket,bánit,banán,Bantu,bantovat,zbančit
banální	banát
baryum	Barnum,Barma
baterie	baterkář
bazar	báze
bačkora	bačkorář
bekat	békat
beryl	berylnatý
bez	bé
bigbít	bigbeat
biomedicína	medicína,medicina
bioterapie	terapie
bit	bít,bítník,bé,bečka,jít,bílý,Ben,bez,jíní,být,bízet,bát,obec,Benák,zdobit,binknout,bikovat,beat,Bíl,vybičit,bdít,běl,jiný
blahý	bláha,Blahynka,Blažek
blb	blbý
blbý	blb
blesk	bleskat
blok	bloknout
blyštět	blyštit
bláto	Blatný
bob	nabob
boj	Bojan,Bój,záboj
bolet	Bolev
bomba	Bombaj
bouda	Boudný
boule	Boulez
brnkat	přebrnkat
brodit	Brod
brok	Brook
broker	Brooker
brum	Broum,obruba,ubrus,Broumov,brunátný,brunet,rum,brusnice,Brusel,Brunej,brusle,Brod,brumlat,rubrika,Dobruš,brzy,obruč,brouk,zrumit,brožura,brož,Brož,brojit,brousit
brunet	Brunej,brunátný
brzy	Brdy
buk	bukovat,bučet
buldok	buldočit
burza	Bury,Burda
bus	buk,bos
business	busking,businessman,bus,Bosana,Bush,bosovat,Musset,Bosna,Bosch,bos,bušit,obušek,absint,Odyssea,zbyzantinisovat,zjudaisovat,dusit,Buda,báseň,zesivnout,zabřídat,Bouška,bouda,Botswana,buk,Budišov,Disney,Zimák,bukovat,Březina,džinismus,básníř,bukařit,bas,justice,sinus,vyssávat,siný,Musil,budovat,odbuzovat,přisýchat,bufet,nudismus,Buquoy,zperiodisovat,insinuovat,přebodovat,deismus,Boudný,síň,zima,zmusit,sadismus,syndikovat,syn,zabasantit,Březa,dusný,Rusín,zdesinfikovat,přisouvnout,Mussolini,zásoba,zabudnout,zabásnout,visnout,přesýchat,dosýchat,Budín,deionisovat,zdynamisovat,bříza,Justýna,vsáhat,Vanessa,osoba,Sibiř,Sába,dosrat,skoba,dosystemisovat,rozbřesknout,baset,bufat,dusat,bodat,vous,judo,bukanýr,výbušinář,Nikósie,břídit,Juda,zrusisovat,dissekovat,zaboudit,brusnice,box,osma,Kosina,činže,předseda,zesýřet,Just,siena,sezdat,Denis,pusa,Budislav,zabřesknout,muset,uzda,indosovat,zesnědnout,vybřeskovat,zasychnout,Doboš,Ibsen,odsouvnout,českobudějovický,dobuzovat,apsida,Dumas,svoboda,vyosit,Judea,bředat,nacismus,přísný,sytý,přisychat,příbuzný,duše,Bask,zpoetisovat,embosovat,King,misie,syndikát,Jusupov,báze,synoda,zadostčinit,bouchat,systemisovat,zabředat,zposvátnit,Justinián,nádoba,budoár,autobus,prosit,rozesýchat,vosa,zintensivnit,bota,Indonésie,přesychat,zionisovat,sezóna,ďas,absence,sorbovat,Rousseau,bomba,disipovat,zestetisovat,buddha,Buddha,poetismus,Persie,submisívní,Bresson,přísnit,justifikovat,Bates,Březiněves,prosýchat,syntetika,bok,přisrat,jod,Rosza,zoperetisovat,březí,zasýchat,dosedat,ionisovat,zposvátnět,zabřezat,přimáčknout,Zuza,Sasín,visovat,Dionýsos,Bessel,bochník,Budějovičan,baptismus,vysýchat,Judita,brousit,seno,recesismus,rozsýchat,zintensivňovat,disonance,rozbředat,sosat,design,bzdít,Sueb,díže,Sysifos,přibíhat,skin,bonsaj,zadostičinit,disonovat,Zuzák,břevno,bodyček,Dušín,buchta,zabukat,obdukovat,syntéza,řidnout,Sinhal,osýchat,doba,zbodřet,sítina,dosychat,Sion,ubrus,sobota,justovat,usýchat,diskuse,zdomácnit,zasouvnout,mikrosmat,buchat,vybříst,Břest,boukat,Duša,Nos,nos,Douba,Tswana,bída,zurbanisovat,Bursík,bunda,zdomácnět,Zeus,synkretismus,zbásničtit,zděř,přizdisráč,Domingo,zmetodisovat,zabotanisovat,dimense,vybředat,dostejskat,visatý,Osetie,Jut,animismus,bonifikovat,viset,Prus,zrajonisovat,deska,skinhead,Doksy,cessionář,zakabousit,Podsedník,zprimitisovat,podsada,dimenze
businessman	business
busking	business,bus
buňka	Bunin
bydlet	rozbydlet,bydlit
byte	být,bytnět,Bajt,bota,nadbytek,bé,zbytkař,výt,Baťa,bača,bečka,nýt,nýt,obec,Bates
bába	baba,Babák
bádat	nabádat
bán	báň
bát	dbát,zobat,bé,bača,bál,bácnout,bán,bit,Baťa,batika,Ob,obec
báze	bazén
báň	bán,banka
bé	bečka,bez,Ben,bit,obec,bát,Ob,bít,Benák,beat,bízet,zbůst,oblý,jíní,dé,Benátky,býk,zet,blůza,dbát,oj,být,zvát,zvát,jiný,bača,binknout,Biela,zen
békat	bekat
bílý	Bíl,Běla,běl,Bělina,bít,Bělov,Bělík
bít	bit,bítník,bílý,být,běl,Bíl,bečka,bé
bóje	Bój
být	byte,bít
býčit	býk
běžet	běženec
bředat	vybředat,zabředat,rozbředat
břeh	Břehov
březí	Březa
bříza	Březa
bůh	Božka
camp	Camus
car	cárat
cena	cent
chalupa	Chalupník
chan	chán
chaos	chat,Antiochos,chasa,chata,chám
chat	chata
chata	chat
chcát	ochcat,nachcat,přechcat,zechcat
chlup	chlop
chopit	Chopin
chorý	Chorvat
chrastit	Chrasta
chrom	chróm,chromý
chromozom	chrom
chromý	chrom
chroptit	chroptět
chroptět	chroptit
chroupat	chrupat
chrupat	chroupat
chróm	chrom
chvalořeč	chvalořečit
chvalořečit	chvalořeč
chvost	chvoj,chvět
chvíle	chvět
chán	chan
chřest	chřestit
chřoupat	chřupat
chřupat	chřoupat
cibule	Cibula
cifra	cifrák,šifra
cimra	šimrat
citron	citrón
citrus	citrusář
clo	clona,Ela,cé,štvát,ovce,Eva,sklo,echo,alt,Ivičič,ovoce,lnout,oko,zelí,Antily,Clovis,kilo,sto,Ota,Keňa,okno,klovat,vně,Kováč,Štenc,kat,Vey,antika,kov,attika,kvák,antikva,cvok,Kovač,deka,kvačit,šek,cval,Ivan,Klos,etika,sekce,skica,kát,štika,Štika,tele,tnout,naiva,delta,oj,klozet,Kelč,Ola,káva,céva,zajíc,Nat,záře,vnuk,Ottawa,čin,zoctit,vát,kelt,Poe,cena,Evenk,ujec,set,dé,dekovat,kost,klnout,knot,datle,seno,koza,ovál,zet,Cayenne,akce,čaj,veka,rek,čelo,Telč,pocta,nikl,lnář,necky,dekl,Detva,octnout,stlát,Iša,dík,atika,otec,Yale,clavecin,nový,vnikat,košt,olovo,kar,rvát,čtát,Čad,zatkat,Kott,zátka,příští,car,klika,dock,čokl,Lvov,Ibo,Evans,Stoy,cárat,vnukat,tlak,šťovík,kolna,vosk,glie,ucho,šlicovat,pot,učit,šnek,Doyle,rekce,ejekce,koště,Atény,skicnout,Zola,dok,relé,cvočkář,Altaj,octář,kníkat,klát,cello,kluk,sekta,Kůst,kecat,šťáva,cvičit,Vlk,vlk,Zita,preclík,pravý,rokle,anténa,keš,secese,cech,Ilava,anýz,šlak,nok,Anna,předek,Mikes,dno,celý,víko,čina,kvalt,Elam,kanout,kino,Watt,watt,Václav,štěně,Ulč,Weil,nést,půst,Kloc,lajk,Stin,ret,dna,Avila,vata,klon,oktáva,štos,Inuit,čeka,cvočkař,štkát,akta,keř,klinika,Zvíkov,oves,klkat,vlna,štok,dýka,eklovat,um,Klára,vikev,Eliot,uzelník,sex,Ištván,Dyk,inovovat,čára,ven,zelený,číš,lov,Štýr,nach,elita,vina,oktan,zátinek,Sláva,čočka,tlouci,zvát,zvát,éter,setkat,Čech,láva,ocet,Sup,kvičet,Reynek,Novák,Kloss,kdy,štír,klíč,Klíč,zívat,zenit,Nostic,čich,Nekovář,sova,Sova,Sovík,klátit,kýč,Katyna,Navajo,sivý,sokl,Avar,skin,překovit,entlovat,véčko,kaše,cvakat,cekat,Akkad,Stone,zen,Seneka,avízo,sen,akcie,kára,olše,lát,sekat,proc,zelina,Zelina,tank,out,Kanak,čáry,Nara,náčelní,aval,Otava,Šlikov,katit,rejd,sok,stoik,divý,kozák,škot,sát,kynout,svat,dole,Oscar,kyt,atak,chat,eroze,vejce,doch,Onan,kolo,rozvoz,sud,klec,Dewar,cancat,tkát,čekovat,Svatý,svatý,diktovat,polní,voština,taj,kalý,Řek,Keynes,den,Křovák,kápo,pod,lev,příčit,zvěr,vana,scan,Wood,čnít,vykat,řvát,Klíš,Alán,nakárovat,Aš,donace,levý,série,scéna,iont,čít,veto,jíní,Mekka,Oset,zout,siena,včela,vak,přesný,vila,scout,štelovat,osev,Nick,Laos,Košta,zlý,novela,Ryk,ocel,tknout,čtverý,kázat,Weiss,Steklý,evokovat,alej,kvokat,škoda,onikat,elév,klíště,kárat,mech,vosa,ananas,op,Kent,konat,vůně,Čou,veš,zátiší,síci,Váša,gnose,Renáta,iks,Vánoce,zlatý,zlatý,zkérovat,detekovat,pošta,Knap,pracka,chata,šluknout,ikona,doktor,Alávita,Joyce,koala,příst,kvíkat,víno,přít,retina,Kyjov,Kysela,Kain,aktér,provoz,Wells,přecviknout,rycnout,nota,Ob,Coen,rovný,Rovný,okus,Nos,nos,osa,ocas,eses,zeť,látka,kanec,růst,Siva,vset,cákat,Kikuj,věno,senát,ulláh,voj,rez,ateliér,noc,teze,práce,povyk,tlustý,sůl,tajný,snout,Přerov,Karela,Šťavík,Kap,cejn,Alpy,lozit,Venuše,vnoukat,klučit,lkát,Vyškov,zíta,sliz,jiný,iluze,kyselý,kůra,Zátor,téci,kakat,potkat,katar,klinkat,deal,etan,Kozár,uvykat,prak,atom,dout,řeka,přezka,úcta,kajak,Clinton,Zuna,kakao,Zdena,chovat,dolňák,teč,konec,kos,celovat,vnadit,střecha,přední,zeď,aktin,recese,Vichy,kničet,Olina,unie,svůj,kňučet,okenář,Melk,výt,Teige,škodovka,nářadí,nit,Scott,unita,elevovat,Vela,klas,šlojíř,vyštkat,Šlosar,agáve,Zeus,ves,pero,Vend,Aleš,káča,upír,Šik,klást,glosa,zatíkat,střeček,ion,prostý,část,laik,len,ořech,Teka,cent,štít,anektovat,Kiel,uniat,Vencl,udice,příčina,etnikum,láce,ulice,Antal,Kant,etiketa,metla,Kladsko,Ikar,zem,Čud,datel,sít,pozice,kotník,čnět,osel,oliva,Oliva,Čenkov,celta,prát,Praj,antikizovat,Slávie,čáp,Don,kyan,Kavan,Vaník,kanár,vést,šlíra,klín,uzel,Váh,tanout,kynik,avalovat,šlakovat,kojit
court	courat,couvat
cucek	cucat,cuckovatět,cuchat,cukat
cvok	cvočkář,cvočkař,cvičit
cvočkař	cvočkář
cvočkář	cvočkař
cyklus	cyklokros,cyklona
cé	Ota,oko,ovce,tele,pot,otec,Telč,Nat,ovoce,sto,oj,vně,ujec,dock,dé,vát,alt,Poe,nový,zajíc,Antily,ovál,záře,antika,čin,Ulč,tnout,zet,Stin,Vey,atika,clo,kost,attika,out,půst,set,cena,kov,Stoy,Doyle,teč,necky
daněk	Dan,daň,Daniel,Dán
dar	Dárí,radar,dařit
datel	dál,dát,daleký
daň	Dan,Dán,Daniel
dbát	bát,nedbat
debrujár	debrujář
dehydrovat	rehydrovat
dekl	deka,Ola,nikl,dé,dekovat,deklinovat
dementi	demence
demoralisovat	zdemoralisovat
den	zen,dé,denár,dna,deka
deprese	represe,depresář
deska	desátek,deka
desátek	desátník
detail	retail
dezert	dezertovat
diferenciovat	diferencovat
diferencovat	diferenciovat
dimense	dimenze
dimenze	dimense
disciplína	disciplinovat
dispens	dispenz,dispensovat
dispenz	dispens,dispensovat
distanc	distance
distance	distanc
distribuce	redistribuce
dlabat	Dlabač
dlouhý	dlouhatý,dloužit,zdlouhavý
dmychat	dmýchat
dmýchat	dmychat
dna	dno
dno	dna,dé,dýně,den,Poe,déšť,dát,deka,půda,Dák,vně,přední,oj,sto,dík,Nat,Doyle,příroda,snout,půst,pot,dít,cé,podlý,dekovat,Antily,zeď,dnít,pod,donace,předek,ovce,Don,ďas,dýka,dock,deal,nový,zen,pozdě,Zdena,dítě,Ind,oko,vát,necky,voda,Voda,sát,nadít,dávný,Dyk,dioda,nářadí,seno,antika,zrno,datel,snadný,přesný,jiný,vdova,udit,Sup,Vey,zet,set,dívat,zlý,mnout,jíní,čin,Nos,nos,Ota,zvát,zvát,dout,soda,anoda,svůdný,zívat,zdát,udice,sud,Stoy,psát,řvát,um,ujec,zajíc,zeť,Onan,uzda,Zdeněk,různý,záda,dole,Dan,Zadov,sen,Dán,Inuit,dar,Daan,Ob,Zedník,Nostic,zem,denár,bé,vset,nést,oblý,Zdíkov,znát,dál,divý,kdy,alt,meč,Pozdník,dům,prostý,op,doba,síci,póza,Yale,Novák,Nick,pravý
dnít	znít,podnět,nit,nítit,zanítit,odpřírodnit,zenit,nový
doba	nádoba,dobnout,Dobš
dobrý	dobrodit
doch	ucho,duch,Zich,nach,deka,Ota,udice,dock,mech,antika,cé,dýka,ořech,čich,zeď,udit,nadít,Duša,pod,prach,edice,donace,ujec,cech,záducha,kdy
dochutit	ochutit
docpat	procpat
dokládat	ukládat,kládat
dokrojit	okrojit
dolar	solar
dole	důl
domejšlet	promejšlet,pomejšlet
domicilát	domicil
donace	Don
doprovodit	vyprovodit
dopřádat	opřádat,zapřádat,upřádat,vypřádat
doslat	poslat,vyslat,zaslat
dostat	ostat
dostoupit	stoupit
dostřihat	střihat,nastřihat
dostříhnout	stříhnout
dosychat	osychat,dosýchat
dosýchat	dosychat,osýchat
doufat	zoufat
dout	out,zout,rozdout
dovrtit	uvrtit,povrtit
dovíjet	províjet
dozor	pozor
dočmuchat	pročmuchat
doškicnout	oškicnout
drahý	dráha,Drahovice,podražec
dredovatět	zdredovatět
dres	dredy
drobet	drobit,drobeček,drob
drobit	drobet
družit	družička
drát	odrat,prodrat,dravý,zrát,orat,dráp,nadrat,zadrat
drén	drénovat,drenovat,dřín
držet	držka
dub	Dubček,Dubaj,zub,Dubeč,ďubka,doba,dobnout,dubl,dudy,ďubnout
duch	vzduch
duh	duha,dužina
dupat	zupat
dusat	dusný,dusit
duše	Duša,Dušín
dvojit	dvojí
dvojka	dvojí,dvojkař,dvojit,dvojný
dvojnásobek	dvojnásobit
dvojnásobit	dvojnásobek
dvůr	dvojka,vor,dvojí,dvojný
dál	dálný
dát	zdát,Dák,dálný,datel,dál,Dán,dna,dno,dávný,dé,Dan,prát,dout,datle,daněk,sát,přední,příroda,dýně,dávit,snout,dock,vně
dé	dno
déšť	dé,deka,dít,dno,dítě,zeď,dekovat,dík,zeť,den,udit,udice
dík	dé,Dyk,dít,dítě,deka,dýka,dívat,diktovat,zívat,Dák,Zdíkov,zet,dock,předek,oj,disk,déšť,Zedník,dekovat,dok
díra	Dírná
dít	dítě,dívat,dé,dík,rdít,nadít,zívat,déšť
dítě	dít,dívat,dík,dé,zíta,déšť,divý,rdít,zívat,zet,zeď,nadít,díra,Zita,udit,deka,den,díl,zděř
dívat	dít,dítě
dým	rým,dýmit,dýmkář
děd	dědit
dědit	dědina
dřevosochat	dřevosochař
dřít	dřín,zřít
dštít	štít
důl	dole
dům	um
džíny	žíně
ekoteror	teror
esej	eses,přesný,svůj,Esop
expres	exprese
exprese	expres
fajfkař	fajfkář
fajfkář	fajfkař
faktum	faktura,faktor
fant	fantom,Fantomas,zfantit,fan,fantóm,ašant,fantazie,fanatik,Diofantos,fág
fantom	fantóm,Fantomas
fantóm	fantom
fara	fárat,farad
farad	fara
farmacie	farma
fasit	fasovat
fasovat	fasit
fauna	faun
fašismus	neofašismus,fašisovat
fašírka	fašírovat
feminní	feminismus
fen	fén
fikce	fík,fikat,fičet,Fikar
fil	filc
filc	fil
film	fil
filosof	filosofie
finance	finále
firnovatět	zfirnovatět
flexe	Fleming
flitrovat	oflitrovat
fluidum	fluidní
flám	fláma
fláma	flám
folklor	folklór
folklór	folklor
forma	reforma,Forman
fosfor	fosforečný
frakce	frak
frank	Franky,Francie
frankismus	Franky,Franke
frčet	frčka
fárat	fara
gajdy	Gajda,Gajdar
galerie	galéra
gamba	hamba
gang	gangréna,gágat,gáže,Ghana,Nagano,gay,Gal,Gál,Reagan
gen	Gent,geneze,agent,génius,gejša,generovat,gel,Gét,Get,Henoch,Henry,gesce,hec,oheň,Cohen,Hejnice,agnát,gesto,Gera,agovat,oxygen,hyena,glej,regent,generál,Adygea,hecovat,hecnout,hejno,agentura,Ghana,cín,estrogen,gnose,gigant,energie,gay,gejzír,Genscher,Hein,Argentina,dogma,hejsek,enigma,glie,vagína,genealogie,gang,Eger,Gil,Aachen,gamin,agama,šína,Bergen,Hegel,gentleman,Gael,Hejl,hynout,agáve,hnůj,gajdy,autogen,hit,men,menšina,gelovatět,hlen
geneze	Gent,gen,agent
gesce	gesto
gesto	gesce,glie,Get,agovat,gestapo,agitovat,hec,gnose,hic,Giotto,geodezie,Hein,Eger,Gera,Google,regestovat,cesta,heilovat,hecovat,gejša,gen,sugesce,hit,zajíšit,agent,Aleš,chovat,Gét,Gent,gay,echo,šedý,lest,glej,mechovatý,list,les,heslo,šlicovat,mestic,Agus,šlíra,Lezga,agáve,cech,Reed,secese,Gil,Gessner,šíita,cedit,Lýd,joggovat,emise,host,mech,gel,agnát,Leš,Estonsko,úschova,Šemík,recese,geneze,švestka,Lýdie,Henoch,oglejit,reedovat,cedovat,Ugarit,hektik,glosa,hecnout,liška,dogma,hyena,zajíc,jih,glajchovat,Emil,amin,giro,agama,Hlinka,hoch,Haiti,zahejsat,led,šnek,lišit,ohm,chorý,chinin,litec,uzemit,Hood,lem,Lem,Mišík,Hlinsko,nach,převýšit,praxe,míšeň,lešení,hnout,Hejnice,hejsek,Chile,hovět,ledví,emetický,ucho,šlem,alej,doch,Eremit,Henry,eses,alergie,šek,aliterovat,anarchie,Nazaret,nacionální,antika,agregovat,řešit
glie	glej
glosa	glosovat,glie,gnose
golf	Goliáš
graf	grafit,grafičit,gram,grafika,ideografie,gróf,Gradiška,geografie,groš,paragraf,program,Graia
grafika	grafičit
gram	program,grad,Graham,gradovat,graf,Gradiška,Graia,agrární,chrám,granát,sociogram,gramatika,Aram,groš,granit,grafit,gradient,graduovat,Schram,Grégr,Grimm,Grygov,agregovat,Šrám,šrám,gramofon,grafičit,grafika
gubernie	gubernium
gubernium	gubernie
gusto	August
had	hadař
halda	haldař
halit	Halič,halíř
ham	hamita,Hamák
hanit	hanět
hanět	hanit
harmonie	harmonika
harmonisovat	zharmonisovat
hec	hecovat,hecnout,hic,žena,Hein
hecovat	hec
hejno	Hejnice
hejsek	hejno,Hejnice
helvet	helvít,Helvét
helvít	helvet,Helvét
hendikepovat	hendikepový
hendikepový	hendikepovat
hereze	Herder,heroin
heroin	heroina
historisovat	zhistorisovat
hit	hic
hladit	hlad
hlas	Hlásný,hlásný
hlava	Hlaváč,hlavička
hledat	hlédat
hloh	Hlohov
hlouček	hloučit
hloučit	hlouček
hlína	hlíza
hnout	prahnout,hníst,hnít,hnát,Hnát,hnát,hnanec
hnát	hnanec,hnout,hnus
hnát	hnanec,hnout,hnus,Hay,hnít,hníst,Vyhnal,Haná,Hana,hanit,ňahňat,rozhňahňat
hníst	hnít,hnout
hnít	hníst,hnout,hněvat
hobl	hoblina
hodina	hodit
hodit	hodina,hodovat,hodinkář
hokej	žokej
hold	holý
holý	hůl,hold
hora	horor,horna,hůra,horký,horovat,Horác,Horka,hoře,hornatý,Horniak,hořec,Hornik,hořký,hořet,horňák
horký	Horka
horna	hornatý
hornatý	horna
horolezec	horolezení
horolezení	horolezec
horor	hora,Hora
hospoda	hospodář
hotel	hotový
houpnout	zhoupnout,rozhoupnout,zahoupnout,vyhoupnout,přehoupnout
houst	houští,houně,houska,Houston,housenka,hustý,houžev,Hus,Housar,husa,host,Hood,houba
hovado	zhovadit,hovno
hovězí	Hověz
hoře	hořec,hořet,hora,Hora,hořký
hořec	hořet,hoře
hořet	hořec,hoře,hořký
hrabat	Hrabák,Hrabánek,Hrabal
hrabě	Hrab
hrdlo	hrdý,hrdlit
hrdý	hrdlo,Hrdina
hrnout	hrnec
hroch	hrot
hrom	Hroza,chrom
hromada	zhromadnit
hrot	hroch
hrozen	Hroza
hrst	hrdý,Hroza,hrot,zhrsťovat,hroch,hrozen,hrůza,hrdlo
hruď	hrudovat
hrách	hrát
hrát	hrách,hrana,hráz
hrůza	Hroza
huba	hubnout,hubit
humno	humánní,humus,záhumení,humanismus
husa	Husák,Hus,hustý
hvozd	hvozdit
hvězda	Hvězdář
hájit	háj,Háj
héros	Herodes
hřeb	hřebec
hřebec	Hřebeč,hřeb,hřebit,hřebenatý
hůra	Hora,hora
ideografie	geografie
idiom	oxid,ódium,Iša,identický
iks	viks,kiks,skin,Mikis,eses
impérium	imperátor
indukce	indukovat
industrie	industriál
inicialisovat	nainicialisovat
injekce	injektovat
intelekt	Intel
intendance	intendant
interna	interní,internovat
interní	interna,internovat,internet
intruze	intrudovat
ion	iont,kůň,Don,Vian,nový,oj,Onan,Sup,Lion,úkon,inovovat,Inuit,Novák,Nat,cé
iont	ion
iris	irisovat
jachta	jachtařit,vachta
jak	vak,Jáva,kajak,jatky,jas,Janák,Java,Ryk,Dajak
jam	jas
janičár	janičář
jazyk	jazyčný,jazz
jelen	Jelena
jet	jít,jetel,jíní,oj
ječmen	zječmenit
jih	jihnout,jiný,Jinek,jíní
jiný	jíní,Jinek
jitro	jitřit
jubileum	jubilovat
judo	Juda,Judea,Just,Judita,Buda,budovat,justice
justice	Just,justovat,Justýna
jáma	Jamajka
jíní	jiný,Jinek,jít
jíst	jistý
jít	jet,jíní,pojit,jiný,jitro,vít,Vít,bit,oj,jitřit,jetel,Jinek,víjet,Jiří,jevit,růst,jíst,rozjívit
jóga	Joga
kabel	kabela
kabonit	kabonět
kabonět	kabonit
kadit	dokadit,kadet
kakat	kakao
kalich	kalit,Kalinin
kalit	Kalinin
kamna	Kamený
kampan	kampaň
kampaň	kampan
kanava	Kanak,Kanaán,kanec,kanál,kanár,káva,kanovník,kanout,Kant,Kanada,Kavan,kanelovat,kanyla,kánoe,kat,kakat,kantýna,kakao,Keňa,kát,navykat,kašna,kancelář,Zykan,kancléř,Kain,Kantor,kantor,kánon,kanton,zakaňkat,káča,zakančit,Knap,Kaniš,kaše,kachna,Katyna,Kainar,kalý,katar,kníkat,kaviár,Kap,skokan,Dekan,katit,vykat,Čekan,kandovat,sekat,Kavkaz,přivykat,zkaňkat,kadence,káď,kar,Kent,kničet,kapka,kýkat,kalit,Kačalov,vnikat,čakavec,kynik,Kováč,kácet,Kalinin,kajak,Kansas,katoda,kadet,káchnout,kelt,okenář,pokaňkat,kázat,zatykat,zakniknout,knot,kazajka,kámen,Kovač,vnukat,Kikuj,kalcinovat,zakákat,čaj,klnout,šikana,Cayenne,odvykat,Kaper,kynout,zatkat,Kečua,Ilava,sekce,zanikat,dekadence,antikva,kapota,vynikat,kantořit,okno,Kokang,kápo,Čankajšek,Kelč,kino,kov,senát,kacéř,Mekka,klokan,kost,klovat,načančat,kňučet,uvykat,setkat,onikat,kadit,sklo,antika,Kalik,překacovat,Seneka,zvykat,etika,Kuťa,cekat,Čad,kaučovat,vačnatý,čekat,kapsa,kecat,kasat,Knapp,vyštkat,kostkář,přitakat,tykat,Kachyňa,kazit,klinika,Akkad,attika,kalich,scan,štkát,kilo,sekta,kýč,sak,katetr,kasa,uštkat,Kennedy,etiketa,kaple,košt,zkájet,kývat,pykat,kára,saně,Ikar,nakárovat,kanonýr,vakcina,Kateřina,cákat,Kňažko,Kamenec,deka,zátinek,zakáchat,kachlář,Křečan,kadeř,čeka,Kalous,čáp,King,kapsle,Inuit,Ota,kajuta,sanita,kasta,akácie,Navajo,Sláva,clo,makat,Klára,zpovykat,čáchat,přimykat,kaučuk,skica,vykácat,kokain,zacásat,sálovkář,kazeta,akce,zkajícnět,rozeštkat,přetýkat,Ignác,keš,knokaut,kyčel,čantovat,Kabát,kabát,Iša,kamna,klinkat,Kott,Kádár,čadit,kapr,skicnout,kameňák,kyan,zkalnět,Klos,Košta,klusat,eklovat,kuna,netýkavý,zajekat,vnoukat,Kajer,konat,kapela,Štenc,satan,Nekovář,kušna,kvák,koště,kniha,sáknout,koňak,inovovat,doktor,Kazach,kanibal,mykat,zmokat,kastle,zkvaknout,sápat,incidence,céva,vymekat,kukat,dekantovat,kýla,cena,savana,Kaiser,sanovat,konev,kuňkat,kejkle,kaštan,kosa,veka,navářet,koka,entlovat,Antily,Kamený,zalykat,Anna,klen,kaštanář,Kůst,neckař,siena,část,šnek,vícekancléř,kavalír,kvačit,kyt,Klaus,Ištván,unikat,zajíkat,kněz,usykat,překovit,kabala,Kamčatka,zajikat,koza,Čečen,jajkat,zinkat,zrkat,škála,Slavia,dokadit,oskenovat,oktáva,intuice,kaktus,tyknout,vikář,klec,čerkat,Kapoun,kapoun,čin,vina,Vokáč,zajíc,Kovařovic,kapraď,kitař,sáňkář,kýta,sankce,bekat,Čenkov,oktan,scéna,Stoy,stoik,klient,Kaleval,kalkul,Novák,předskokan,Kunc,Jinek,vak,vetkat,aktér,kapusta,Štika,štika,kárat,Detva,kvokat,konec,akta,savo,kapuca,keř,knír,Skála,skála,seno,kabina,čára,inklinovat,štvát,dotejkat,Dyk,sako,klátit,sto,skin,Slavník,klát,Keynes,koukat,okařit,pšenice,soukat,pyknik,kvíkat,klisna,kůň,znikat,Michna,povyk,dýka,akcie,dok,vokázat,akcent,kachlíkář,kárný,čina,Nat,klkat,zaštkat,kanón,stříkat,cé,cvakat,Karen,Stin,podsekat,škvíkat,Santana,uákat,satyr,konkatenovat,dekovat,Kysela,Čech,set,kandýrovat,Kladsko,dacan,Kasák,infekce,Vian,vycejkat,čas
kanec	Kanaán,Kanak,kanout,kanovník,kanár,kanál,kanava
kanout	Kant
kanál	Kanaán
kapela	kapelničit
kapitola	Kapitol
kapitál	kapitála,kapitán,Kapitol,kapitola
kapitála	kapitál
kapka	Kap,Kaper
kapr	kápo
kapsa	Kap,kapsle,kapka,kapsařit
kapuca	kapuce
kapuce	kapuca
kar	Ikar
karate	kárat
karbonát	karbonář,karbon,karbonatit,karbonyl
kariérismus	kariéra
kartouza	karta,kartáč,Karter,karton,kartotéka,kartón
kartón	karton
kasa	Kasák,kasat
kasat	Kasák,kasa
kat	kát,káva,katit,kakat
katalýza	katalyzovat
katar	kat
katit	kat
kazit	kázat,kadit
kaše	kašna
kašel	kaše
kde	kdy,košt,kosý,kost,koště,kýč,kosa,Kůst,Doksy,kynout
kdy	Doksy,Dyk,kde,Čad
kiks	viks,iks,kiksat
kladný	Kladno
klamat	sklamat
klas	klasika
klasika	klasikář
klenout	klen,klenot
klep	klepeto,klepat
klepat	Klepáč
kleč	klečet,klec
klečet	kleč
kleště	kleštit
klid	klidit
klidit	klid
klihovatět	zklihovatět
klima	Klimák,Klíma,Klimek,klimax,klid,Klimoš,Klimosz,klímat,kliment,klidit,klinika,klient,klisna,slimák
klofat	rozklofat
klonit	klon
klopotit	naklopotit
klub	klubko,kloub
kluk	klučit
klusat	Klusák
klučit	Klučov
kláda	kládat
kládat	kláda
klást	klas,kláda,klát
klát	klátit,Klatovy,klacek,klovat
klátit	klát
klín	klínit
klínit	klín
klít	Klíč,klíč,klín,klec,klínit,kleč,klíště
klíč	klít,kleč
kmen	kmín
kmín	kmen
knot	okno,zakniknout,kat
koks	kokos,koka,kosý,kočka
kolekce	kolektiv
koleno	Koleč
kolo	kolona,kůl,kolna,koláč,kolize
kolona	kolonie,kolo
kolonie	kolona,koloniální
komise	komika
komparz	kompars,komparovat
kompliment	komplement
kompost	kompot,komposice
komprese	kompresovat
konat	konec
konec	konat,kůň,konev
konev	konec,kůň,konat
konstanta	Konstantin
konstituce	konstituovat
kontinuum	kontinuovat,konto,kontura,kontovat,kontumovat,kontoár,konzum,kontakt
konto	kontovat,kontoár,kontinuovat
kontoár	kontura,konto,kontovat,kontinuovat,kontakt
kontrakt	kontrast
konverse	konversovat,konverzovat,konvář,konvenovat,konvergovat
kopa	kopí,kopt,kopie,Kopač,kopr,kopat,kopit
kopat	Kopač
kopec	Kopeč
kopie	kopit,kopa,kopí,kopist,kopčit,Kopeč,kopt,kopec,koptit,utopie
kopit	kopie
kopt	koptit
kopí	kopčit,kopa,Kopeč,kopit,kopie,kopr,kopt,kopec,čop,Prokop,kopyto,kopist
kord	akord
korec	Korea
korekce	korektní
korupce	korupčník,koruna,korozní,protikorupční
kos	Kosovo
kosa	kosý,Kosák,kost,kos,Kosovo,Kůst,sako,košt,vosa
kosmopolita	kosmopolitický
kosmopolitický	kosmopolita
kost	Kůst,košt,kosa,kosý,kos,koza,koště,kostkář,Kostelný,koka,oko,Kosák,okus,kov,Kozár,Kováč,Kovač,kozák,kostel,kosíř,kýč,Kosovo,čin,etika,cé,kočí,oj
kostel	Kostelný
kotel	kotit
koule	kout,kout,kouč,kotva,Kotoul,kotel,koza
kout	kouč
kov	Kováč,Kovač
koza	kozák,Kozár,kost,Kůst
kozák	koza
kočka	Koč,kočí,kočár
kočí	Koč,kočka,koka,kočár,Kott
kořist	Kořista
koš	rozkoš,Košík
košt	koště,kost,Kůst,kosa,koka,Košta,kosý,kos,okus,kostkář,Kostelný
koště	košt,Košta,kost,Kůst
kravál	Kravák
krejčí	Krejčík
krev	kreovat,krejčí,pokrevný,kráva,křeč,krém,Krist,křeček,Kršna,Krejčík,krep,krečovat,krátký,Kréta,krize,křivý,Krn,kritika,krk,Krč
kripl	zkriplovat,krize,krep,Křiva,kritika,skript,Král,král,krejčí,Krejčík,Křivan,Křivák,krojit,kreol,Krist,křivý,Králík,krejcar,kraul,krchov,krinoid
kritika	diakritika
krk	Krč
krojit	okrojit,Kroječ,dokrojit
krok	kročit,krokev,krosček,kros
krokev	krok
kros	krosna,krosček,krok
krosna	krosnář
kroupa	krupař
kročit	krok,nakročit,zakročit
král	Králík,Královák,Králik
krása	krást
krást	krása
kráter	krátký
krátký	kráter,krátkokrký,kráva
kráva	Kravák
krčit	Krč
kubík	Kubič
kuchyně	Kuchyňa,kuchat,Kuchar,biokuchyně,Kuchár
kudla	Kudlák,kudlat
kult	Kulka,okultní
kur	kura,kurýr
kura	kur,prokura
kurie	Kurily,kur,kura,okurka,kurýr
kurs	Kurš
kvapit	překvapit
kvarta	kvartet,kvartýr
kvartýr	kvarta,nakvartýrovat,kvartet
kvačit	kvák
kvák	kvačit
květ	květena
kydat	překydat
kyprý	Kypr
kyselý	Kysela
kámen	Kamenec
kánoe	kánon,kanout,Kanaán,kanec,kanovník,Kant,Kanak,Zykan,kanár,káva,skokan,kanál,kát,zakančit,kanava
kára	kárat,Káraný
kárat	Káraný,kára
kárný	Káraný,kára
kát	kat,káva,katit,kakat,kalý,kanout,vykat,kakao,katar,Katyna,Kanak,kápo,vnukat,Kováč,káča,Kap,Kant,okno,přivykat,kácet,kanec
káva	kát,kat,kakat,kakao,Kanak,kanout,Kavan,kanec,kanava,Kain,Katyna,káča,katit,Keňa,katar,kanár,Kanaán,Kant,vykat,Kavkaz,kaviár,Kováč,kalý,vnukat,knot
kázat	vokázat
káď	kadit,kadet,kazit
kúra	kura,kur,kůra
křapat	křápat
křest	křeček,křeč,křeslo
křeč	křeček
křik	křivý,Křivák,Křiva,křeč
křivý	Křiva,Křivák
křápat	křapat
křídlo	křída
kříž	Křiž
kůl	kolo
kůra	kůr,kora,kur,zakůrovat,kura,korec
kůň	konec,konev,konat,Nikon,úkon
kůže	koza
ladit	Lada
lahev	láhev
lak	láčka,lakýr
lampa	lampas
laso	lasice
lata	látka,latina,látat,lát
led	Ledeč
ledví	Ledvina
legie	legovat,legista
legovat	legie
lehký	lež
lekce	lekat
len	Lenin,Lena,lenit,Lennon,léno,líný
lenit	Lenin
lepit	Lepík
leptat	leptař
les	Leskov,led,lest,lis,lesnit,list,lísa
lest	les,list,lekce,lesnit,Leskov,ledví,Leona,Ledeč,zalesák,led,lísa,lesknout,lézt,nést,nalesnit,Leontina,protest,relikt,lýko,vesta,dolesnit,lem,Lem,plést,test,Lech,levý,litec,lev,vést,listen,ledkovat,Lion,cesta,vdolek,lednit,lít,lešení,lék,lízat,průlez,Leština,lenit,Lena,lítý,lekat,levný,čtyřlístek,Lída,Lenin,lísat,Leš,vlast,gesto,Lhota,ulice,nalézt,olistit,plast,odlevit,Ledvina,odlistit,gesce,lhůta,jevit,Levit,liktor,delšit,Lvov,alej,proces,jetel,Lezga,ulita,kolekce,Eliot,ujec,zálesí,jíst,zlevnět,jedle,Celesta,dole,léč,lis,Doyle,Aleš,plsť,ateliér,Lízal,plíce,veslo,Lear,Weil,zlít,veksl,neřest,perla,lnout,linout,přelítnout,lícit,odlistnit,likér,litice,dlít,líto,len,zalistit,veka,líc,plít,plít,lilek,plečka,číst,Válek,lůj,ulejt,Pesch,líný,Lýd,Litva,úlisný,vlízt,Vey,lijec,intelekt,letnit,ovce,Lyko,čtyřletý,Lýdie,nálevka,rozlítit,důl,nalejvat,projekt,plesat,liána,průlina,ves,level,slez,prolét,jez,telit,švestka,Levant,Lhotka,recese,elita,zalícit,jízlivý,analýza,rozlízat,Lessing,atestovat,past,proc,plečkař,lid,alkyl,vylevit,zlý,olše,Lér,zajíc,česlo,daleký,Yale,ulevit,řevnit,oves,jet,ventil,rozlítnout,lajk,Evenk,sled,nalítnout,přelejvat,část,přeslice,Valeč,lkát,česnek,olej,rozlejvat,poledne,zalítnout,lov,půllitr,nedůtklivý,zatesnout,lineární,litr,Poledník,následný,jesle,selekce,Leonard,Jeneč,převlek,plynit,zlítit,pes,Alijev,víko,převlečný,echo,prolejzat,vklesat,Ulč,linie,hlesnout,cedule,oblast,letovat,ucho,líh,sůl,údolí,jed,Olmék,laso,aval,otec,ulítnout,glie,kolektiv,těsto,Jelcin,telex,oj,Vlastík,lelek,eses,učitelík,Koleč,Dolejš,naolejíčkovat,póvlizovat,doproléčit,zalektat,secese,pěst,plech,livrej,letět,licence,veselý,Veselý,Reed,ulláh,Elster,předek,necky,vně,Nazaret,likérník,listonos,Olina,azyl,cech,cedovat,prevít,lžíce,Aventin,vlčit,pravý,Líšný,alt,píst,sliz,linkař,ejekce,záplet,většit,cé,Vít,vít,litera,plizovat,Čech,usoplit,telesetkat,vůl,Nat,rekce,nikl,prolhat,línat,blesk,zezlit,pesík,glej,valcíř,Mikes,lasice,Lojza,ovoce,čeka,podlý,rvát,předčit,vézt,podlízat,zaplynout,lišta,uvěčnit,Lesbos,vůle,ulhat,čtyřlitr,Lyon,častý,přestýlat,zkolektivnit,uzel,Ola,Slezsko,plena,agovat,Jedlov
letovat	Letov,letět
letět	letovat,Letov,letnit
lev	levý,levný,Levit,level,Levant,Lvov
levný	levý,lev,level,Levit
levý	lev,Levit,levný,level
lež	lehký,líh,len,Lér,Lenin,lenit,Lena,Lear,leb,zležérnět,lehkovážný,led,lažírovat,líhnout,lít,vylehčit,léno,líhat,Leona,vyléhat,Lech,litec,letnit,dlít,lev,Lem,lem,odlehčit,lítý,želet,lajk,lijec,letět,líhňař,levý,léto,uléhat,příležitost,ulláh,prolét,lednit,litice,Leontina,blížit,zlít,Lennon,litr,lyže,legie,zaléhat,Litva,Lion,letovat,vlažit,lanýž,nocleh,Libye,zlehknout,leasovat,líto,alej,ledví,Libý,libý,leader,polehčit,lahev,líný,blíženec,železo,ledkovat,Slíž,rozléhat,telit,láhev,Letov,Ledeč,blít,Lída,Levit,Parléř,želírovatět,legovat,Lažánek,liána,Lébl,lehkooděný,poléhat,Liba,plížit,cejch,Lahovice,líc,libra,přiléhat,zlehkovážnět,ježek,poleno,vylíhat,uložírovat,libreto,lilek,Lojza,telex,polehat,litera,olej,ateliér,les,žárlit,Lebovič,řeholit,rozlíhat,zlítit,legista,vláha,elegie,lnář,lnout,ložit,lék,lihovar,zlihovatět,nehet,uzlit,zlínět,dealer,lid,Anežka,lineární,nalejvat,liliář,levný,Leonard,želat,lov,lelek,larva,lebedit,lžíce,Lebeda,Levant,perla,Dolejš,čtyřletý,elita,rozlítit,jelen,nalétnout,Vyletěl,lajstnout,vlažný,lanolin,Leš,valcha,Labe,linie,přelítnout,lajznout,Leština,linout,liga,zliterárnit,litanie,lano,hlen,Polena,tíha,dolihovat,zlatý,zlatý,zcelit,léč,nalíhat,Laník,předlítnout,něha,Zlín,žlab,zletilý,teřet,žířit,Leger,valit,naolejíčkovat,Lýd,žito,lilie,rozlítnout,vhlížet,level,nadlétnout,prolejzat,rozlejvat,dolíhat,Valera,lata,Litovel,neteř,zpodlet,latina,nalítnout,valcíř,látka,ulita,Náhlík,láva,cech,zaoblit,zalíhat,lůj,lýtko,lícit,navelit,poohlížet,Želiv,Luter,linkař,Jelena,těžký,list,udolat,dlaha,žít,vylejt,Hlinka,nocležna,úloha,přelejvat,Loučka,Ledvina,lešení,odlétnout,Novell,lob,protežovat,bolet,tlít,vylétnout,Alijev,lajdačit,línat,luh,lidnit,Libuše,Lezga,rozlejzat,lézt,zalítnout,žehlíř,dolítnout,Lužice,ladit,pero,lajdat,líbat,tetelit,letovod,přenáhlit,perník,plynit,Hlinsko,šlíra,nížit,podlejzat,zlatět,volenec,zacelit,glie,lest,znáhlit,čtvrtletý,želé,Soller,vejl,ulejt,velebit,žena,livrej,Váh,zelený,čtyřlitr,nitro,volit,čižat,tér,režie,loupežničit,sled,aliterovat,rozčilit,vyžle,podlétnout,Lýdie,linkařit,čtyřspřež,zlevnět,pololežet,hotel,levitovat,Láník,ulítnout,čílit,docelit,vlítnout,dolétnout,lízat,zahlížet,dláždit,čtyřlůžko,lídr,cejn,vyoslit,zlatničit,užovka,delegovat,proletář,žehlit,louh,Žitný,klih,lapit,Helena,jehně,lát,Heller,zladnit,Eliot,odlevit,dolejzat,nalétat,nalétat,řehol,ucelit,sléhat,Litvínov,zezlit,vydlažit,voltiž,anilín,Velen,brojler,náhlý,lesnit,Žítek,žilet,nehetnatý,cello,zježatět,prolétat,želva,Jelcin,lepšit,zahoulet,přehlédat,Lach,rozlétnout
libra	Libý,libý,Libye
libý	Libye,Liba
lidnit	lid
lijec	Alijev,líh,litec,lůj,Lojza,Lér,kovolijec,Lion,linie,litice,líhnout,líný,liána,linout,něha,Litva,lajk,Libý,libý,lilek,ateliér,dlít,litr,olej,lov,lineární
lilek	lilie
linie	linout,linkař
linout	linie
list	lísa,lis
lnout	lnář
lob	Lobeč
lobby	lob,Lobeč
log	logika,login,enolog
logika	log,logistika,login
login	log,logika
loket	lokat,lokaj
lombard	Lombardie
lomit	Lomič
los	losos
losos	los
louka	Loučka,Loučný,loučit,Louny
loupat	loupit,lupat
louskat	luskat
loučit	Loučka,Loučný,louka,Louny
louže	louh
loď	Lodín
lub	Lubina,Lublin
lucerna	Lucern
lues	luk,Lucie,Luňák
lymfa	nymfa
láce	látka,láčka,lát,lata,latina,látro,Lach,láva,látat,lak
láhev	lahev
láska	laskat,lasice
lát	látka,látat,láce,látro,lata,lať,láva,láčka,latina
látat	lát,látka,lata
látka	lata,lát,láce,látat,latina,látro,láčka,láva,lať,lak
látro	lát,látka,láce,látat,lata,lať,latina,láčka,láva
lék	léč
léno	Lena,len,Lenin
léto	líto,letovat
lézt	nalézt
líný	línat,linout,líc,linie,lítý,zlínět,Loník,lít,len,Zlín,linkař,Lojza,lenit
lípa	lípat
lípat	lípa
lísa	lísat
lít	lítý,líto,litec,zlít,litice,dlít
líto	lítý,lít,zlítit,lítostnit,léto,rozlítit,zlít,nalítnout,litice,litec,lícit,litr,dolítnout,přelítnout,Litva,ulítnout,rozlítnout,dlít,zalítnout
lítý	lít,líto
lízat	Lízal
lýko	Lyko
macecha	macek
maestro	mastrovat,Masters,magistr,masterovat,strast,streamovat,štramák,Mastný,Nestroy,strom,magistrála,máma,strofa,ester,Masár,strach,ministrovat,mustr,štymovat,mast,menstruovat,izoterma,ostrý,Marek,Maxim,Madura,monstrózní,štrychovat,Street,mást,mateř,May,stroj,mámit,strýc,ostrov,Maryna,štreka,nástraha,ústroj,mašírovat,Marie,Mareš,masař,marnotratný,magie,straka,magor,matrovat,strana,Maria,estráda,machr,skromný,mašina,mumie,Mao,Mareček,Sumara,Castro,rozmarýn,macecha,Mart,Mater,migrovat,Magic,nezmar,Máša,Manchester,ministr,zeskromnit,odestřít,destruovat,matrika,demonstrovat,Marx,Marlow,Eritrea,Strašín,zestraničtit,štrůdl,Štýr,maximum,semestr,uskromnit,maškařit,macek,Mars,macerovat,astma,strojit,mačkář,moře,stréc,střecha,Macourek,štráf,zestrýcovatět,štrajkovat,Macov,sestřenec,Madeira
magie	Magic
malovat	malý,Malec
malátný	Malát
malý	Mali
man	Mann
mandel	mandle,mandl,mandant
mandl	mandle
mandle	mandl
marináda	mariňák
market	Markéta,markovat,markýz
masa	maso
masiv	masív
maso	masa,maska,mast,Masný,masiv
mast	mást,Mastný,Masný
masáž	Masaj,masař,masa,Masný,maso,masiv
masív	masiv
matka	mat
matrika	matricovat
maximum	Maxim
mazat	Mazák
mačkat	mačkář
mech	mechovatý
mechovatý	mech
med	Méd,Medek
medicina	medicína
medicína	medicina
men	Mencl,Mína,den,menšina,mínit,Menšík,nomen,zmenout
mentalismus	sentimentalismus
menšit	Menšík,menšina
merk	merčit,Meroe
metalika	metalista
metan	metanář
metat	zmetat
metla	metlář
metr	metrie,Méty,metér,metrum,Mitrov,mech,střevo,metoda,vítr,metanář,metla,metat,Street,mechovatý,meč,meteor,rozmar,střeček,strom,zítra,Mitrovic,Mečiar,vitrína,Meroe,mentor,míč,dveře,ministr,metlář,matrovat,metan,veltr,vnitrozemí
metrie	metr,symetrie,biometrie,detritus,dozimetrie,metrum,antropometrie,spirometrie,Dietrich,metér,trim,telemetrie,audiometrie,geometrie,potenciometrie,senzitometrie,matricovat,Mitrov,ekonometrie,Street,metat,meteor,detronizovat,triko,Méty,matrika,metoda,strom,Mitrovic,doktrína,trám,matrovat,trio,tréma,trik,strana,trokar,retrovir,Troy,mechovatý,Metternich,metanář,vitrína,trakt,matrix,travař,mech,tratit,yttrium
metrum	metr,metrie,výtrus
metál	metalika
mez	mést,míza
meč	míč
mečet	mlčet,meč
milý	milice
mimika	mimikry
mimikry	mimika,mimino
mimino	mimikry
mina	minuta
ministr	ministrovat
minus	Minos,mina
minuta	mina
mináž	mina,Mináč,mince,Ming,minuta,minus,zapomínat,Minos,minomet,dominance,Minařík,Mína,napomínat
misie	mísit,mísa
mléko	mléčit
mlít	mlíčný
mnich	Mnichov
mnohý	množný
moc	moci,mok,moč,mošt
moci	moc,mošt,promoce
modrý	Modra,Modrák
modus	móda,modem,mimóza,Modra,model,modrý,mozek,Mizó,mozaika,Modrák,modul
mok	moč,Močik,močka,dok
moneta	Monet
montovat	Montana
morf	morfin,Morse
morálka	moralismus
most	mošt
motýl	Motýlek
moucha	mouka,muškař
mozol	mozolit
močka	moč,močůvka,Močik,mok
moře	můra
mošt	most,moci
mrcasatit	mrcasatět
mrcasatět	mrcasatit
mrkev	mrčet,mrkat
msta	mít
muka	mukat,mouka
muzeum	muzejník,muzika
muzika	muzeum
muž	Mužík
mykat	domykat,promykat
máchat	Mácha
máma	mámit
mánie	mánička,man,Mání,Manet,Mánes,Manila,manko,Mann,vymanit,rozmanitý,Maňovice,manekýn,Omán,Aman,May,Máša,maňas,Maňas,podmanit,namanout,mango,mák,vymanout,mangan,mínit,zmanout,mávat,Romanov,Najman,Rayman,máj,men,mnich,román,Román,narkomanie,mat,Mao,Roman,malina,mást,mnout,Dan,daň,Macov,Neuman,zamanout,Mína,Mali,manažovat,umanout,mast,manéž,Malín,Dán,mošt,macek,mandant,Makov,zeman,mačkář,máčet,mina,menšina,amant,Mácha,mandel,máma,Málik,mařit,malý,Ming,Mnichov,monský,pyromanie,matka,Monet,matika,mandát,Osman,Masný,manuál,měnit,Daan,manžel,emanovat,Malič,mělký,mapa,Daniel,manikúra,daněk,Menšík,mateř,namáčknout,mašle,Malec,zmálit,masiv,míč,malovat,zmatnit,Majdan,mošna,maso,Minos,míle,mašina,Toman,zmatnět,minuta,udomácnit,Bynov,Mencl,mamon,Yankee,masa,Manuela,masív,dynamo,most,mince,zmátnout,vymáčknout,rozmarýn,Maur,Vaník,manifest,permanence,Mňačko,pomník,moci,Míla,máry,Don,Marie,minus,masař,manažer,rozmar,den,maznice,máslo,domáčknout,um,dna,mail,Mars,Méty,zmáhnout,Monako,fan,Markoman,masáž,sedma,rozmáčknout,Danaj,múza,maska,Maria,kajman,domnívat,vynímat,Marván,milý,showman,pomnít,Maryna,Macák,pomátnout,Machyna,menšit,Vian,mámit,dýně,dařit,Mašon,Masaj,Mináč,romantika,primán,mennonita,moře,mít,mandle,přímo,duše,Mazal,moč,monitor,míšeň,Mendel,Mater,macecha,zmenout,maran,minomet,promenovat,vyvánět,zmalit,namátnout,mandl,zdomácnit,muž,meč,udomácnět,máchat,animovat,osma,mazat,odmáčknout,Mastný,permon,Rainman,pšenice,příroda,zmatit,nový,zapomínat,Súdán,Přerov,Machač,soma,praxe,nomen,ataman,banán,rýma,připomínat,nezmar,promáčknout,Írán,Mališ,zapomnět,Melk,močka,madián,Michna,moneta,muset,Sodoma,Maor,odpřírodnit,bán,prizma,dům,Marek,mináž,Mikes,Fénicie,manévr,minimální,Madona,Šanov,měch,Vaněk,animismus,omalovánka,Ašanin,diamant,mělnit,deismus,magnát,zmačknout,sanita,pomalý,magie,neomalený,mol,suma,moc,maškařit,Magic,banka,manžeta,Šan,jméno,Duncan,mrně,Annan,Mynařík,napomínat,Radvan,mul,jíní,měkký
máry	Maryna
máslo	mást
mást	mast,máslo,Masný,Mastný,masa,Máša,maso,masař,May,Mao,masiv,mail,mák,maska,mávat,máma,mazat,mnich,Mání,masív
mést	místo,Mesa,mez,mestic,meč,mísa,míza,men
míle	Míla,mělký,Mílek
mínit	měnit
mír	mířit,Mirek,měřit,merk,moře,domírat,Meroe,Mojmír,merčit,zmírnět,Amor,umírák,můra,díra,vodoměr,skomírat,síra,Morea,Mína,Miřejovice,mít,Zmij,míhat,sýr
mísa	mísit
mísit	mísa,místo,misie
místo	mísit,mísa,město,mést,misie,Mesa,míza,míč
mít	Mína,míč,msta,mínit,Míla,milý,míle,Méty,máj,Mitáč,Mitis,mina,mířit,pomět,přimět,dít,měch,men,dítě,měřit,míhat,Mitrov,místo,změtený,meč,mýto,mělký,měkký,mýt,mat,sít,míjet,mést,Melk,minuta
míč	meč
mířit	mír,měřit
mýt	mýto,mýtit
mýto	mýt
mýtus	mýto
měnit	mínit
město	měsíc,místo,městnat,mísit,mísa
měřit	mířit
mřít	mříž,mžít,dřít,pýřit,udeřit,zapeřit
nacismus	neonacismus
nadrat	zadrat,odrat
nadzdvihat	nazdvihat
nadít	vnadit
nahý	náhlý,Náhlík
nakolejit	vykolejit
nakročit	zakročit,kročit
nalézt	lézt
napájet	pájet
napřahat	vypřahat,zapřahat
nasmrádnout	vysmrádnout
nastehnout	zastehnout
nastřihat	střihat,zastřihat
nastříhnout	stříhnout,ustříhnout
naturismus	turismus
navlhat	zavlhat
navrtit	vyvrtit,zavrtit
nazdvihat	nadzdvihat
nazvedat	zvedat
načrtat	črtat
načít	začít,začít,začít,zaonačit,čít,počít
necky	Nick,nový,neckař,Nat,nit,nést,Poe
nehet	nehetnatý
neonacionalismus	neonacismus
neonacismus	neonacionalismus,nacismus
neosurrealizmus	surrealismus
nikl	Nick,Nil,nový,nit,necky
niob	Ob,nit,nový
nit	nový,Nick,nítit,ničit,znít,Nil
nitro	nitrace,nit,Nitran
nobilis	nobilisovat,znobilisovat
noha	Noháč,nůž,hnůj,John,Honza
nomen	men,nominovat,pomnít,pomník,minomet,nomád,mnohý
nora	Nor
norma	Norman
novela	Vela,nivelovat
nový	Novák,nit,Nick
nudle	nuda
nést	necky,Nat,vně,Nick,nit,nový
nítit	nit
nízký	niob
nýt	výt
obec	Ob,bečka,bé
oblbit	zblbit
oblý	zlý
obr	brk
oběsit	zběsit
ocel	Vocel
ocet	ocel,docent,oceán,cent,cena,zocelet,céva,cítit,celý,ocitat,docelit,cech,zocelovatět,Vocel,ucelit,cejn,cello,zcelit,celovat,procento,kotit,katit,cé,proc,ucho,tele,zocelovět,acetyl,tkát,cejtit,vycejkat,zoctit,vycicat,celta,zcizet,kácet,dvacetník,otec,telit,tetovat,kotel,teta,Telč,census,ovoce,cekat,Ottawa,zacikat,kat,procitat,zcitovět
ochutit	dochutit,přichutit
odeslat	předeslat
odolat	udolat
odprdelit	vyprdelit
odpínat	podpínat
odpřahat	vypřahat,spřahat,zapřahat,rozpřahat,připřahat,přepřahat
odrat	prodrat,udrat,drát,drát
odsadit	podsadit
odér	dar,dozor,díra,dívat,zděř,Zátor,Dírná,Zour,user,dýka,zeď,Zeyer,dítě,Dora,dík,Ir,pod,dít,odzírat,série,záře,díže,rodit,Voděra,pozor,oj,dé,dinár,rozdírat,sýr,rdít,Oset,vzdor
oficiální	oficiál
oheň	Henry,Hein,hec,Hejnice,Henoch
ohlášet	vyhlášet
okno	knot,oko,Kováč,kov,Kovač,Keňa,dok,okařit
oko	cé,sto,Ota,kost,okno,ovce,kov,čin,zet,ovoce,koza,Kůst,Kováč,dé,oj,dock,okus,košt
okrojit	dokrojit,prokrojit,krojit
okrvavit	zkrvavit
oktan	oktáva
oktáva	oktan
okusit	zkusit,okus,zakusit
olovo	Ola,olovář,Olina
omrzat	promrzat
omráčit	zmráčit
omšít	šít
op	Pop,pop
opak	opakovat
opat	pat
oploštit	zploštit
oploštět	zploštět,oploštit
opláchnout	pláchnout,propláchnout,vypláchnout
oplítat	proplítat
oponovat	proponovat
oprostit	zprostit,zprostit,vyprostit,sprostit
optimalisovat	zoptimalisovat
optimum	optimát
opus	pusa
opylit	zapylit
opál	opálka
opřádat	zapřádat,upřádat,dopřádat,vypřádat
orace	orat,orátor,Orava,proorat,Dora,Raet,orel,ráčit,dravý,Uran,Ural,Rath,urin,odrat,Renoir,Zralý,zrát,rak,rána,Orta,zrak,dozorce,raný,ráčkovat,Irena
orat	orace,orátor,proorat,odrat
orchestr	orchestrovat
ordinovat	ordinář
orient	orientovat
osa	vosa,rosa
osel	síla,Oset,osev,Osetie,nos,Nos,sen,diesel,los,Nosál,sysel,sít
osev	Oset
osma	Osman
osoba	osobit
ostrostřelba	střelmistr,lukostřelba
ostruha	struha
ostrý	ostrov,strýc
osud	sud,soda,Sudek
osychat	dosychat,prosychat,osýchat
osýchat	dosýchat,prosýchat,osychat
otep	tep
otevřít	polootevřít,znovuotevřít
otrsat	trsat
out	dout,zout,zarout,aut,rozdout,Jut,vát,vně,půst,Nat,oj,psout
ovadat	uvadat
ovce	vně,oj,cé,Vey,vát,zet,Poe,sto,ujec,oko,Ota,deka,čin,záře,zajíc,dé,Nat,ovoce,Doyle,antika,um,rvát,veka
oves	ves,ověs
ovoce	cé,ovce
ozdravět	zdravět
ozón	zóna
očurat	čurat
ořech	Ořechov,vořech
oškicnout	doškicnout
ošklíbat	pošklíbat
oťupat	ťupat,poťupat
pacht	pachtit
padat	vypadat
pakt	pást,Paka,past,páčit,pak
palec	palice
palice	Palin
pan	pán
panel	pánev,pan,Pan,pán
panorama	panoráma
panoráma	panorama
papat	papá
paprsek	paprika
papá	papat,papája,Papák,papuč,papula,Papuán
parafa	parafin
parafin	parafín
paralýza	paralyzovat
parazit	parazitit,razit
parker	párkář,párkař
parodie	parodont
parodont	parodie
part	parta,partie,parter,párat,partykovat,partner,partičkařit,Parth,parkovat,Sparta,zpartekovat,párkář,nárt,pára,pár,párkař,Pareto,pero,port,partneřit,pářit,rozpárnout,pařák,partyzán,parker,Parker,Párs,parcela,partizán,spurt,Perota,parádovat,parírovat,čtvrt,perník,zapartykařit,Perout,parita,pnout,zpartykařit,pádlo
parta	part,Sparta
paráda	parádovat
pasivní	pasivovat
pasovat	pas
past	pást,pasta
pasta	past,pastvit
pat	pata,opat,pátek,zupat
pata	Zapata,pat,patina,pátek
patro	patrona,pátrat
patron	patrona
patrona	patron
paša	pašák,pašovat,Pašta,paštika,pašík,pach,Paka
paštika	Pašta
paže	pažit,pařez,panika,Panák
pec	Peck,pecka,Pecina,píce,péče,péci,pat
pecka	Peck,pec,Pecina
pelyněk	Pelin
pentan	pentle
penze	peníz
perzekuce	perzekuovat
pes	pesík,písek,ves,peskovat,píst,pás,Pesch,pec,oves,pěst,pas,vřes,viks,Pikt,Řek,Pásek,píka,Peck,píď,zápas,přesný,pasíř,Pšov,přísný,víko,píča,řeka,eses,pěší,past,jíst,pást,oj,kiks,pysk,ovce,prs,pásnout,les,průpis,um,převis,zem,povyk,příst,vsyp,proces,Nos,nos,Paska,pak,průsek,pasovat,předek,ověs,iks,půst,nést,česnek,Mikes,Řečice,péče,píce,ujec,čin,vně,otec,vést,Piave,záře,věk,pikovat,pšenice,plsť,oko,vosa,pat,Pěč,zpěčit,Pescar,zesýřet,pěstit,veka,vset,Novák,Poe,tisíc,zajíc,pasta,tečka,zatesnout,zesítit,zet,přírodopis,pecka,písničkařit,opice,Zvíkov,piano,Tisa,Teka,pot,přední,piksla,pnout,Ota,čísnout,zpívat,síci,pěkný,pod,Padova,osa,účinek,Vey,řečit,peníz,vosk,vak,cé,zpíčit,řepa,pestřit,dock,řevnit,účes,časopis,rek,teč,Nat,Sovík,Ulč,spasit,Sup,necky,viset,zeď,piknik,los,zen,jistý,Opasek,Dyk,pinie,op,Zeus,zátinek,pátek,pero,sůl,čina,pospat,Peking,ovoce,nový,voj,péci,čas,vize,pekařit,prst,vát,lis,visnout,pizda,dík,pastvit,jíní
pestřit	zpestřit
pesík	pes,peskovat
petržel	Petržela
piano	Piave
pila	píle
pindat	rozpindat
pivoň	Pivoňka
placatý	plácat
plachta	Placht
plachý	pláchnout,Placht,opláchnout,vypláchnout,plachta
plakat	plakát
plast	plastika
plastika	plast,zplastičtit,plastinovat,zplastičtět,neoplastický
platit	platina
plazma	plazit,protoplazma
plyn	plynit
pláchnout	vypláchnout,opláchnout,propláchnout
plán	Plánka,Plávka,plát,plát,planeta,zplanit,plátno,vyplanit,plankton
plát	plátno
plát	plátno,Plávka,plavat,plán,Pluto
plátno	plát,plát
plést	plečka,plít,plít
plíce	plít,plít
plíseň	plísnit
plít	plíce
pnout	pnít
pod	půst,Poe,půda,původ,zeď,podiv,zárod,podlý,vně,nos,Nos,pozice,podolí,póza,pot,pár,nářadí,vodovod,oj,dno,pozitivní,pouto,dýně,Pound,Nat,dna,Párs,zem,ovce,um,dům,záře,čin,zen,jod,příroda,op,zívat,donace,piano,Ota,Doyle
podestýlat	odestýlat
podmítka	podmět
podsada	podsadit
podsadit	podsada
poezie	Poe
pogo	Joga,poezie
pohřbít	hřbet
poker	pokérovat
polda	poldovák
pole	polní,Polsko,police,půl,polovat,poleno,Polena,políček,pól,poltit,policie
poledne	Poledník
poleno	Polena
police	policie
policie	police
polopatě	lopata,Lopata
pomejšlet	domejšlet
pomnít	pomník,zapomnět,pomněnka
pompa	pumpa
ponoukat	poňoukat
pop	op
popel	popelka
populární	zpopulárnit
porce	port
port	porta,porce
porta	Portnoy,port,porota,porce
poslat	doslat,zaslat,vyslat
pospíchat	spíchat
postlat	dostlat
posunek	posuněk
posuněk	posunek
pouto	pouť
pouzdro	pouzdrař,pouzdřit
pouť	pouto,půst,podlý,pot
povrtit	dovrtit,uvrtit
pozemský	pozemek
pozor	dozor
pozápadnit	pozápadnět
pozápadnět	pozápadnit
pozřít	zřít
počít	načít,čít
poňoukat	ponoukat
prak	práce
praktikum	prakticismus,zpraktičtit
praxe	udice,udit,zadina,dýně,pravý,Praha,Radek,prase,Praj,Antily,adovat,Doyle,deka,rejdit,aditivní,příroda,prýmek,přední,dinár,denár,předek,nadít,pradlář,nářadí,Rýn,ujec,jiný,ananas,prázdný,rada,antika,dívat,um,rejd,datel,den,zajíc,dekovat,cé,urna,dna,odpůrce,dioda
praštět	praštit
premiér	premiéra
premiéra	premiér
prim	prima,prémie
prima	primán
princ	princes,privát,prst,prérie,sprint
prizma	prima
prkno	prst
proces	proc
procuraindosament	prokuraindosament
prodrat	odrat
produchovnět	produchovnit
progres	progrese,progredovat
progrese	progres
projekce	projekt
projekt	projekce
prokura	kura
prokuraindosament	procuraindosament
promejšlet	domejšlet
promoce	moci
promrzat	omrzat
propan	pan,Pan,pán
propláchnout	pláchnout,opláchnout
prorok	rok
prosrat	přisrat,dosrat,přesrat,odsrat,usrat
prostý	sprostý
prosychat	osychat,prosýchat
prosýchat	prosychat,osýchat
protest	test
proud	proudit
provlhat	vlhat
provázet	Provázek
províjet	dovíjet
pročmuchat	dočmuchat
prs	prst,vyprsit,prim
prst	prs
prvý	první
pryštit	prýštit
práce	prát,pravý,prak,pracka,prach,oprať,uprat,naprat
práh	Praha,zápraž
prát	práce,uprat,pravý,přát,naprat,přít
prýmka	prýmkář
prýštět	prýštit
průduch	průduška
psout	vsout
psát	půst,příst,psout,vně,vset,pot,nový,přít,Poe,piano,snout,zen,prát,Nick,Nat,sát,vzít,pouť,Piave,přední,přesný,nést,půda,nit
pták	ptát
ptát	pták,Pták,uptat
pult	puls
punk	punč,punkt,puncovat,punktovat
punkt	punk,punč,punktovat,puncovat
pusa	pustý,opus
puč	pučit,Puk,pučet,půst,punč,vypučovat,pouť,počít,pustý
pučet	pučit
pučit	puč
pytel	Telč,zpyt,tele
pádlo	pádit
pájet	napájet
pálit	pálat,palice
pán	pan,Pan
pánev	panel,pán,Pan,pan
pár	pára,párkář,Párs,pářit
pára	pár,párat,spára,Párs,párkář,pářit
párat	pára
párkař	párkář
párkář	párkař
pás	Pásek,pas
pást	past,Pásek,pásnout,pakt,pás,pasta,pastvit
páter	páteř
páteř	páter
péci	péče,pécéčko,Peck,pec,píce
péče	péci,pécéčko,píce,píča,pec,Peck,zpíčit,píka,zpívat,pít,vypíčit,pátek,zpět,zpětit,zpěčit,pět,pevný,Pikt,pecka,pětník,Pěč,pečeť,peníz,píst,zpěčovat,pnout,pěna,Pelé,supět,zpátek,přepečovávat,píle,pétépák,pekařit,pat,píár,pentle,pnít,pěnice,zpětvzít,penze
píce	píča,píka
píka	píča,píce,Pikt,píst,pěkný,zpíčit,Pěč,písek,vypíčit,zpěčit,pít,péče,pět,pikovat,popíkář,pec,Peck,pěst,pětník,pěší,zpěčovat,opice,piknik,pěna,píár,zpívat,pitvat,píle,picnout,péci,pecka,zpěknit,pěnice,pikat,spíkr,vzpěčovat,pes,zpět,pást,pátek,pakt,pekařit,Paka,Pásek,Piter,řapík,zpětit,Piave,pinie,pak,pata,pila,Pila,supět,pnít,pat,píchat,pécéčko,čapíkovat,pesík,opět,spět,piksla,víko,pnout,páčit,příčit,Pecina,pás,pečeť,Pivín,píď,peníz,přítel,upír,Pop,pop,příčina,Piper,řeka,přít,zpěknět,půst,povyk,pech,odpínat,zápecník,pěchovat,past,pinkat,pikola,páteř,patetika,písničkařit,Pšov,příst,přepečovávat,průpis,vzít,úpět,op,Sup,Pelé,Vápeník,vápeník,pípat,zpátek,Řečice,Piťha,zátka,pikýrovat,pupek,pot,zpichovat,pěstit,optika,páter,Řek,čin,Petr,pepř,zopačit,zíta,piano,záře,patina,Spitta,pískař,Spina,pšenice,zpětvzít,pečivář,pepa,Pepa,popelka,řepa,panika,nasupit,pásnout,pětistovka,propan,zátinek,podpínat,Zapata,pipeta,spiknout,pivoň,Picasso,pinčl,zívat,Pesch,Čína,počít,Zátor,piklovat,Čapek,pískat,prst,pac,pospat,opak,pentle,přepona,penále,vzpínat,penze,epika,Zappa,čapět,popel,Popel,necky,rozpínat,pasta,spát,peklo,Pju,Pinkas,pakl,prospěch,přát,prkno,pecnář,provoz,průsek,veka,pikantní,pářit,čeka,Zvíkov,Poe,čina,opakovat,jíst,pevný,poříčí,potence,puč,rozpěra,oj,vně,pílit,kypět,Pozník,řečit,přispat,příjice,Pivoňka,sípět,přezka,Říčan,prostý,opat,Spěvák,zet,pasíř,Zita,psát,Panák,začít,začít,začít,zen,přívoz,zajíc,pápěra,překovit,zopáknout,papír,zpěvec,prát,páv,přesný,projekt,nový,zapovat,Paska,zip,vápeničit,načít,pas,říci,věk,Nick,pero,čočka,pizda,Viktor,pučit,Novák,zapevnit,zpyt,čpět,próza,Piccard,připásat,zčitelnit,patent,poníkář,vikář,peskovat,pětiletý,Pelin,pozice,zupák,půjčit,pupen,poník,propásnout,prvý,etika,Pétain,půl,pěnkava,Piast,Ob,čít,Napier,přepočíst,číst,Nat,pár,dík,ujec,jepice,Popper,účinek,předek,Petera,Proust,biopekař,oko,pýřit,dopink,prérie,práce,princ,zípat,zpříčinit,pach,perník,Peřina,Teka,závitka,pokoj,vést,prs,plsť,kopist,pustý,osopit,pionýr,políček,přípoj,Opočno,prozřetelný,pan,Pan,ovce,vypočinout,čnít,přísný,přední,zpovykat,pitomý,zřít,kopec,piškot,prak,zpopelnět,pouť,plíce,nikl,přepichovat,předpínat,neckař,pytel,různý,zápůjční,potkat,vápenět,zenit,Peking,pastvit,Vína,průčelí,řevnit,tečka,nést,pouto,Řezáč,supat,provozář,pán,neřest,kopit,Jičín,pole,Ota,vsyp,privát,naspat,spočíst,zupat,Vey,znát,viks,Piešťany,Puk,bečka,Kopeč,Prokop,otec,přízeň,sopka,prťák,Pešice,čnět,spíchat,pýcha,Spinoza,zpeřit,pilíř,uvěčnit,znělka,projekce,růst,zastřít,učitelík,příští,přepásat,zítra,pětituna,zeť,pauza,zaktivnit,uspíšit,pingl,vzácný,obec,čich,putna,piha,přeonačit,Úpa,zařknout,unita,ves,uřknout,perla,zkýčařit,piklit,zapšknout,paket,antika,zpevnět,plný,ničit,jíní,pačok,přispíšit,počínštit,plyn,přispávat,kopí,jít,precizní,učit,spočívat,teč,vůně,oponář,zápas,zátočina,vikýř,Pousta,čekovat,epitel,pištět,nit,kýč,pelyněk,Kůst,Opasek,pára,psout,zout,první,Čečen,Patočka,přísun,znatel,udit,přírodopis,udice,přitělovat,pykat,dock,pučet,vát,proc,unie,Ulč,vina,znít,značit,spěchat,Vopěnka,přivykat,Vaněk,Potůček,Pilát,tele,rozpočtář,opium,povysát,pysk,Vaník,odpočnout,pozřít,prior,nízký,průlina,Opava,úcta,Kovač,Provázek,pod,pouťák,zátiší,opuka,kost,pravý,protekce,Telč,Říp,zem,paprika,zákup,pranostika,pétépák,respekt,prstýnkář,pilot,zapeřit,vpírat,prokovit,zelí,pořečtit,jiný,vypeřit,optovat,utopie,Zrůst,věc,Kikuj,část,Praj,cé,Plzák,vyakčnit,zapchnout,Kováč,nota,police,přepírat,Zedník,vápno,papat,ústa,vít,Vít,pocta,Poznaň,párkář,spad,upload,připařovat,Prokš,Řenč,náčelní,řítit,Úštěk,učout,úkon,vřít,zpikantnit,vřes,nazála,zaktivnět,předčit,čáp,pospíchat,přepeřit,dítě,proponovat,pánev,rek,plout,pozoun,Apple,skopec,přičitat,sprostý,pestřit,zpříkřet,prim,Onan,přísnit,odpočívat,zvát,zvát,Pilich,opeřit,čísnout,atika,práh,pospíšit,zesýřet,Čou,prostřít,prospektor,čop,půda,aspekt,bez
píle	pílit,Pila,pila
písek	píst
píst	písek,pěst,Pikt
pít	pět,píce,pětník,supět,píár,zpět,píča
píča	píka,píce
pól	polní,pole,Polsko,police,půl
pór	porce
pórovatět	zpórovatět
pěna	pěnice
pěnice	pěna
pěst	píst
pět	pít,pětník,supět,zpět,píce,opět,zpětit,Pěč,píča,píka,pitvat,pat,pec,píár,úpět,píle
pěší	Pěč
předeslat	přeslat,odeslat
předestřít	odestřít,rozestřít
přelodit	nalodit
přepočíst	spočíst
přepřahat	vypřahat,vpřahat,zapřahat,připřahat,spřahat,odpřahat,rozpřahat
přeslat	předeslat
přesný	přísný,přední
přesrat	přisrat
přesychat	přesýchat
přesýchat	přesychat
převýšit	vyvýšit
přezka	stezka,Kůst,kost,předčit
přichutit	ochutit
připřahat	zapřahat,přepřahat,spřahat,odpřahat,vypřahat
přispat	přispávat
přisrat	přesrat,prosrat
přisychat	přisýchat
přisýchat	přisychat
příst	přísný,příčit,přít,přesný,půst,přát,vně,přední
přít	přítel,přát,příst,příčit,příští,prát,vně,vřít
přítel	přít
přízeň	zen,zenit
půst	vně,Poe,pot,zout,Nat
rab	Ráb
rabi	rabiák,rabiát,rab,Ráb,Rabštejn
rachat	ráchat
rada	radovat,Radek,radon,radar
radar	rada,radovat
radon	Radouň,rada
rafika	rafičit
rafičit	rafika
rajka	ráj
rak	zrak
rakev	raketa,Rakovník,rak
rameno	ramenář
ranč	rána,raný,Rankov
rap	vrap
ras	rasa
rasa	ras,řasa
razit	razítkář
recept	recepce
reklama	reklamovat
relykrosový	kros,krosna,relokovat,relax,zkritisovat,zakritisovat,kritisovat,krosnář,sakrovat,rallyekros,diakritika,odsadit,losos,makrela,krosček,kras,lakros,krinoid,recesismus,sakrální,korelovat,elaidinizovat,Šlosar
remíza	remíz
rentovat	renta
reorganisovat	zreorganisovat
represe	deprese,repríza
ret	retina,retinovat,rétor,rek,Renáta,réva,Raet,Renč,Rive,rýt
retina	retinovat
revanš	revanšovat
revma	réva
revoluce	revolucionařit,evoluce,revolucionovat
rez	rezivý,ryzí,dřez,bez,řezat,anýz,zeď,reznout,Řezník,zet,pařez
rezerva	rezervoár
reální	reálný
reálný	reální
režie	režim
rock	rockovat,rošt
roh	rohovatý,rohovník,růže
rohovatý	roh
roj	Rojka
rok	prorok,dok,úrok,nárok,rak,rošt
role	Rol
rolovat	Rol
román	Roman,Romanov
rosa	osa,vosa,růst
rota	rotovat,routa,Roth,Dorota,rock,Rotar,porota,rutina
roura	rourař
rozbydlet	bydlet
rozbředat	bředat
rozchvátit	zchvátit
rozcitlivět	zcitlivět
rozdout	dout
rozedrat	zedrat
rozeslat	přeslat
rozesrat	zesrat
rozesychat	rozesýchat
rozesýchat	rozesychat
rozjařit	zjařit
rozklofat	klofat
rozlítit	rozlítnout
rozmrzat	zmrzat
rozptýlit	zptýlit
rozpřahat	rozpřáhat,vypřahat,zapřahat,odpřahat
rozpřáhat	rozpřahat
rozradostnět	zradostnět
rozresonovat	zresonovat
rozsocha	socha
rozsychat	rozsýchat
rozsýchat	rozsychat
roztrpčit	ztrpčit
rozvichřit	vichřit
rozvrtit	uvrtit
rošt	růst,rock,rok
rubat	Rubák
ruch	ruka
rudý	Ruda
ruka	rukovat,ruch,ruina,paruka,routa
rum	Rusko,rudý
rusý	Rusko,Rusín
rvát	vát,řvát,ovce,ujec,oj
ryba	Rybák,Rybář
rychta	rychtovat
ryšavět	zryšavět
rádlo	Radek
ráj	rajka,roj,Rojka,rajcovat,Rovný,rovný,rána,rap
rám	rámě
rámě	rám,rámus,rameno
rána	raný,ranč
rýha	rýže
rým	dým,rýma
rýma	rýmař,rým
rýt	Rýn
rýže	rýha
růst	Zrůst,rošt,rosa,různý
sadit	Sadil,odsadit,Sádek,Sadov
sahat	zasahat,vsahat
sajdkára	sajdkárkros
salaš	salašit
samec	samet
samet	samec
sankce	sankciovat
sardinka	sardinkář
sardinkář	sardinka
sekce	sekta,set,sekat
sekvence	sekvencovat
selekce	selektiva,selektovat
selektovat	selektiva
sen	seno,set,Seneka,zen,síň,senát,den,skin,sít,ven,nový,sát,sova,Sova,Oset,siena,Novák,síci,sítina,sto,čin,senilní,osel,vosa,osa,sekce,vset,dna,nos,Nos,osev,Poe,síla,ovce,syn,Vey,sivý,Stin,vně,snout,scan,men,vyosit,zenit,secese,skica,přesný,síť,eses,Sovík,Ota,vina,dé,Stoy,saně,deka,Nick,Siva,zajíc,sál,Svatý,svatý,oj,cé,necky,antika,psát,senior,Osetie,osten,svat,svůj,siný,Nat
seno	senát,sen,set,Seneka,síci
senzibilní	senzibil
senzitiv	senzitivní
senzitivní	senzitiv
seraf	Serafína
sesmekat	smekat
set	Oset
sever	Severa
sex	sexovat
sexus	sexovat,sex,soused,duše,sérum,Erós,Erós,dosedat,Duša,předseda,dusit,Rusko,šos,Zeus,Sioux,deismus,Saud,odsedat,sesedat,sesout,příroda,rozsedat,dusat,Irák,xerox,kros,dusný,soda,Sekera,sekera,eroze,Mikes,zadušit,posedat,virus,dioda,Dák,osmóza,Dušín,vous,osud,vsedat,Sadov,Eda,přisedat,erudovat,user,dok,kosmos,rusý,šús,vyexovat,ďas,Srp,srp,sadovník,Sasko,Moser,Doksy,Mikis,edukovat,kosíř,skikros,osma,sedět,Ovidius,Wood,sud,Dewar,karosa,kos,iks,Sum,ušař,vysedat,Izák,série
sešikmit	zešikmit
silika	silice,silikát,silt
silikát	silika
sinus	siný
sirý	síra,Usir
sivý	Siva
skalp	skialp
skialp	skalp
sklamat	klamat
sklep	sklepník
sklo	kilo,Keňa,Klos,Kelč,skica,okno,sekce,Kloss,Kováč,clo,seno,sekat,Seneka,kelt,síknout,Kovač,kov,klovat,set,knot,skin,antikva,sivý,skicnout
sklovatět	zesklovatět
skopec	kopec
skála	Skalka,Skalice,Skalník
skýtat	naskýtat
skřípat	skřípět
slabý	slabika
slad	sladký,sladit
sladit	sladký
sladký	sladit,slad
slalom	slalomovat
slavit	slavík
sled	slez,Slezsko,slída,slad,sliz,slídit,následný
slez	Slezsko,sled
sloupkař	sloupkář
sloupkář	sloupkař
slout	sloup,slynout
slunce	slon
slyšet	slušet
smekat	sesmekat
smetí	smeč
smích	Smíchov
smět	Smělý
smůla	Smola
sníh	něha,nížit,Něnec
socha	rozsocha
soda	sud
sok	dok
solar	dolar
soma	Sodoma,soda,Sum,suma,rosomák,Siam
sonografie	fonografie
spedice	speditér
sploštit	zploštit,oploštit
spor	spora,sporý,Sporck,spořit,sport,spára,rozpora,prapor,zasporovat,opora,zúspornit,pár,spurt,pod,pozor,Zátor,odpůrce,pára,dozor,rozporovat,vzor,Zour,purpur,porce,sponzor,Špůr,přespořit,upír,diaspora
spora	spor,sporý
sport	spurt,Sporck
sporý	spora,spor
spočíst	spočívat,přepočíst
sprostit	oprostit,sprostý,zprostit,zprostit,vyprostit
sprostý	sprostit,prostý
spurt	spurtovat,sport,spurtér
spát	pospat,přispat,naspat
spíchat	pospíchat,spěchat
spěchat	spíchat
spřahat	odpřahat,připřahat,přepřahat,vypřahat,zapřahat,vpřahat
srnec	Srník,Srna
srp	sýr
srst	srdce,srkat
srát	přesrat,dosrat,přisrat,odsrat,prosrat,srnec,sráz,Srna,zesrat,usrat,rozesrat
star	starý
starý	star,starat,Stoy,stádo,start
statika	statistika
statistika	statika
stenografie	stenografovat
stlát	dostlat,přestlat,postlat,přistlat
sto	Stoy,set,oko,sát,zet,stoik,cé,ovce,vát,vně,Stin,dé,Ota,oj,Nat,Stone,snout,seno,Inuit,Poe,Sup,čin,záře,out,kov,Vey,půst,Sova,sova,antika,Antily,dout,sekce,Zita,čaj,pot,dno,sít,deka,sen,Sovík,zajíc,nový,zívat,zátka,kost,stonat,dock,ovoce,zout,scout,vina,Kováč,sud,dík,Zeus,necky,dna,tele,stonek,víko,zeť,iks,jíní,skin,inovovat,Oset
stoik	Stoy,sto
stolit	stolice
stonat	Stone,stonek
stonek	Stone,stonat
stop	stopa
stopa	stop,Stupa
stoupat	stoupit,vstoupat
stoupit	dostoupit
stroj	strojit
strojit	stroj
strouhat	vystrouhat
struha	ostruha
struk	stručný,strok
strýc	stréc
stud	studit,studovat,studený,Studený,Studnář,Stoy,Studénka,stádo
studit	stud,Studený,studený
studovat	stud
styl	Tyl,stůl
stát	statovat,dostat
stát	statovat,dostat,ostat,statika,stáj
stát	statovat,dostat,ostat,statika,stáj
stáž	stážovat
stážovat	stáž
stéblo	estébé
stín	Stin
stěhovat	stěhovák
stěna	stínat,stín
střecha	echo
střed	středit
střihat	nastřihat,dostřihat,vostříhat,zastřihat,odstřihat,přistřihat
stříbro	stříbřit
stříhnout	ustříhnout,nastříhnout,dostříhnout
stůl	stolice,Soul,stolit,styl
subvence	subvencovat
suchý	Suchan,suchozemský,Suša
sud	osud,soda,Sudek
suk	sok
sulc	Sula
suma	sumec
supat	zupat
supět	pět,zpět
surf	surfovat
svat	Svatý,svatý,sval,seno
svatý	svat
svině	Sviny
svor	svora
svora	svor
svrbit	svrbět
svrbět	svrbit
svítit	světnice,svět
svědek	svědit,svědět
svědit	svědět
svět	světnice,svítit,zásvětí,Osvětim,zásvětný,zesvětovět,svitek
swing	swingovat
systém	systémák,ekosystém
sálat	salát
sát	set,saně,sto,sít,seno
série	síra,sýr,Sýrie,user
síci	sít,seno,siena,sítina
síla	osel,silt,sít
síra	sirý,série,Usir
sít	sítina,síť,vyosit,set,sivý,síci,Oset,sát,seno
síť	sít,sítina
sólo	solnice
sýr	Sýrie,Srp,srp,série,síra
sůl	vůl,půl,kůl,důl,Soul,nový,sál,Nat,vůle,nikl,znatel,olovo,Ulč,oj,stůl,Novák,Nosál,lov,solnice,sulc,ovál,vně,necky,spool,cé,Nos,nos,dole,ovoce,Nil,Sup,lůj,podzol,Doyle,Zola,Nick,ovce,sova,Sova,přesný,Sula,rosol,čin,zlý,nit,sonet,Poe,sokl,rozkol,kolo,Don,vůně,přísný,sokol,znít,půst,osel,styl,Val,Ola,síci,Olina,Zvol,válka,nést,sonáta,Pozník,dock,eses,vset,příst,znát,dé,vosa,čina,osa,ulice,sto,jíl,pot,oko,vát,sval,vole,čokl,zajíc,Loos,psát,vosk,olše,dna,deal,zen,pole,poník,sólo,Onan,unie,lísa,zátka,sát,oliva,Oliva,sunout,záře,sít,snout,pouť,síla,Sovík,ničit,los,lnout,Zlín,Antal,přední,kilo,dno,sekce,Válek,otec,zlovůle,op,Lojza
taj	tajný
tajemný	tajemnůstkář
tajný	taj
tam	atom,tým,taxi,Tamana,Tamil
tanec	tank
tank	tanout,tanec
tanout	tank
tavit	zotavit
technika	techno,zootechnika,ztechničtit,ztechničtět
techno	technika
teismus	ateismus
tele	Telč,cé,otec,telit,teč
tenze	tenký,Tennant,ztenknout,tendovat,teze,tknout,Tien,vztek,potence,nota,vytkat,otec,recenze,cenzus,Telč,týn,penze,notit,tele,vytentovat,tenis,Atény,Novotný,tečka,tenor,tejp,antitéza,potentovat,pytel,tnout,notář,teta,přenýtovat,nýt,nýt,Teka,tanout,Vsetín,odtínat,teč,Tanzanie,osten,tér,potkat,tendr,ztížet,zen,podtínat,řetěz,téci
tep	otep
teplý	Teplice
terapie	bioterapie,arteterapie,socioterapie,terej
termika	termit
teror	teriér
teta	tetovat
tetelit	telit
text	textil
teč	tečka
tečka	Teka,teč
tichý	Tichák
tip	tiper
titan	Titán
tknout	tkát,otec,Tennant,Telč,tnout,Atény,potkat,tele,vytkat,tenký,téci,zatkat
tkát	tknout,vytkat,potkat
tleskat	otleskat
tma	téma
tmívat	vytmívat,tmět,tým,tmel
tnout	tanout
tonus	tonout
totální	totál
touha	tuha,stuha
trafika	trafikařit
trakce	trakt
trakt	trakce
trasa	trasovat
trest	trek
trh	Trhovky
trik	triko
trio	triko
trivium	trio,trim,triko
trn	Trnka
trocha	trokar
tropy	trojka,Troy,trojice,troup,tropit,trojčit,trudit,trůn,trust,trať,trouba,tratit,Troják,strop,trápit,tráva,trio,truc,trapovat,trakt,Trojan,Trója,Třinec,traper,triko,trám,travař
trsat	otrsat
tráva	travař,trávit,trať
tu	Tutu,tuk,tutový,tuna,Votus,out,tnout,Tuvin,tur,rtuť,Ota,tuš,attika
tuha	tuhý
tuhý	tuha
tuk	tu,Tutu,tutový
tuna	tuňák,tung,Tula,Tutu,tutový,tunel,Tunis,tu,tuk,Kotula,tonout,třítuna,Tunguz
tunel	tunelit
turismus	naturismus
turner	turnér
tušit	tuš
tvar	tvářit,tvárný,tvářet
tvaroh	tvarohář
tvářet	tvářit
tvářit	tvářet
tykev	tykat,tyknout
tyrolsko	Tyroly
tyč	tyčit
tyčit	tyč,vytýčit
tát	Tate,táta,Tatar
táta	Tate,tát
téci	otec,tele,teta,Telč,tknout,tkát,Teka,teč,tečka
téma	tma,temovat,teismus
tón	tónika
týkat	tykat
týl	Tyl
týt	týl,týn
tělo	týl,tele
těsný	těsto
těžit	těžký
těžký	těžit
třáseň	třást,třásnit
třást	třáseň,třít,třásnit
tříska	třískat
třískat	třeskat
třít	Třinec,vatřit,třást
ubohý	bůh
ucho	doch,echo,cech,nach,ochočit,ušař,chovat,uchvátit,záducha,Ota,otec,Chotkov,učit,ochotničit,ořech,cé
udit	udice
udomácnět	udomácnit
uhel	úhel
uhášet	zhášet
ujec	zajíc,oj
uklihnout	zklihnout
ukládat	dokládat
ulejt	vylejt
um	zem,dům,ovce,ujec,přímo,přesný,vně,oj,Poe,Mikes,Nat,Vey,Sum,Oset,eses,rým,záře,antika,Rom,Osetie,cé,oves,pod,dým,dýně,Ota,půst,set,Řek,necky,meč,přední,nový,vát,míč,čin,nos,Nos,unie
unie	unita,uniat,nový
unita	unie
upravdit	zpravdit
upřádat	opřádat,zapřádat,dopřádat,vypřádat
urin	Uran,Uriáš
uryšit	urýšit
urýšit	uryšit
uspíšit	pospíšit
ustříhnout	stříhnout,nastříhnout
utilita	utilitář
utilitarismus	utilitarianismus
utopie	atopie,otop
uvadat	ovadat
uvrtit	dovrtit,rozvrtit,povrtit,vrtět
uvykat	vykat
uvědomit	zvědomit
uzda	půda,záda
uzel	uzelník,uzenář,zelí,znatel,zen,podlý,Doyle,udice,podél,pot,zlý,zajíc,ujec,udit,cé,osel,zívat,uvozovat,zet,pole,Vlk,vlk,zenit,týn,Antily,ovce,pozice,nota,provoz,Zábel,Yale,ovál,týl,zelina,Zelina,Onan,uzda,vně,nový,záře,uzlovatý,přítel,Poe,lozit,oj,Ota,dole,půl,jíl,Ulč,polní,čin,zelený,Nat,otec,učit
uzelník	uzel,zelí,zelený,uzenář,Zelina,zelina,zkouzelnit,zkouzelnět,udice,zenit,Zelenkov,Ela,osel,nádeník,zívat,udit,pozice,Slovensko,lnout,oslnit,vlk,Vlk,vlna,zajíc,zen,vazelina,cé,Antily,alt,ujec,nazála,delta,pot,ovce,podél,Eliot,klozet,podnáčelník,dolňák,polní,svízel,póvlizovat,Pozník,Zola,vně,iluze,glie,podělkovat,uvozovat,ven,clo,Zdeněk,zálik,podlý,zalíknout,znatel,Doyle,novela,Pondělík,Vey,Ota,Slanec,předek,provoz,zolovnět,Slovan,uzda,senilní,Lenin,len,deka,pozitivní,zet,Yale,antika,zinzat,přilicovat,dekl,sliz,Poe,relé,Provázek,lázeň,Onan,solnice,cizelovat,zlý,donace,zavazet,Powell,zátinek,nota,Inuit
uzlit	zauzlit
učit	čít,čin,učitelík
ušedat	zšedat
ušklíbat	ošklíbat,zašklíbat
užrat	požrat
vachta	vachtat,vachtař
vagant	vagantit
vagantit	vagant
valit	Valina,Val
vana	vanad
vanad	vana
var	várka,Avar,Jar,varovat,výr,tovar,rozvářet,Nara,vor
varhanět	varhanit
variance	varianta
varta	vartovat
vata	vát
vdova	vdovit
vdychat	vdýchat
vdýchat	vdychat
vedrat	Vedra
vegetit	vegetář,vegetovat
vegetovat	vegetář,vegetit
vejce	vejl,Vey,vějice,ven,víjet,výt,věno,vejr,veto
velký	Velen,Vela,veličit,velet,víla
ven	Vey
ventilovat	ventil
verbum	verbovat,baryum,bomba,verbena
ves	oves,vést
veta	veto
vetchý	vetkat
veto	veta
veš	veka,ves,Leš,Valeš,Aleš,jíška,Aš,veteš,Vitiš,Záviš,číš,veksl
vichr	vichřit
vichřit	rozvichřit
vidět	video
vietnamka	Vietnam
vina	Vína
viola	violina
vir	víra
viset	visatý,visnout,visovat,visitovat
vize	Vizovice,vizír,vizita,vizáž,video
vkotoulet	zakotoulet
vlas	Vlasov,vlasař
vlekat	vlékat
vlhat	provlhat,zavlhat
vlk	vlčit
vládný	vovládnout,vládat,Vladík,Vlám
vláha	vlažný,vlažit
vlákno	vláknit
vlčet	vlčit
vně	vát,Nat,oj,ovce,půst,Vey,Poe,nový,vůně,zvát,zvát,pot,op,přesný,Sup,jíní,sto,cé,zet,necky,příst,zlý,vana,přední,přít,ujec,vlk,Vlk,Novák,čin,zajíc,zout,zen,záře,Vaník,řvát,nést,nit,dé,Antily,Vaněk,Nick,out,psát,víko,dýně,vset,dna,Ob,voj,pravý,jiný,Ota,ven,vina,vosa,pod,růst,vosk,set,příčit,zívat,přát,Telč,oko,dno,um,rvát,tele,pop,Pop,Ulč,prvý,prát,věno,snout,různý,dout,prostý
vochle	vochlovat
voda	Vodák,vodovod,vodnář,vojvoda,vývoda,vodničit
voj	vojna
vojevoda	vojevodit
vojvoda	vojvodit,vejvoda
vole	vůle,volný,vůl,Volta,zlovůle
volný	vole,vůle,vilný,volat,volenec,Volta,zlovůle,vůl,volit,navolňovat,Vont,Zvol,olovo,rozvolnit
vosa	osa
vozher	uher,Uher,Herder,hever
vpřahat	vpřáhat,přepřahat,vypřahat
vpřáhat	vpřahat
vrah	vražit,otcovrah
vrap	vráp,rap
vraštit	vráštit
vrba	Vrbata
vrhat	vyvrhat,zavrhat,zvrhat,převrhat,povrhat
vrtět	uvrtit,dovrtit,Vrtěl,vyvrtit
vrzat	Vrzák
vrána	Vrana,Vraný
vráp	vrap,vrápat
vráskatět	vráskovatět
vráskovatět	vráskatět
vráštit	vraštit
vsahat	vsáhat
vsout	psout,vsouvnout,vysout,sesout
vsáhat	vsahat
vtip	vtipkař,vtipkařit
vtít	vtínat,vtip,vtírat
vulgární	zvulgárnit,zvulgárnět
vybulat	zbulat,zabulat
vyběsit	zběsit
vybředat	bředat,zabředat
vybříst	Břest,bříza,Březa,březí,břečka,břevno,břit,zabřezat
vychlípit	vychlípět
vydlažit	vydlážit
vydlážit	vydlažit
vydřevit	vydřevnit
vyhlášet	ohlášet
vykat	uvykat
vykolejit	nakolejit
vykotoulet	zakotoulet
vylejt	ulejt
vyplavět	zplavět
vypláchnout	pláchnout
vypolštářit	polštář,zpolštit,zpolštářkovatět,popolštit,zapoletět
vyprahat	vypráhat,zprahat
vyprdelit	odprdelit
vyprostit	zprostit,zprostit,oprostit
vyprovodit	doprovodit,sprovodit
vypřahat	zapřahat,napřahat,přepřahat,odpřahat,rozpřahat,vpřahat,vyprahat,vzpřahat,připřahat
vypřádat	zapřádat,dopřádat,opřádat
vyslat	zaslat,doslat
vysoký	vysout
vysout	vysouvnout,vsout,sesout
vystrouhat	strouhat
vysychat	vysýchat
vysýchat	vysychat
vyvrhat	vrhat,zvrhat,zavrhat
vyvrtit	zavrtit,navrtit,dovrtit,uvrtit
vyvýšit	převýšit
vyzírat	zírat
vyčouhat	čouhat
vzdor	vzor
vzduch	duch,vzdušnice
vzdušnice	vzdušnit
vzdušnit	vzdušnice
vzdušnět	vzdušnit
vzdýmat	zdýmat
vzor	vzdor,pozor,dozor
vzorkař	vzorkář
vzorkář	vzorkař
vzpřahat	vypřahat
vzrůst	Zrůst
vzít	zívat,příst,zíta,zet,přít,psát,zen,zátka,vzácný,příčit,půst,Zita,Zdíkov,vůně,přední,dít
váha	váhař,Váh
válka	Val,Válek,valkovat,Vala,Valina,valit,Valeč,valník,ovál,vana,valčík,Vaník,Vaněk,vát,vůl,vně,vůle,vanila,Yale
vát	vně,rvát,vata,Nat,oj,ovce,vana,zvát,zvát,sto,zet,řvát,půst,vak,Vaník,cé,záře,Vaněk,out,ujec,jíní,nový,víko,Poe,zout
váza	vázat,vazný
vázat	váza
vášeň	vášnit,Vašina,Váša,višeň
vést	ves,véda,veka,vesta,vézt,Vey
víno	Vína,věno,vina
víra	Věra,vir,výr,věrovat,zvírat
vít	větit,veto
vítr	Vít,vít,vitrína,veto,Vetter,věta,veta
výr	Výrov
výt	nýt,nýt
věk	věc,víko
věnec	věnečný
věno	víno,věnec,Vína
věta	větit,větev
větev	věta,větit
věž	věžit
vřed	vředovatý
vřít	zavřít,zřít,přít
vštípit	štípit
vůl	vůle,vole,sůl,Zvol,zlovůle,půl,vůně,volný,válka,kůl,Val,Vont,vonice,ovál,Ulč,lůj,lov,Válek,ovoce,nový,jíl,důl,volit
vůle	vůl,vole,vůně,volný,zlovůle,vonice,Vont,ovoce,Volta,válka,Ulč
vůně	Vont
zabsolutnit	zabsolutnět
zabsolutnět	zabsolutnit
zabstraktnět	zabstraktnit
zabulat	zbulat,vybulat
zabředat	bředat,vybředat
zachrustět	zachrustit
zahltit	zahltnout
zahálet	zahálčit
zajíc	ujec,oj,záře
zakademičtit	zakademičtět
zakademičtět	zakademičtit
zakládat	zakládač
zakládač	zakládat
zakročit	nakročit
zakrvit	zakrvavit
zaktivnět	zaktivnit
zalistit	odlistit
zalykat	zalyknout
zapomínat	pozapomínat,napomínat
zapylit	opylit
zapřahat	vypřahat,napřahat,rozpřahat,přepřahat,připřahat,odpřahat
zapřádat	opřádat,vypřádat,upřádat,dopřádat
zaslat	vyslat,doslat,přeslat,poslat,rozeslat,odeslat,předeslat,slatina,zaslnit,seslat,obeslat
zastehnout	nastehnout
zastřihat	nastřihat
zasychat	zasýchat
zasýchat	zasychat
zatykat	tykat,tyknout,Katyna,přetýkat,týkat,vykat,přivykat,kýkat
zavazadlo	zavazit,zavazet
zavazet	zavazit
zavazit	zavazet
zavlahnout	zavláhnout
zavlhat	navlhat
zavrhat	vrhat,vyvrhat
zavrtit	vyvrtit,navrtit
zavřít	vřít
začít	načít,čít,počít
začít	načít,čít,počít
zbabičkovatět	babičkovatět
zbanálnit	zbanálnět
zbanálnět	zbanálnit
zblbit	zblbět,oblbit
zblbět	zblbit
zbodřet	zbodřit
zbodřit	zbodřet
zbroj	výzbroj
zbulat	vybulat,zabulat
zbídnět	zbídnit
zběsit	vyběsit
zbůst	bé,bdít,bečka,zábnout,bos,bez,půst,Ob,zbočit,Bosna,zem,bit,zbujný,vybičit,bus,bok,zeď,oblý,obec,zdobit,vzít,půda,zub,bát,vně,záboj,zen,zvát,zvát,oj,zbojník,zout,obout,bízet,zívat,Prajz,bída,Uzbek,Ben,býk,Boole,příst,zet,nynat,psát,zlý,probošt,nový,bon,Byzanc,nést,anýz,ryzí,Nat,pot,boj,vbočit,dé,zbídnit,zděř,Bosch,bzdít,bít,příčit,jíní,zeť,poboční,Zubík,zápůjční,Pju,dbát,přímo,dno,jiný,zjízvit,zběsit,Poe,doba,necky,dít,Zdíkov,březí,nýt,nýt,zajíc,zátka,řvát,Joza,přesný,půvab,beat,obdélný,Bond,zbujnit,zbojničit,přít,důstojný,zpyt,příjice,různý,dík,vybříst,déšť,Eben,dítě,obvod
zchvátit	rozchvátit
zcitlivět	rozcitlivět
zcivilnit	zcivilnět
zcivilnět	zcivilnit
zcukernit	zcukernět
zcukernět	zcukernit
zdomácnět	zdomácnit
zdravkat	zdrávkat
zdravět	ozdravět
zdredovatět	dredovatět
zdrobnět	zdrobnit
zdrávkat	zdravkat
zduchovnět	zduchovnit
zduševnit	zduševnět
zduševnět	zduševnit
zdvihat	nazdvihat
zdát	dát
zdýmat	vzdýmat
zdětštět	zdětštit
zdůstojnit	zdůstojnět
zdůstojnět	zdůstojnit
zdůvěrnit	zdůvěrnět
zdůvěrnět	zdůvěrnit
zedrat	rozedrat,zadrat,vedrat,nadrat,sedrat
zelí	zelený,Zelina,zelina
zem	zeď,um
zen	zenit
zesentimentálnit	zesentimentálnět
zesentimentálnět	zesentimentálnit
zesilnit	zesilnět
zesilnět	zesilnit
zesinavět	zsinavět,zasinavět
zeskelnět	zeskelnit
zesklovatět	sklovatět
zeskromnit	zeskromnět
zeskromnět	zeskromnit
zeskrovnit	zeskrovnět
zeskrovnět	zeskrovnit
zeslavnostnět	zeslavnostnit
zesličnět	zesličnit
zeslovanštit	zeslovanštět
zeslovanštět	zeslovanštit
zespolečenštit	zespolečenštět
zespolečenštět	zespolečenštit
zesrat	rozesrat,přesrat
zestraničtět	zestraničtit
zestručnit	zestručnět
zestručnět	zestručnit
zesvátečnit	zesvátečnět
zesvátečnět	zesvátečnit
zesvětačet	zesvětačit
zesvětačit	zesvětačet
zesvětštit	zesvětštět
zesvětštět	zesvětštit
zesyrovatět	zesýrovatět
zesýrovatět	zesyrovatět
zet	zeť
zevropštět	zevropštit
zextenzívnět	zextenzívnit
zezvířečtit	zezvířečtět
zeď	zem,Zedník,dé,pod
zešikmit	sešikmit,zešikmět
zešupinovatět	zešupinkovatět
zeť	zet
zfanfrnit	zfanfrnět
zfanfrnět	zfanfrnit
zhlupit	zhlupět
zhlupět	zhlupit
zhmotnět	zhmotnit
zhorečnit	zhorečnět
zhorečnět	zhorečnit
zhranatit	zhranatět
zhranatět	zhranatit
zhrdinštět	zhrdinštit
zhrubit	zhrubět
zhrubět	zhrubit
zhybnět	zhybnit
zhášet	uhášet
zima	Zimák
zintensivnět	zintensivnit
zintenzívnit	zintenzívnět
zintenzívnět	zintenzívnit
zintimnět	zintimnit
zjařit	rozjařit
zjednostranět	zjednostranit
zjednotvárnit	zjednotvárnět
zjednotvárnět	zjednotvárnit
zklasičtět	zklasičtit
zklihnout	uklihnout
zklihovatět	klihovatět
zkonkrétnět	zkonkrétnit
zkonvenčnit	zkonvenčnět
zkouzelnit	zkouzelnět
zkouzelnět	zkouzelnit
zkrvit	zkrvavit
zkulturnit	zkulturnět
zkulturnět	zkulturnit
zkusit	okusit
zlacinět	zlacinit
zlahodnět	zlahodnit
zlakotnět	zlakotnit
zlatý	zlatět
zlatý	zlatět,zlatničit,zlatinit,látka,lát,láce,lata,zlolát,zlaičtit,vlát
zlednatět	zlidnatět,lednit
zliterárnit	zliterárnět
zliterárnět	zliterárnit
zlogičtit	zlogičtět
zlogičtět	zlogičtit
zludračet	zludračit
zludračit	zludračet
zlyričtit	zlyričtět
zlíbeznit	zlíbeznět
zlíbeznět	zlíbeznit
zlít	zlítit,lít
zlítit	zlít
zlý	podlý,oblý,vně
zmalichernit	zmalichernět
zmalichernět	zmalichernit
zmalit	zmálit
zmalomocnit	zmalomocnět
zmalomocnět	zmalomocnit
zmatnit	zmatnět
zmatnět	zmatnit
zmdlet	omdlet
zmezinárodnět	zmezinárodnit
zmije	Zmij
zmilosrdnět	zmilosrdnit
zmilostnět	zmilostnit
zmléčnit	zmléčnět
zmocnit	zmocnět
zmrzat	rozmrzat
zmrzoutět	zmrzutět
zmrzutět	zmrzoutět
zmužštět	zmužštit
zmálit	zmalit
zmútit	zamútit
změlčet	změlčit
změlčit	změlčet
změšťáčtět	změšťáčtit
znamenat	znamení
znamení	znamenat
zneklidnět	zneklidnit
znemravnit	znemravnět
znemravnět	znemravnit
znepravidelnit	znepravidelnět
znepravidelnět	znepravidelnit
zneprůchodnit	zneprůchodnět
znepříjemnit	znepříjemnět
znepříjemnět	znepříjemnit
znervosnět	znervosnit
zniternit	zniternět
zniternět	zniternit
znoj	znojit,nápoj,zen,znít,Onan,nový
znovudosadit	znovuosadit
znovuosadit	znovudosadit
znádhernit	znádhernět
znádhernět	znádhernit
znáhlit	přenáhlit
znát	znatel,značit,Nat,znít,znavit
znít	nit
zněmit	zněmět
zněmět	zněmit
zněžnit	zněžnět
zněžnět	zněžnit
zobyčejnit	zobyčejnět
zobyčejnět	zobyčejnit
zobčanštět	zobčanštit
zodbornit	zodbornět
zodborničtět	zodborničtit
zoficiálnit	zoficiálnět
zoficiálnět	zoficiálnit
zohebnět	zohebnit
zohyzdnět	zohyzdnit
zoptimalisovat	optimalisovat
zoufat	doufat
zout	out,dout
zparchantět	zparchantit
zpasivnit	zpasivnět
zpasivnět	zpasivnit
zpestřit	pestřit,zpestřet
zpikantnit	zpikantnět
zpikantnět	zpikantnit
zplacatět	zplacatit
zplamenit	zplamenět
zplamenět	zplamenit
zplastičtit	zplastičtět
zplastičtět	zplastičtit
zplavět	vyplavět
zplodnět	zplodnit
zploštit	oploštit
zploštět	oploštět,zploštit
zpodobit	vypodobit
zpodstatnět	zpodstatnit
zpopruhovatět	zpruhovatět
zpopulárnit	zpopulárnět
zpopulárnět	zpopulárnit
zposvátnit	zposvátnět
zposvátnět	zposvátnit
zpovrchnět	zpovrchnit
zpovšechnit	zpovšechnět
zpovšechnět	zpovšechnit
zprahat	vyprahat
zpravdit	upravdit
zpravidelnit	zpravidelnět
zpravidelnět	zpravidelnit
zprimitivnět	zprimitivnit
zprostit	oprostit,vyprostit,sprostit
zprostit	oprostit,vyprostit
zprostonárodnět	zprostonárodnit
zpruhovatět	zpopruhovatět
zpružnit	zpružnět
zpružnět	zpružnit
zprůchodnit	zprůchodnět
zprůchodnět	zprůchodnit
zprůmyslnit	zprůmyslnět,odprůmyslnit
zprůmyslnět	zprůmyslnit
zprůzračnit	zprůzračnět
zprůzračnět	zprůzračnit
zptýlit	rozptýlit
zpychat	zpýchat
zpyt	přírodozpyt,Pju,pytel,pot,vyzuzat,zpívat,půst,Zuza,pnout,zupat,Telč,Zuzák,Zappa,uprat,Nat,nýt,nýt,Úpa,Jut,zpytat,zout,vně,řvát,pat,tele,Updike,teč,oj,Poe,příst,zápůjční,zapovat,přít,Joyce,výt,cé,přát,ujec,rozpárnout,pouť,podlý,op,pec,provoz,pouto,uzda,vytýčit,tečka,půda,zlý,otec
zpýchat	zpychat
zpěknět	zpěknit
zpět	zpětit,pět,opět,supět,zpětvzít,zpívat
zpřístupnit	zpřístupnět
zpřístupnět	zpřístupnit
zpřítomnět	zpřítomnit
zpřízvučnit	zpřízvučnět
zpříšernět	zpříšernit
způvabnět	způvabnit
zrabiátnět	zrabiátnit
zradostnit	zradostnět
zradostnět	rozradostnět,zradostnit
zrealističtit	zrealističtět
zrealističtět	zrealističtit
zreorganisovat	reorganisovat
zresonovat	rozresonovat
zreálnit	zreálnět
zreálnět	zreálnit
zrno	zrnit
zrohatit	zrohatět
zrohatět	zrohatit
zromantičtět	zromantičtit
zrozkošnět	zrozkošnit
zryšavět	ryšavět
zsinavět	zesinavět
ztajemnit	ztajemnět
ztajemnět	ztajemnit
zteatrálnit	zteatrálnět
zteatrálnět	zteatrálnit
ztekutit	ztekutět
ztekutět	ztekutit
zteplit	vyteplit
ztitěrnět	ztitěrnit
ztrojit	roztrojit
ztrpčet	ztrpčit
ztrpčit	roztrpčit
ztrudnět	ztrudnit
zub	Zubík,dub,Kozub,ozubnice
zubožet	zubožit
zuhelnit	zuhelnět
zuhelnět	zuhelnit
zumělečtit	zumělečtět
zumělečtět	zumělečtit
zunkat	zuňkat
zupat	supat
zvedat	nazvedat
zvlhat	vlhat
zvniternit	zvniternět
zvniternět	zvniternit
zvnitřnět	zvnitřnit
zvrhat	vyvrhat,vrhat
zvýraznit	zvýraznět
zvýraznět	zvýraznit
zvýznamnět	zvýznamnit
zvěcnět	zvěcnit
zvědomit	uvědomit
zvěr	zvěř
zvěř	zvěr,zazvěřit
záda	půda
záhoř	záhoří
záhumení	záhumenka
zápas	pas
zásvětí	zásvětný
zázvor	Zázvora
záře	oj
zírat	vyzírat,odzírat
zúrodnět	zúrodnit
zúzkostnit	zúzkostnět
zúzkostnět	zúzkostnit
zřídký	řídký
zřít	pozřít,vřít,dřít
zšedat	ušedat
Ábel	Zábel
Ázerbajdžán	Ázerbájdžán
Ázerbájdžán	Ázerbajdžán
ódium	idiom
úhel	uhel
úhoř	úhořit
úrok	prorok,rok
účet	účel,účes,učit
Čapek	čapíkovat
Čech	Čechov,čecháček,Čechák,čich
Čechák	čecháček
Čeladná	kladný,Kladno,čeleď,základna
Černo	černý,Černov,Černík
Čunek	čuník
Čína	čina
čas	časit,kiks,kos
časomíra	časoměr
čecháček	Čechák
čeka	čekovat,čekat,Čečen,číst,čina,Čekan,čin
čekat	čeka,Čekan
černý	Černo,Černík,Černov
čich	čina,Čech,čin
čihač	Čihák
čin	čina
čina	čin,Čína
čistý	číst
člověk	zčlověčit
čmuchat	dočmuchat
čnít	čnět
čnět	čnít
čouhat	vyčouhat
črtat	načrtat
čtyřnásobek	čtyřnásobit
čurat	očurat
čára	čáry,kára
čáry	čára,čaj
část	častý
číhat	čihač
číslo	česlo
čísnout	pročísnout
číst	čistý,čeka,čít,část,čísnout,číslo,čina,častý,čin,česnek,učit,čekovat
čít	načít,začít,začít,začít,počít
ďábel	ďábelný
Řek	řeka
Řihák	Říhák
Říhák	Řihák
Řím	římsa
řad	řada
řada	řad
řasa	rasa
řehnit	Říha
řeholit	řehol
řeka	Řek,Řečice,řečit
řezat	Řezáč
řečit	Řečice
řvát	rvát
říci	řítit,Řek,řinout,zřít,poříčí,Řečice
římsa	Řím
Šamánek	šaman
Šan	Šanov
Šanov	Šan,šanovat
Šima	Šimák,Šíma
Šimon	Šimoník
Šimůnek	Šimoník
Šiša	šiška,šišatý
Štika	etika
Štětkař	štětkář
Šust	šustit
Šíma	Šima
Šípek	šíp
šance	Šan
šanovat	Šan,Šanov
šat	šaty,šátek
šaty	šat,šátek,šátkař
šašek	Šak
šerm	šerý
šerý	šerm
šikana	Šik,šiknout,šikovný,Ašikaga,Šiša
šikovný	Šik,šiknout
škatule	škatulář
škoda	škodovka,škůdný
škrob	škrobit
šlak	šlakovat
šlapat	Šlapák
šmelc	šmelcovat
šmelcovat	šmelc
šmírařit	šmírař
šohajík	šohaj
špic	špice
špice	špicl
špicl	špice
špígl	špína,špicl
špína	Špina
šrot	šrotit,Šrut
šrotit	šrot
štípit	vštípit
štít	štítit,štět
štítit	štít
štěnice	štěně
štěně	štěnice
štěstí	poštěstit
štět	štít
štětkář	Štětkař
šukat	ušukat
šálit	šál,šalina
šéf	šíf
šíf	šéf
šít	šíp,omšít,šína
šťouchat	pošťouchat
šťourat	rozšťourat
ťapat	ťápat
ťupat	oťupat,poťupat
ťápat	ťapat
Žitný	žito
Žižkov	Žižka
žahat	zžáhat
žal	žalost
žalm	žalost,žalář,žal,žalářit
žalost	žal,žalář
žalud	žaludek
žaludek	žalud
žalář	žalářit
žebrat	prožebrat
želé	Želiv,želet,žena,želva,hec,želat,železo,uhel,žíla,úhel,žít,žengle,žíně,ženovat,hecovat
žena	ženovat
žeravět	žeravit
žito	Žitný,žít
žlutý	žlutat
žrát	požrat,přežrat,užrat
žvastat	žvástat
žvástat	žvastat
žár	požár,Požár
žíně	džíny
žít	žito,Žítek,Žitný,žíně,žířit
