Aachenová	Aachen
Abanda	abandovat
Abbas	Abbás
Abbásí	Abbás
Abcházka	Abcház
Aboriginka	Aboriginec
Absolut	absolutní
Absolute	absolutní
Acháj	Achaj
Adamik	Adamík
Adamička	Adamík
Adamičko	Adamík
Adani	Adana
Adano	Adana
Admiral	admirál
Adriano	Adrian
Adrianova	Adrian
Adrián	Adrian
Agen	gen
Agrega	agregovat
Aj	oj
Ajar	Jar
Ajúb	Ajjúb
Aksamite	aksamit
Aksamít	aksamit
Alan	Alán
Alan	Alán
Albane	Albany
Albani	Albany
Albano	Albany
Albat	Albany
Albert	Alberta
Albert	Alberta
Albertina	Alberta
Alberto	Alberta
Albin	albín,albína
Albina	albína
Albini	albína
Albino	albína
Albrechtičky	Albrecht
Albán	Albánie,albánský
Albín	albína
Alejo	alej
Alemán	Aleman
Alexandre	Alexandr
Alexandrovci	Alexandrov,Alexandr
Alexandrovič	Alexandrov
Alexandrovský	Alexandrov
Alexejevič	Alexejev
Alexey	Alexej
Alfredo	Alfréd
Alfrédov	Alfréd
Alterová	alterovat
Altmann	Altman
Amann	Aman
Amazon	Amazonie
Amazonia	Amazonie
Ambrosio	Ambros
Ambrosios	Ambros
Ambrozi	Ambroz
Ambrozy	Ambroz
Ambrůz	Ambroz
Amina	amin
Amina	amin
Amine	amin
Amini	amin
Amnesty	amnestie
Amádeus	Amadeus
Anas	ananas
Anatole	Anatol
Anders	Andersen
Andreja	Andrej
Andrejevič	Andrejev
Andrejevský	Andrejev
Andrij	Andrej
Andronik	Andronikov
Andrys	Andrýs
Andráško	Andráš
Andělice	anděl
Ann	Annan
Annan	Annen
Anne	Anna
Anni	Anna
Anno	Anna
Anta	anténa
Ante	anténa
Antena	anténa
Anton	Antoník
Antoni	Antoník
Antonický	Antoník
Antonik	Antoník
Antonina	Antoník
Antonino	Antoník
Antonio	Antoník
Antonínka	Antonín
Antonínov	Antonín
Antoněnko	Antonín
Antoňák	Antoník
Apolloni	Apollon
Appa	Zappa
Ararat	arat
Arbess	Arbes
Archangelsko	Archangel
Ardea	Ardeny
Arena	aréna
Arena	aréna
Argent	Argentina
Argenti	Argentina
Arménec	Armén
Armín	Armén
Arno	Arnošt
Aronin	aron
Arpad	Arpád
Arto	art
Astra	strast
Atamanová	ataman
Atlante	Atlanta
Atlantic	Atlantik
Atlantic	Atlantik
Atletiko	atletika
Atta	attika
Attica	attika
Aténa	Atény
Augusta	August
Augusta	August
Auguste	August
Augustine	Augustin
Augusto	August
Augustýnek	Augustýn
Augustýnka	Augustýn
Azerbajdžan	Ázerbajdžán,Ázerbájdžán
Azerbajdžán	Ázerbajdžán,Ázerbájdžán
Ašanink	Ašanin
Ašantsko	ašant
BOBo	Bob,bob
Baba	Bába,bába
Baba	Bába,bába
Babajan	Babán
Babak	Babák
Baban	Babán
Babe	baba
Babe	baba
Babica	Babice
Babický	Babice
Babina	Babice
Babinec	Babice
Babinov	Babice
Babinský	Babice
Babiny	Babice
Babiná	Babice
Babits	babit
Babič	babičkovat,babit
Babičková	babičkovat
Babí	babit
Babíl	Babel
Bachar	bachař
Bachora	bachor
Badyan	badyán
Bagdadí	Bagdád
Bagdádí	Bagdád
Bahmann	Bahman
Bakalár	bakalář
Bakelite	bakelit
Baladová	balada
Balakovo	Balakov
Balaďa	balada
Balbinot	Balbín
Balejík	Balej
Baletka	balet
Balita	balit
Balkan	Balkán
Balonová	balon
Balso	balsa
Balšan	Balšán
Bamberk	Bamber
Bambula	bambule
Ban	bán,báň,banka
Bana	banát
Banana	banát
Bananc	banát
Bank	banka
Bank	banka
Banka	baňka
Banková	banka
Banovec	Bánovec
Bany	banát
Banyan	banán
Banák	banát
Banáčan	banán
Baný	banát
Barak	barák
Baranja	Baranj
Barbara	barbar
Barbaro	barbar
Barda	bard
Bardej	Bardejov
Bardo	bard
Bardo	bard
Bardona	bard
Bardyn	bard
Barin	Barina
Barone	baron
Baroneová	baron
Baroniová	baron
Baroň	baron
Bart	Bárt
Barta	Bárta
Bartak	Barták
Bartolomej	Bartoloměj
Bartolomějová	Bartoloměj
Barton	Bartoň
Bartonice	Bartoň
Bartonička	Bartoň
Bartoňka	Bartoň
Bartoňov	Bartoň
Bartoňský	Bartoň
Bartošov	Bartoš
Basett	baset
Bastardo	bastard
Bateria	baterie
Batman	Batmanov
Bauda	baud
Baudo	baud
Bayard	bard
Bače	bača
Bačo	bača
Baňka	banka
Baňkovský	baňka
Baško	Baška
Bažantice	Bažant,bažant
Beate	beat
Bechynský	Bechyně
Bechyňa	Bechyně
Becket	Beckett
Beda	bedna
Bednarek	Bednár
Bednarský	Bednár
Bednář	Bednár
Bena	Benák
Benak	Benák
Benačka	Benák
Benediktov	benediktin
Benek	Benák
Beneška	Beneš
Bengálsko	bengál
Benice	Ben
Benin	Ben
Benjamin	Benjamín
Benk	Benák
Benka	Ben
Benát	Benátky
Benátecko	Benátky
Beranek	beran
Beranov	beran,beranit
Beranovec	beranit
Beranovka	beran,beranit
Beranovský	beran
Berbera	Berber
Berberova	Berber
Bergenia	Bergen
Bergmann	Bergman
Bergmannov	Bergman
Bergmannova	Bergman
Berl	berle
Berlinová	Berlín
Bermuda	Bermudy
Bermudez	Bermudy
Bernard	bernardýn
Bernardin	bernardýn
Bernardo	bernardýn
Bernardy	bernardýn
Bernardí	bernardýn
Berounský	Beroun
Bertová	Berta
Bethanie	Bethan
Betonika	beton
Betonova	beton
Bey	bez
Beza	bez
Bezručka	Bezruč
Bezručko	Bezruč
Bezvěrov	bezvěrec
Beáta	beat
Bečička	bečka
Bečko	bečka
Bečkov	bečka
Beň	Ben
Beňák	Benák
Bikovo	bikovat
Bimbác	bimbat
Bink	binknout
Birte	Birt
Bizoň	bizon
Blabol	blábol
Blaha	bláha
Blanca	Blanka
Blane	blána
Blank	Blanka
Blanke	Blanka
Blatnicko	Blatnice
Blatno	Blatný
Blatník	Blatnice
Blato	bláto,Blatný,blata
Blatt	blata
Blazej	blazeovat
Blazek	blazeovat
Blažečka	Blažek
Blažík	Blažek
Blech	blecha
Bled	bledý
Bledy	bledý
Blábolil	blábol
Bláža	bláha
Boba	bob,Bob
Bobko	bob,Bob
Bobo	Bob,bob
Bobo	Bob,bob
Boby	Bob,bob
Bochnie	bochník
Bochníček	bochník
Bohata	bohatý
Bohatice	bohatý
Bohdanovský	Bohdan
Bohdánkov	Bohdan
Bohumilice	Bohumil
Bohunice	Bohuna
Bohuslavský	Bohuslav
Bohuslávková	Bohuslav
Bohuslávky	Bohuslav
Bohéme	bohém
Bojanov	Bojan
Bojo	boj
Bojov	boj
Boleslavec	Boleslav
Boleslavsko	Boleslav
Bologno	Bologna
Bolívka	Bolívie
Bolševička	bolševik
Bombera	bomber
Bombo	bomba
Bondo	Bondy,Bond
Bondoa	Bondy
Bondone	Bondy
Bonito	bonita
Bonito	bonita
Bora	bor
Boreck	borec
Borecký	borec
Borek	borec
Borek	borec
Boren	borec
Borný	Zborný,Oborný
Borodino	Borodin
Borodinovka	Borodin
Borov	Zborov
Borovansko	Borovan
Borovanský	Borovan
Borovka	borůvka
Borovovanka	Borovan
Borovánek	Borovan
Borův	borůvka
Bosnay	Bosna
Bosnák	Bosna
Bostone	Boston
Botana	botanika
Boubínsko	Boubín
Bouda	Boudný
Boudy	bouda
Bourn	Bourne
Bořice	bořit
Bořiny	bořit
Bořislavka	Bořislav
Bořita	bořit
Boříkovy	Bořík
Boříček	Bořík
Božkov	Božka
Brabantia	Brabant
Brade	brada
Bradna	brada
Bradné	brada
Brahma	Bráhma
Brambory	brambor
Brandao	brand
Brandejský	Brandejs
Brandes	Brandýs
Brandeys	Brandejs
Brando	brand
Brandys	Brandýs
Brandýsko	Brandýs
Brane	brána
Brano	brána,obrana,brand
Brany	brána,brand
Braný	brána
Brdec	Brdečka
Brdek	Brdečka
Brdečný	Brdečka
Brdo	Brdy
Breber	breberka
Brejský	brejk
Brita	Brit
Brito	Brit
Britt	Brit
Brod	brodit
Brodie	brodit,Brod
Brody	Brod
Broj	zbroj
Broz	brozovat
Brozyn	Brozan
Broža	Brož,brož
Brožina	brož,Brož
Brtnice	brtník
Brtnicko	brtník
Brtnička	brtník
Brtničák	brtník
Brtníky	brtník
Brtníček	brtník
Bruk	brouk
Brunea	brunet
Brunec	brunet
Brunete	brunet
Brunno	brunátný
Brunát	brunátný,brunet
Brusnický	brusnice
Brusné	brusnice
Brusník	brusnice
Brynda	bryndat
Brzezinský	Brzezina
Bránek	brána
Bránice	bránit,brána
Bránský	brána
Brýl	brýle
Brňo	Brno
Buba	bubák
Bubáč	bubák
Bubáček	bubák
Buchan	Buchanan
Buchar	Buchár
Buchtele	buchta
Buchárí	Buchár
Buchář	Buchár
Buday	Buda
Budiš	Budišov
Budišovsko	Budišov
Budo	budovat,Buda
Budová	Buda,budovat
Budy	Buda,budovat
Budyně	Buda
Budínka	Budín
Budínský	Budín
Bukovno	bukovat
Bukovník	bukovat
Buková	bukovat
Bukovák	bukovat
Bulat	zabulat,zbulat
Bulgakovová	Bulgakov
Bulhary	Bulhar
Bulíček	bulík
Bumba	bumbat
Bumbác	bumbat
Bumbálka	Bumbál
Bundová	bunda
Bunia	Bunin
Bunič	Bunin
Bunt	buntovat
Buquoyová	Buquoy
Buranov	buran
Burianec	Burian
Burianek	Burian
Burianková	Burian
Burián	Burian
Buriánek	Burian
Buriánková	Burian
Burjace	Burjat
Burlák	burlak
Buryová	Bury
Buráň	buran
Burček	burčet
Burďák	Burda
Bučec	bučet
Buček	bučet
Buček	bučet
Buďa	Buda
Buďová	Buda
Buňkov	buňka
Buřinský	buřina
Bystřicko	Bystřice
Bystřický	Bystřice
Bystřina	Bystřice
Bystřina	Bystřice
Byzance	Byzanc
Byňov	Bynov
Bábel	Babel
Bábá	bába,Bába
Bábík	Babík
Báchor	bachor
Bájo	báje
Bánov	bán
Bárd	bard
Bártů	Bárt
Bártů	Bárt
Báča	bača
Bíla	bílý,Běla
Bílina	Bělina
Bílka	Bíl
Bílkov	Bíl
Bílov	Bíl
Bílá	bílý
Bílá	bílý
Býkov	býk
Běla	Bělina
Běle	Běla,běl
Bělehradová	Bělehrad
Bělice	Bělov,běl,Bělina,Běla
Bělik	Bělík
Bělina	Běla
Bělič	Bělov
Bělkov	Bělov,běl
Bělovov	Bělov
Bělsko	běl
Bělský	běl
Bělý	Běla,běl,bílý
Bělý	Běla,běl,bílý
Bělč	běl
Běsno	běs
Bětík	bítník
Břevnice	břevno
Březice	Březina
Březinka	Březina
Březinky	Březina
Březiny	Březina
Března	Březnice
Březník	Březnice
Březný	březí,Březa
Březík	březí
Břečkov	břečka
Bříza	Březa
Bříza	Březa
Carat	cárat
Carraro	Carrara
Casanová	Casanova
Ce	cé
Cecile	Cecilie
Cecilio	Cecilie
Cejnek	cejn
Celestica	Celesta
Celestina	Celesta
Celestine	Celesta
Celli	cello
Celovec	celovat
Cenek	cena
Ceni	cena
Cento	cent
Cesar	César
Chalco	Chalch
Chalupníčková	Chalupník
Chalupný	chalupa
Chalupy	chalupa
Cham	chám
Chan	chán
Chan	chán
Chanov	chan
Charitka	charita
Charvat	Charvát
Charvátce	Charvát
Charvátek	Charvát
Charváty	Charvát
Chatt	chata
Chilina	Chile
China	chinin
Chini	chinin
Chino	chinin
Chlumec	chlum
Chlád	chlad
Chlévsko	chlév
Chmela	chmel
Chmelař	chmelařit
Chmelařík	chmelařit
Chmelka	chmel
Chmelo	chmel
Chobotský	chobot
Chochola	chochol
Chochole	chochol
Chodov	Chod
Chody	Chod
Chorvátský	Chorvat
Choustnicko	Choustník
Chrastice	Chrasta,chrastit
Chrastina	Chrasta
Chrastiny	Chrasta
Chrastičky	Chrasta
Chrastný	Chrasta
Chrastová	Chrasta
Christian	Christián
Christiania	Christián
Christianie	Christián
Chrobáček	chrobák
Chrome	chromý
Chrudina	chrudit
Chrámce	chrám
Chrástecko	Chrástek
Chrástecký	Chrástek
Chrástecký	Chrástek
Chud	chudý,chudý
Churchil	Churchill
Chvojka	chvoj
Chvíla	chvíle
Chyňavák	Chyňava
Chábera	Chabera
Chánov	chán,chan
Cichlidae	cichlida
Cicvárek	cicvár
Cidlinský	Cidlina
Cigan	Cigán
Cigánková	Cigán
Cimbal	cimbál
Cimbálková	cimbál
Cimbálník	cimbál
Cin	cín
Cinkan	cinkat
Clowe	clo
Commodore	Commodor
Commodore	Commodor
Cope	cop
Cuc	cucek
Cuketka	cuketa
Curier	Curie
Cvik	cvičit
Cyrani	Cyrano
Cílka	cíl
Cílková	cíl
Císařský	císař
Cítkov	cítit
Cítov	cítit
DServer	server
Dacán	dacan
Daják	Dajak
Dal	dál
Dalek	daleký
Dalmacie	Dalmácie
Dalmatinec	dalmatin
Dama	dáma
Daniell	Daniel
Daniels	Daniel
Daniil	Daniel
Danov	Dan
Danove	Dan
Danájek	Danaj
Datels	datel
Dauphine	dauphin
Daur	ďaur
Davide	David,Davidov
Davidko	David
Davidovič	Davidov
Dačický	Dačice
Debica	debit
Dee	dé
Dehtáry	dehtář
Dehtáře	dehtář
Dene	den
Dene	den
Dene	den
Denia	den
Denisov	Denis
Denisák	Denis
Diamantina	diamant
Dietrichsteinský	Dietrichstein
Digital	digitál
Dimitr	Dimitrov
Dimitra	Dimitrov
Dimitrovka	Dimitrov
Dimitrovo	Dimitrov
Dimitrovski	Dimitrov
Dimitrová	Dimitrov
Dinara	dinár
Dionýsios	Dionýsos
Ditrichštejnský	Ditrichštejn
Divice	Divina
Divo	divý
Dlabáč	Dlabač,dlabat
Dobay	doba
Dobeška	Dobeš
Dobiaš	Dobiáš
Dobruše	Dobruš
Dol	důl
Dolana	Dolany
Dolanc	Dolany
Dolejší	Dolejš
Dolejší	Dolejš
Dolejší	Dolejš
Doli	dole
Dolin	Dolina,dolinář
Dolina	dolinář
Dolinar	dolinář
Dolinek	doliňák,Dolina
Dolo	dole
Dolňácko	dolňák
Domingos	Domingo
Dominick	Dominic
Dominika	Dominik
Dominikovič	Dominik
Dominiček	Dominic,Dominik
Dominička	Dominic,Dominik
Donate	donace
Donati	donace
Donec	donace
Donna	donace
Donne	donace
Donát	donace
Donátek	donace
Dore	Dora
Doro	Dora
Dorte	dort
Dosev	osev
Dospíšil	Pospíšil
Dostal	Dostál
Dostálková	Dostál
Dostálík	Dostál
Doutnáč	doutnat
Douša	Duša
Dovrtěl	Vrtěl
Drahanský	Drahan
Drahánek	Drahan
Draháň	Drahan
Drba	drbat
Drlička	Drlík
Drobec	drobeček
Drobek	drobeček
Drobička	drobit
Drobík	drobeček
Drosendorf	Rosendorf
Drozda	drozd
Drož	drožka
Druide	druid
Drábský	dráb,Dráb
Dráža	dráha
Drštka	dršťka
Dual	duál
Dubrovin	Dubrov
Dubrovský	Dubrov
Ducati	ducat
Ducato	ducat
Duchač	Ducháč
Duchcovsko	Duchcov
Dukátník	dukát
Dunajová	Dunaj
Durán	Duran
Dynamite	dynamit
Dávid	David
Díké	dík
Dítě	dít
Dědice	dědina,dědit
Dědinka	dědina
Děkanovský	děkan
Děkanová	děkan
Dřevěnice	dřevěnkář
Dřínov	dřín
Dříň	dřín
Džbánice	džbán
Džbánov	džbán
Edie	edice
Edina	edice
Eduardo	Eduard
Egerer	Eger
Eliott	Eliot
Elite	elita
Elitka	elita
Emile	Emil
Empiria	empirie
Entlová	entlovat
Epica	epika
Ergometrin	ergometrie
Eschauer	Schauer
Estera	ester
Eston	Estonsko
Eston	Estonsko
Estrada	estráda
Estreicher	Streicher
Etana	etan
Excel	excelovat
Extréme	extrém
Eštok	štok
Fabien	Fabián
Fabini	Fábina
Fabinyi	Fábina
Fabiánková	Fabián
Fabri	fabrika
Fabrice	fabrika
Fabrici	fabrika
Falcký	falc,Falc
Falk	Falc,falc
Fandík	fandit
Fantini	fant
Farmak	farma
Faso	fasovat
Fato	Fatos
Faulí	faul
Fausek	Faust
Fausto	Faust
Feder	federovat
Federico	federovat
Femina	feminní
Fendi	fendovat
Fendi	fendovat
Fenin	fen
Fenix	fénix
Fens	fen
Ferra	Ferrara
Ferrari	Ferrara
Ferrari	Ferrara
Ferrarini	Ferrara
Ferraro	Ferrara
Ferrat	Ferrara
Fichte	Ficht
Fidelio	Fidel
Fidelis	Fidel
Fidél	Fidel
Figaro	Figar
Figuri	figura
Fik	fík
Fikes	fikce
Fila	filc
Filcík	filc
Filipe	Filip
Filipi	Filip
Filipinec	Filipíny
Filipinský	Filipíny
Filips	Filip
Filipský	Filip
Filipína	Filipíny
Filko	filc
Filmařík	filmařit
Fils	fil
Fils	fil
Fine	Fink
Fini	finiš
Finke	Fink
Fiskali	fiskál
Fistula	fistule
Fixová	fixovat
Fišera	Fišer
Flandin	flanda
Flauto	flauta
Flavio	Flavius
Fleky	flek
Flers	fleret
Flexík	flexe
Flint	flinta
Florec	Florena
Florenc	Florencie
Florence	Florencie
Florencia	Florencie
Florenciin	Florencie
Florencio	Florencie
Florenský	Florena,Florian
Florent	Florentina,Florena
Florentin	Florentina,Florena
Florentino	Florentina,Florena
Florentýn	Florentina
Florentýna	Florentina
Florentýnka	Florentina
Florey	Florena
Floria	Florena,Florian
Floriano	Florena,Florian
Florin	Florena,Florian
Florio	Florena
Floriánek	Florian
Floriánová	Florian
Foltyn	Foltýn
Fonovice	fonovat
Fontain	fontána
Fontaine	fontána
Fontana	fontána
Fontana	fontána
Fontane	fontána
Fontani	fontána
Formann	Forman
Formánek	Forman
Fotografia	fotografie
Frajerová	frajer
Fran	Franke
Frana	frank,Francie
Franc	frank,Francie
Franca	Francie,frank,Franky
Francaise	Francie
France	Francie
France	Francie
Frances	Francie
Francesko	Francie
Franci	Francie,frank
Francin	Francie,frank,Franke
Francina	Francie,frank
Francine	Francie,frank
Francioni	Francie
Francis	Francie
Francisci	Francie
Francisco	Francie
Francisco	Francie
Francisko	Francie
Franck	frank,Francie,František
Francke	Francie,frank
Franckovka	Francie
Franco	Francie,frank
Francák	frank,Francie
Franců	frank,Francie
Franců	frank,Francie
Franek	frank
Franieck	Franic
Frank	Franky,Francie
Franka	Franky,Franke,frank
Frankia	Franky,Franke,frank
Frankie	Franke,Franky,Francie,frank,frankismus
Franko	Franky,Franke,frank
Franks	frank,Franky
Frano	Francie
Frans	frank
Frantic	František
Frantice	František
Frantina	František
Františák	František
Franče	Franke,Franky
Frater	fráter
Frenštatský	Frenštát
Frick	Fric
Fricke	Fric
Fridrichovský	Fridrich
Friedmann	Friedman
Friuli	Friul
Friča	Frič
Frontera	fronta
Fronto	fronta
Fryk	Fryč
Fryštacký	Fryšták
Fryštak	Fryšták
Fryštácko	Fryšták
Fryštát	Fryšták
Fryštáček	Fryšták
Frís	Frísko
Frýda	Frýd
Frček	frčka
Funda	fundovat
Furmánek	Furman
Fák	fáč
Fára	fara,fárat
Fátima	Fatima
Fíček	fík
Gabrieli	Gabriel
Gabčíkovo	Gabčík
Gajdaj	Gajda,gajdy
Gajdos	Gajdoš
Galanta	galantní
Galante	galantní
Gale	Gal,Gál
Gale	Gal,Gál
Gale	Gal,Gál
Galera	galéra,galerie
Galia	Gal
Galicia	Galicie
Galicin	Galicie
Galilei	Galilea
Galileo	Galilea
Galileo	Galilea
Galileo	Galilea
Galina	Gal
Galský	Gal
Galt	gall
Galén	Galen
Gamina	gamin
Gandhí	Gándhí
Ganga	gang
Gastronomia	gastronomie
Gazdo	gazda
Gellnar	Gellner
Gene	gen
Gene	gen
General	generál
General	generál
Genie	gen
Genova	gen
Gentile	Gent
Gentilo	Gent
Geodézie	geodezie
Georgia	Georgij
Georgievský	Georgiev
Georgijev	Georgij
Gerlache	Gerlach
Gerlachovka	Gerlach
Germaina	Germain
Germaine	Germain
German	Germán
Germania	Germán
Germanie	Germán
Gero	Gera
Geseke	gesce
Gestvík	gesto
Geta	Get
Gete	Get
Getino	Get
Ghanec	Ghana
Ghaní	Ghana
Ghání	Ghana
Gigante	gigant
Gila	Gil
Gilk	Gil
Gilová	Gil
Gilík	Gil
Gira	giro
Giri	giro
Glajchová	glajchovat
Goldberger	Goldberg
Gonda	gondat
Gorochovský	Gorochov
Goth	Gotha,Gota
Gotthardt	Gotthard
Grabovac	grabovat
Gradiente	gradient
Grado	grad,gradovat
Grady	grad
Grafie	ideografie
Grafite	grafit
Grana	granát
Granat	granát
Granato	granát
Granice	granit
Granier	granit
Granin	granit
Granite	granit
Grano	granát
Greenville	Grenville
Gregory	Gregor
Grenvillová	Grenville
Grešl	grešle
Grin	gril
Grit	gril
Grička	gril
Grof	gróf
Grossmann	Grossman
Gráf	graf
Gudžarátec	Gudžarát
Gulaš	guláš
Gumotextilka	gumotextil
Gurdžár	Gurdžar
Guty	Guta
Habanec	habán
Habánov	habán
Habáník	habán
Habáň	habán
Habřinka	habřina
Habří	habr
Hachl	hachle
Hadra	hadr
Haja	Háj,háj
Hajduček	hajdučit
Hajdučík	hajdučit
Haját	hajat
Hak	hák
Haldane	halda
Hale	hala
Hale	hala
Haleňák	halena
Halí	hala
Hamak	Hamák
Hamra	hamr
Hamrníky	hamr
Hamá	Hamák
Hanace	Hana
Handlovský	handl,Handl
Hani	Hana
Hanina	hanit
Hank	Hana
Hanna	Hana,Haná
Hanne	Hana,Haná
Hanno	Haná,Hana
Hannover	Hanover
Hanns	Hana,Haná
Hanzálková	Hanzal
Hanín	hanět
Harari	Harare
Harcov	harcovat
Harcovna	harcovat
Hare	Harare
Harmonit	harmonie
Haré	Harare
Hasištejnský	Hasištejn
Hastrmanová	hastrman
Haussman	Haussmann
Havant	Havana
Havele	Havel
Havlice	Havlov
Havlice	Havlov
Havlovič	Havlov
Havlovka	Havlov
Havranková	havran
Havransko	havran
Havraníky	havran
Havraň	havran
Haňa	Hana,Haná
Hašová	hašovat
Heck	hec
Hecová	hecovat
Hegmon	hegemon
Heinc	Hein
Heine	Hein
Heini	Hein
Heino	Hein
Heinovský	Hein
Hejna	Hejnice,hejno
Hejnic	Hejnice,hejno
Hejník	Hejnice,hejno
Hejný	Hejnice,hejno
Hejtmanová	hejtman
Hejtmánek	hejtman
Hejtmánka	hejtman
Hekaté	hekat
Helene	Helena
Helveti	helvet
Herain	heroin
Hercegoviňák	Hercegovina
Hercig	Herceg
Hermafrodítos	hermafrodit
Herman	Hermann
Heřman	heřmánek
Heřmaneč	heřmánek
Hindustan	Hindustán
Hita	hit
Hits	hit
Hladil	hladit
Hladký	hladit,hlad
Hladný	hlad
Hlavaj	Hlava,hlava
Hlavatý	hlava,Hlava
Hlavna	hlava,Hlava
Hlavnice	hlava,Hlava
Hlemýždí	hlemýžď
Hlinice	Hlinka
Hlinicko	Hlinka
Hlinický	Hlinka
Hlinička	Hlinka,Hlinsko
Hlinka	Hlinsko
Hlinková	Hlinka
Hlinky	Hlinka
Hlohovičky	Hlohov
Hlohová	Hlohov
Hlouček	hloučit
Hlubinka	hlubina
Hlubinský	hlubina
Hlubiňák	hlubina
Hlučínský	Hlučín
Hlušička	Hlušík
Hlušičky	Hlušík
Hnanice	hnanec
Hnaník	hnanec
Hnánice	hnanec
Hnátko	Hnát,hnát,hnát
Hnátnice	Hnát,hnát,hnát
Hnátík	Hnát,hnát,hnát
Hník	hníst
Hochmann	Hochman
Hodgkins	Hodgkin
Hodice	hodit,hodina
Hodicko	hodina,hodit
Hodický	hodit,hodina
Hodinka	hodinkář,hodina
Hodonínka	Hodonín
Hodoníňan	Hodonín
Hojka	hojit
Holaň	Holan
Holobrada	holobradý
Holohlavy	holohlavý
Holubov	holub
Holubář	holubařit
Holán	Holan
Holáň	Holan
Homer	Homér
Homer	Homér
Homola	homole
Homolka	homole
Homolka	homole
Honda	Honza
Honda	Honza
Honore	honor
Honoré	honor
Horizonte	horizont
Horka	horký
Horky	horký,Horka
Horký	Horka
Horn	horna
Horna	hornatý
Horne	horna,hornatý
Hornice	horna,hornatý
Hornich	horna
Hornicová	Hornik
Horno	horna
Hornák	horňák,horna
Hornát	hornatý,horňák
Hornáček	horňák,hornatý
Horní	horna,hornatý
Horník	Hornik,Horniak,horna,horňák
Horný	horna,hornatý
Horný	horna,hornatý
Horácko	Horác
Horňátky	hornatý
Horňáček	horňák
Horšice	horšit
House	houst
Housska	houska
Houška	houští
Hovora	hovor
Hovězí	Hověz
Hořanský	Hořan
Hořec	hořet
Hořenice	hořec
Hoření	hořec
Hoření	hořec
Hořetice	hořet
Hořice	hořec
Hořice	hořec
Hořánek	Hořan
Hořánková	Hořan
Hrabko	Hrab
Hrabský	Hrab
Hrabáč	hrabat
Hrabáň	Hrabánek
Hrabí	hrabě,Hrab
Hrabětice	Hraběta
Hrach	hrách
Hradiský	Hradisko
Hradišťánek	Hradišťan
Hrant	hrana
Hraník	hraničník
Hrbov	hrb
Hrdly	hrdlo
Hrdza	hrdý
Hromadník	hromada,Hromada
Hronec	Hroník,Hron
Hronov	Hron
Hronský	Hron
Hroněk	Hroník
Hroudný	hrouda
Hrozek	Hroza
Hroňová	Hron
Hrubský	hrubý
Hrubínka	Hrubín
Hrudka	hruď
Hrušecký	hruška
Hruškov	hruška
Hruškovský	hruška
Hrušková	hruška
Hrušky	hruška
Hrácha	hrách
Hrádecko	Hrádek
Hrůza	Hroza
Hrůzek	hrůza
Hubay	huba
Hubař	huba
Hubbert	Hubert
Hubička	hubit
Hubna	hubnout,huba
Huda	Hudec
Hudecký	Hudec
Hudek	Hudec
Hudeč	Hudec
Huhne	huhňat
Hulan	hulán
Hulva	hulvát
Hulánová	hulán
Hulínský	Hulín
Humnice	humno
Humpolačka	humpolák
Humpoláková	humpolák
Hurbanovo	Hurban
Hurta	hurtovat
Hust	hustý
Husár	husar
Huďa	Hudec
Hvozda	hvozd
Hvízdal	hvízdat
Hvězdenský	hvězda
Hynšt	hynout
Hysteria	hysterie
Hábr	habr
Háda	hádat
Hádí	Hádek
Háje	háj,Háj
Hájecký	háj,Háj
Hájek	háj,Háj
Hájko	Háj,háj
Hájov	háj,Háj
Háka	hák
Hála	hala
Hána	Hana,Haná
Hándl	Handl,handl
Hání	Hana
Háy	Hay
Hášimí	Hášim
Hérakleios	Hérakleitos
Hít	hit
Hřebec	Hřebeč,hřeb
Hřebecký	hřebec
Hřebek	hřebec,Hřebeč,hřeb
Hřebenice	hřebec
Hřebenka	hřebec,hřebenatý
Hřebenky	hřebenatý
Hřebský	hřeb
Hřebík	hřebec
Hřebíček	hřebec
Hřivna	hřivnatý
Hůle	hůl
Hůry	hůra
Ignace	Ignác
Ignacy	Ignác
Ignácio	Ignác
Ignát	Ignác
Iki	iks
Imam	imám
Imobilia	imobilie
Impact	impakt
Indonesie	Indonésie
Inov	inovovat
Instinet	instinkt
Invalidovna	invalida
Inventa	inventář
Iona	ion
Ione	iont,ion
Ionov	ion
Ionová	ion
Irak	Irák
Irene	Irena
Irákí	Irák
Iréne	Irena
Isa	osa
Ischia	ischias
Iser	eser
Ito	sto
Ivanov	Ivan
Ivaň	Ivan
Ivič	Ivičič
Iván	Ivan
Ištvan	Ištván
Jabloneček	Jablonec
Jablonica	Jablonec
Jablonné	Jablonec
Jablunka	Jablunkov
Jablunkovan	Jablunkov
Jachym	Jáchym
Jadranka	Jadran
Jadranko	Jadran
Jahodnice	jahoda
Jahodná	jahoda
Jakobič	jakobita
Jal	jalový
Jama	Jáma,jáma
Janak	Janák
Jandák	Janda
Jandáček	Janda
Janeka	Janečka
Janišov	Janiš
Jantarský	jantar
Janás	Janus
Janát	Janák
Janáč	Janák
Jarmar	jarmark
Jarmárka	jarmark
Jarošov	Jaroš
Jary	jarý
Jasanka	jasan
Jasanský	jasan
Jasmína	jasmín
Jaspers	Jasper
Javora	javor
Javorie	Javorin
Javorina	Javorin
Jedlí	jedle
Jedničkin	jednička
Jehnice	jehně
Jehnědno	jehněda
Jelenec	Jelena
Jelenice	Jelena,jelen
Jelení	Jelena,jelen
Jeleň	jelen
Jelimán	jeliman
Jemení	Jemen
Jesenec	Jesenin
Jesenice	Jesenin,jesen
Jesenské	Jesenin
Jesenský	jesen
Jeseník	Jesenin
Jeseň	jesen,Jesenin
Jestřábka	jestřáb
Jestřábský	jestřáb
Jetelka	jetel
Jett	jet
Jevišovicko	Jevišovice
Jeřábek	jeřáb
Jihlavák	Jihlava
Jin	jiný,Jinek,jíní
Jináček	Jinek
Jiranek	Jiránek
Jirasek	Jirásek
Jirkovský	Jirkov
Jiruš	Jirouš
Jiráni	Jiránek
Jirásko	Jirásek
Jiráský	Jirásek
Jičínský	Jičín
Jiřice	Jiří,jiřina
Jiřinec	jiřina
Jiřinský	jiřina
Jiřský	Jiří
Jiřínský	jiřina
Johann	Johan
Jordan	Jordán
Jordan	Jordán
Jordan	Jordán
Jordánie	Jordán
Jordánka	Jordán
Jov	oj
Joze	Joza
Juanův	Juan
Jude	Judea,Juda
Jugoslavie	Jugoslávie
Juliánka	Julián
Juliánov	Julián
Junan	Junona
Jungman	Jungmann
Junáček	junák
Juračko	Jurač
Juristová	jurista
Justa	justice
Juste	justice,Just
Justi	Just,justice
Justicová	justice
Justin	justice
Justina	justice
Justine	justice
Justitia	justice
Justo	Just
Justy	Just,justice
Justyna	Justýna
Jániš	Janiš
Jánov	Ján
Jílové	jíl
Jína	jíní
Jínek	Jinek
Jíno	jíní,jiný
Jíně	jíní,jiný
Jósef	Josef
Jůn	Jon
Kabele	kabela
Kabelice	kabel
Kabelka	kabel
Kabický	kabina
Kabonil	kabonit,kabonět
Kachlík	kachlíkář
Kacéřov	kacéř
Kacířová	kacíř
Kade	kadet
Kadei	kadet
Kadena	kadet,kadence
Kader	kadeř
Kadetová	kadet
Kadett	kadet
Kadár	Kádár
Kaine	Kain
Kajetan	Kajetán
Kajetánka	Kajetán
Kakata	kakat,kakao
Kalevala	Kaleval
Kalikovák	Kalik
Kalikst	Kalik
Kalin	Kalinin
Kalina	Kalinin
Kalinec	Kalinin
Kalinič	Kalinin
Kalinovo	Kalinin
Kalinský	Kalinin
Kalita	kalit
Kalný	kalý
Kalužný	kaluž
Kaly	kalý
Kalík	Kalik
Kamarádová	kamarád
Kamen	kámen
Kamenačky	kameňák
Kameni	Kamený
Kamenka	Kamenec
Kameno	Kamený
Kamenáčky	kameňák
Kamení	Kamený,Kamenec
Kameňákov	kameňák
Kamilov	Kamil
Kampan	kampaň
Kampelik	kampelička
Kampelík	kampelička
Kamča	Kamčatka
Kanaan	Kanaán
Kanal	kanál
Kananová	Kanaán
Kanclíř	kancléř
Kanda	kandovat
Kanea	kanec
Kann	Kanaán
Kann	Kanaán
Kannan	Kanaán
Kano	kanout
Kanoute	kanout
Kanouté	kanout
Kanov	kanovník
Kanáda	Kanada
Kanáry	kanár
Kanás	Kanak
Kanát	Kanak
Kaník	kanec
Kapec	Kapet
Kapelní	kapelničit,kapela
Kapilárie	kapilára
Kapitál	kapitála
Kapitáňová	kapitán
Kaprálik	kaprál,Kaprál
Kara	kára
Karabáček	karabáč
Karakalpacko	Karakalpak
Karata	karate
Karbonia	karbon
Karbonová	karbon
Karelie	Karel
Karelův	Karel
Karliková	Karlik
Karlík	Karlik
Karmazin	Karmazín
Kart	karta
Kartouzka	kartouza
Kartouzová	kartouza
Kartouzy	kartouza
Karták	kartáč
Karélie	Karel
Kasai	kasa
Kast	kasta
Kaste	kasta
Kastilia	Kastilie
Kasáč	Kasák
Kasáčková	Kasák
Kasík	Kasák
Kat	kát
Kate	kat,kát
Kateřinice	Kateřina
Kateřinky	Kateřina
Kateřinov	Kateřina
Kati	kat,kát
Kato	kat
Katy	kat
Katyně	Katyna
Kaut	knokaut
Kavalíř	kavalír
Kavkazsko	Kavkaz
Kaván	Kavan
Kaznějovsko	Kaznějov
Kazík	kazit
Kača	káča
Kača	káča
Kačal	Kačalov
Kačák	káča
Kašparec	Kašpar
Kašparková	Kašpar
Kašparů	Kašpar
Kašparů	Kašpar
Kašperk	Kašper
Kašperka	Kašper
Kašperko	Kašper
Kašpersko	Kašper
Kašpárková	Kašpar
Kaštanka	kaštan
Kaštanov	kaštan
Kaštánek	kaštan
Kaštánková	kaštan
Kelčí	Kelč
Kenedy	Kennedy
Keno	Keňa
Kenša	Keňa
Ker	keř
Kerouack	Kerouac
Keňo	Keňa
Keřsko	keř
Khmér	Khmer
Kiki	kiks
Kikujo	Kikuj
Kilianová	Kilián
Kirovský	Kirov
Klabavce	Klabava
Kladné	kladný,Kladno
Kladníky	kladný,Kladno
Klapzuba	Klapzubák
Klar	Klára
Klara	Klára
Klat	klát,klátit
Klatovačka	Klatovy
Klatovský	Klatovy
Klatovák	Klatovy
Klaunika	klaun
Klecanský	Klecan
Klee	klec
Kleine	Klein
Kleine	Klein
Klemenc	Klement
Klementice	Klement
Klenota	klenot
Klenov	klen
Klenová	klen
Klenský	klen
Klení	klen
Klepač	Klepáč
Klepačov	Klepáč
Klepetko	klepeto
Klepák	Klepáč
Klepáčková	Klepáč
Klepáčov	Klepáč
Klepétko	klepeto
Kleček	kleč,klečet
Klečka	kleč
Klima	Klimák
Klimecký	Klimek
Klimentiev	kliment
Klimko	Klimek
Klimáčková	Klimák
Klimíček	Klimek
Klin	klinika
Klina	klinika
Klinc	klinika
Kline	klinika
Klink	klinkat,klinika
Klink	klinkat,klinika
Klinka	klinkat,klinika
Klinkl	klinkat
Klinko	klinkat,klinika
Klinský	klinika
Klička	klika
Klobouky	klobouk
Kloboučky	klobouk
Klofát	klofat
Klokočka	klokoč
Klokočník	klokoč
Klokočov	klokoč
Klokočí	klokoč
Klokočůvky	klokoč
Klonk	klon
Kloos	Klos
Klose	Klos
Klouza	klouzat
Klouzek	klouzat
Klouzovy	klouzat
Kloz	klozet
Kluc	Kloc
Klusáčková	Klusák
Kluč	klučit,kluk
Kluč	klučit,kluk
Kluček	klučit,kluk
Klučka	kluk
Kládek	kláda
Klár	Klára
Klát	klátit
Klášterec	klášter
Klášterecko	klášter
Klášterka	klášter
Klášterský	klášter
Klínský	klín
Klíčov	Klíč,klíč
Klíše	Klíš
Kmenský	kmen
Kmeť	kmet
Kmínek	kmín
Knoflíček	knoflík
Knott	knot
Kníř	knír
Knězek	kněz
Knězů	kněz
Knězů	kněz
Knězů	kněz
Kněžice	Kněž
Kněžka	Kněž
Kněžák	Knížák
Kobylá	kobyla
Kocan	Kocán
Kohak	Kohák
Kohoutice	kohoutit
Koios	kos
Kojič	kojit
Koki	koks
Koko	koka,kočí
Koky	koka
Kolek	Koleč
Kolečko	Koleč
Kollar	Kollár
Kolnák	kolna
Kolon	kolona,kolonie
Koloničný	kolonie
Kolovraty	kolovrat
Kolovrátek	kolovrátkář
Kolínský	Kolín
Komeda	komedie
Komet	kometa
Komárom	komár,Komár
Komárov	komár,Komár
Kon	kůň
Kona	konat
Konaté	konat
Konařík	Koňařík
Kone	konec,konat
Kone	konec,konat
Konecký	konec
Konica	konec
Konice	konec
Konop	konopí
Konopa	konopí
Konstanc	Konstantin,konstanta
Konstanca	Konstantin,konstanta
Konstance	Konstantin,konstanta
Konstancie	Konstantin
Konstanco	Konstantin,konstanta
Konstancu	Konstantin
Konstantinky	Konstantin,konstanta
Konstantinov	Konstantin,konstanta
Konstantinovna	Konstantin
Konstantinus	Konstantin,konstanta
Kontová	konto
Konáč	konat
Koné	konec,konat
Kop	kopí
Kopanica	kopaničář
Kopanič	kopaničář
Kopaničár	kopaničář
Kopačík	Kopač
Kopec	Kopeč
Kopec	Kopeč
Kopernica	Kopernik,Koperník
Kopernický	Kopernik,Koperník
Kopet	kopec
Kopečný	Kopeč
Kopisty	kopist
Kopits	kopit
Kopitz	kopit
Koptík	koptit
Kopáčik	Kopáč,Kopač
Kopča	kopčit
Kopček	kopčit
Kopčil	kopčit
Kopčo	kopčit
Kopčák	kopčit
Kopčáni	kopčit
Kopčík	kopčit
Kopřivnice	kopřiva
Kopřivnička	kopřiva
Kopřivík	kopřiva
Korab	koráb
Koral	korál
Koral	korál
Korecký	korec
Korený	korec
Korina	Korint
Kormoran	kormorán
Korunní	koruna
Korál	korálkář
Kos	Kosovo
Kos	Kosovo
Kosař	kosíř
Kosec	kos
Kosmata	kosmatý
Kosmo	kosmos
Kosov	Kosovo,kos
Kosovič	Kosovo
Kostelič	kostel
Kostelka	kostel,Kostelný
Kostelní	Kostelný,kostel
Kostelík	kostel
Kostice	kostkář
Kostka	kostkář
Kosík	Kosák
Kosířová	kosíř
Kosířsko	kosíř
Kot	Kott
Kotelice	kotel
Kotelsko	kotel
Kotelský	kotel
Kotlár	kotlář
Kotlářová	kotlář
Kotnik	kotník
Kotor	Kotora
Kotoučov	kotouč
Kotto	Kott
Koubek	Koubík
Kouk	kouč
Koutský	kout,kout
Kouřimov	Kouřim
Kovačik	Kovač
Kovačič	Kovač,Kováč
Kovačík	Kovač
Kovařovice	Kovařovic
Kovařovič	Kovařovic
Kovič	kov
Kovo	kov,Kováč
Kovolit	kovolitec
Kováčík	Kováč
Koza	kozák
Kozak	kozák
Kozar	Kozár
Kozák	koza
Kozí	koza
Kozík	kozák
Koča	kočí,koka
Kočař	kočár
Koček	Koč
Kočič	Koč,kočí
Kočko	kočka,Koč
Kočov	Koč
Kočí	Koč
Kočí	Koč
Koňakov	koňak
Koňák	koňak
Koňákov	koňak
Kořan	Kořán
Kořenice	kořen
Kořenov	kořen
Kořensko	kořen
Kořenský	kořen
Košat	košatý
Košata	Košatka,košatý
Košec	Košík
Košicko	Košice
Košik	Košík
Košilka	košile
Košov	koš
Košátko	košatý
Košátky	košatý,Košatka
Košíkov	Košík
Košíky	Košík,Košice
Košínov	Košín
Košťal	košťál,Košťál
Košťálkov	košťál,Košťál
Košťálková	košťál,Košťál
Košťálov	Košťál,košťál
Kožušnik	Kožušník
Kožár	kožař
Kracik	Kracík
Kracíček	Kracík
Krajc	kraj
Krajský	kraj
Krajíc	kraj
Krajč	kraj
Krajča	kraj
Krajči	kraj
Krajčí	kraj
Krakovič	Krakov
Krakovák	Krakov
Kral	král,Král
Kralik	Králik
Kramár	Kramář
Kraslicko	Kraslice
Krasosmutnění	krasosmutnit
Kraval	kravál
Krchovová	krchov
Krejcárek	krejcar
Krejča	krejčí
Krejčí	Krejčík
Krejčí	Krejčík
Krejčů	krejčí
Krejčů	krejčí
Kristi	Krist
Kristian	Kristián
Kristiania	Kristián
Kristianie	Kristián
Kristina	Kristýna
Kristiánov	Kristián
Kristýnek	Kristýna
Kriz	krize
Krizek	krize
Krizia	krize
Krka	krk
Kronich	kronika
Kropáčková	Kropáč
Kropáčov	Kropáč
Krosnař	krosnář
Krosno	krosna,kros
Kroutil	kroutit
Kročko	kročit
Krupa	krupař
Krupár	krupař
Krupčík	Krupka
Kruta	krutý
Krutilková	Krutil
Krutina	Krutil
Kruty	krutý
Krutílková	Krutil
Kruček	kručet
Krušec	krušit
Krušnohoří	Krušnohor
Krylovo	Krylov
Krystian	Krystián
Krákořice	zakrákořit
Králicko	Králík
Králov	Král,král
Královka	král,Král
Králové	Král,král,Královák,Králík
Krása	krást
Krásno	krása
Krátká	krátký
Kráty	krátký,kráter
Krča	Krč
Krčík	Krč,krčit
Kršnák	Kršna
Kuban	Kubáň
Kubatko	Kubát
Kubaň	Kubáň
Kubaň	Kubáň
Kubek	kubík
Kubelice	Kubelík
Kubelik	Kubelík
Kubica	Kubin
Kubice	Kubin
Kubie	Kubin
Kubik	Kubič,kubík
Kubina	Kubin
Kubinský	Kubin
Kubinyi	Kubin
Kubičko	Kubič,kubík,Kubin
Kubánek	Kubáň
Kubánkov	Kubáň
Kubáč	Kubač,Kubák
Kubáš	Kubaš
Kubín	Kubin
Kubínková	Kubín
Kubíče	kubík
Kuchařka	Kuchar,Kuchár
Kuchynka	kuchyně,Kuchyňa
Kudlata	kudlat
Kudláč	Kudlák
Kudláčková	Kudlák
Kukle	kukla,Kukla
Kulik	Kulikov,Kulík
Kulin	kulinář
Kulke	Kulka
Kulkov	Kulka
Kumpan	kumpán
Kumšta	kumšt
Kundrat	Kundrát
Kundrata	Kundrát
Kuno	kuna
Kuno	kuna
Kunrátková	Kunrát
Kunský	Kunka
Kunt	Kunc
Kunák	kuna
Kunát	kuna
Kuní	Kunc,kuna
Kunčičky	Kunka
Kunčák	Kunka
Kunčí	Kunka
Kuomintanec	kuomintan
Kupča	kupčit
Kupček	kupčit
Kupčo	kupčit
Kupčík	kupčit
Kurdí	Kurd
Kurdík	Kurd
Kuric	kurie
Kurka	okurka
Kurko	okurka
Kutil	kutit
Kutina	kutit
Kutáč	Kuták
Kušan	Kušán
Kvak	kvák,kvačit
Kvapilík	Kvapil
Kvačice	kvačit
Kvačková	kvák
Kváč	kvák,kvačit
Kváča	kvák
Kváčková	kvák
Květinov	květena
Květnice	květena
Květnický	květena
Květná	květena
Květy	květ,květena
Květín	květena
Kybernet	kybernetika
Kyjovský	Kyjov
Kynice	kynik
Kyte	kyt
Kálik	Kalik
Kántor	kantor,Kantor
Káto	kát,kat
Kášek	kaše
Kýček	kýč
Křemenec	Křemen,křemen
Křemenice	Křemen,křemen
Křenek	křen,Křen
Křenice	Křen,křen
Křenov	Křen,křen
Křenovy	křen,Křen
Křenovák	křen,Křen
Křenůvky	křen,Křen
Křepel	křepelka
Křepelková	křepelka
Křepčík	křepčit
Křetinský	Křetín
Křetínský	Křetín
Křeč	křeček
Křivce	křivý
Křivice	křivý,Křiva
Křivoklání	Křivoklát
Křivský	křivý,Křiva,Křivák
Křivánek	Křivan
Křiváčková	Křiva
Křivé	Křiva,křivý
Křivý	Křiva,Křivák
Křiček	křivý
Křička	křivý
Křišťálová	křišťál
Křižanov	Křižan
Křižánky	Křižan
Křoví	Křovák
Křídla	křídlo
Křížko	kříž,Kříž
Křížov	Kříž,kříž
Křížová	Kříž,kříž
Kšíra	kšír
Kůs	kos
Kůča	kočí
Kůští	košt,Kůst
Labeo	Labe
Labuťa	labuť
Ladná	Lada
Lahodný	lahoda
Lamia	lamino
Lamini	lamino
Lana	lano
Landao	landat
Lane	lano
Lani	lano
Lani	lano
Laně	lano
Laokoón	Láokoón
Lasica	lasice
Laska	láska
Laska	láska
Late	látka,lata,lát
Latin	latina
Latini	latina
Latinák	latina
Latka	látka,lata,latina
Latko	látka,lata
Lato	lata
Laudon	Laudonov
Laurene	Laurent
Lauria	Laurin
Laurinc	Laurin
Laurinský	Laurin
Lauro	Laura
Lauro	Laura
Lava	láva
Lavický	lavice
Lawrenc	Lawrence
Lazare	Lazar
Lazár	Lazar
Lača	láčka
Laďa	Lada
Laška	Laškov,laškovat
Laško	Laškov
Laško	Laškov
Laškovič	Laškov
Lažánky	Lažánek
Lažánský	Lažánek
Lebedev	Lebeda
Lebedov	Lebeda
Lebeď	lebedit
Ledec	Ledeč
Ledecký	Ledeč
Ledek	Ledeč
Ledečko	Ledeč
Ledečky	Ledeč
Ledečsko	Ledeč
Ledkov	ledkovat
Lednice	lednit
Lednicko	lednit
Lednický	lednit
Ledvice	Ledvina
Ledvinov	Ledvina
Legend	legenda
Legerský	Leger
Lele	lelek
Lemke	Lem,lem
Len	Lenin
Lene	Lena
Lene	Lena
Leni	Lena
Lenica	lenit,Lenin
Lenický	Lenin,lenit
Lenk	Lena
Leno	Lena
Lenovo	len
Lenský	len
Leníček	Lenin
Leon	Leona
Leonardo	Leonard
Leone	Leona
Leone	Leona
Leontin	Leontina
Leopoldo	Leopold
Leptač	leptat
Leptáč	leptat
Lepš	lepšit
Lepšík	lepšit
Leskovec	Leskov
Leskovský	Leskov
Lesnice	lesnit
Letohradsko	letohrad
Letovy	letovat,Letov
Levante	Levant
Levice	Levit
Levitt	Levit
Levský	lev,levý
Levy	levý,lev
Levík	levý
Levý	lev,Levit
Levč	levý
Lešensko	lešení
Leško	Leš
Leštnice	Leština
Leštínský	Leština
Lhotky	Lhotka,Lhota
Lhoty	Lhota
Lhůty	lhůta
LiDE	lid
Liana	liána
Liberal	liberál
Liberie	Liberec
Liberta	libertin
Libertinová	libertin
Libertín	libertin
Libunský	Libuň
Libyně	Libye
Liběchovky	Liběchov
Lidie	lid
Liechtensteinsko	Liechtenstein
Lili	lilie
Lili	lilie
Lilic	lilie
Lilka	lilie
Lin	linie,linout
Lin	linie,linout
Lina	linout,linie
Lind	Linda
Lindovský	Linda
Lindák	Linda
Linhartice	Linhart
Linhartovy	Linhart
Link	linkař
Lipanský	lipan
Lipany	lipan
Lipiner	Lipina
Liping	Lipina
Lipinský	Lipina
Lipiny	Lipina
Lisa	lísa
Lisec	lis
Lisec	lis
Lisek	lis
Lisov	lis
Lisov	lis
Lisový	lis
Liss	lis
Liss	lis
Liss	lis
Lisý	lis
Litecký	litec
Litoměřic	Litoměřice
Litoměřičák	Litoměřice
Littin	litice
Litvínovice	Litvínov
Liškov	liška
Liškovský	liška
Lištná	lišta
Lnáře	lnář
Loděnice	loděnka
Loginov	login
Loketsko	loket
Lokomotiv	lokomotiva
Lombard	Lombardie
Lombardi	Lombardie,lombard
Lombardo	lombard,Lombardie
Lomnica	Lomnice
Lomnicko	Lomnice
Lomníček	Lomnice
Lomoz	lomozit
Lomozová	lomozit
Lonek	Loník
Loněk	Loník
Lopušník	Lopušný
Lopéz	Lopez
Lorcy	Lorca
Loreth	Loreta
Loretta	Loreta
Loretto	Loreta
Loudin	loudit
Loudát	loudat
Louky	louka
Lounky	Loun
Loutkov	loutka
Loučany	Loučný
Loučka	loučit
Loučky	Loučka,loučit
Loučovský	loučit
Loužek	louže
Love	lov
Loz	lozit
Lubica	Lubina
Lubinka	Lubina
Lublice	Lublin
Lublín	Lublin
Lubomíra	Lubomír
Lucemburský	Lucemburk
Lucera	Lucern,lucerna
Lucerna	Lucern
Lucian	Lucián
Lucice	Lucie
Lucio	Lucie
Ludvik	Ludvík
Luhový	luh
Lukavecko	Lukavec
Lukaš	Lukáš
Lukáška	Lukáš
Lukášov	Lukáš
Lukšik	Lukšík
Lupenice	lupenitý,lupenka
Lusitania	Lusitán
Lusitanie	Lusitán
Lusitánie	Lusitán
Lučenecko	Lučenec
Luďa	luďák
Lužce	Lužice
Luže	Lužice
Lužec	Lužice
Luženičky	Luženice
Lužin	Lužice
Lužiny	Lužice
Lužička	Lužice
Lužnice	Luženice
Luží	Lužice
Lánička	Láník
Lánov	lán
Lánsko	Láník
Lánský	lán,Láník
Lásková	láska
Lát	látka
Látka	lata,lát
Láček	láčka
Léger	Leger
Lév	lev
Lín	líný
Líny	líný
Líní	líný
Lípový	lípa
Lísal	lísat
Líté	líto,lítý
Líza	lízat
Líšno	Líšný
Maceček	macek
Machalický	Machalík
Macháč	Machač
Madar	Maďar
Madian	madián
Madonna	Madona
Madras	Madrás
Maduro	Madura
Magdalena	Magdaléna
Magdalénka	Magdaléna
Magica	Magic
Mahdie	mahdí
Majak	maják
Mak	mák
Makedonov	Makedonie
Makovič	Makov
Makovička	Makov
Makovský	Makov
Makový	Makov
Malecký	Malec
Malecí	Malec
Malia	malina
Malik	Málik,Malič
Malikí	Malič
Malin	malina
Malinec	malina
Malinin	malina
Malink	malina
Malinová	malina
Malinský	malina
Mallorka	Mallorca
Malo	malý
Malovaný	malovat
Malte	Malta
Malte	Malta
Malátný	Malát
Maléř	malér
Malínský	Malín
Malíč	Malič
Man	Mann
Man	Mann
Manas	Maňas,maňas
Manda	mandant,mandát
Manda	mandant,mandát
Manda	mandant,mandát
Mandarino	mandarín
Mandl	mandle
Manganka	mangan
Mange	mango
Manilov	Manila
Manka	manko
Mankin	manko
Maori	Maor
Marak	Marák
Marcia	Marcin
Marcinov	Marcin
Marcio	Marcin
Mare	Marek
Marec	Marek
Marecs	Marek
Mariam	Maria
Mariana	Maria
Mariane	Maria
Mariani	Maria
Mariano	Maria
Marica	Marie
Marici	Marie
Marier	Marie
Marijsko	Maria,Marija
Marin	Maria,Marie
Marina	Maria,Marie
Marine	Maria,Marie
Marine	Maria,Marie
Marini	Maria,Marie
Marino	Maria,Marie
Marino	Maria,Marie
Marinák	mariňák
Mario	Maria
Marketa	Markéta
Marketa	Markéta
Marko	markovat
Markov	Markovič
Markovec	markovat
Markytánová	markytán
Marlowe	Marlow
Marmeladová	marmeláda
Maro	Maroko
Maro	Maroko
Marte	Mart
Marte	Mart
Martens	Marten,Martin
Martic	Martiš
Martin	Martinov,Martín,Marten
Martine	Martin
Martini	Martin
Martinice	Martin
Martinický	Martin
Martino	Martin,Martinov
Martins	Martin
Martinák	Martin
Martiník	Martin
Martinš	Martin
Martinů	Martin
Marty	Mart
Martynov	Martyn
Martí	Mart
Maruše	Maruš
Marvan	Marván
Mary	máry
María	Maria,Marie
Maršálek	maršál
Maršálová	maršál
Masar	Masár
Masaryčka	Masaryk
Master	Masters
Mastersová	Masters
Masty	mast
Mate	mat
Mate	mat
Mati	mat
Matica	matika
Mats	mat
Mattia	matka
Matura	maturovat
Matějek	Matějík
Matějičný	Matějík
Matějíčková	Matějík
Matůš	Matoš
Maurj	Maurja
Mauroy	Maur
Maxima	maximum
Maximus	maximum
Mayo	May,Mao
Mazát	mazat
Mařica	mařit
Maří	mařit
Maša	Máša
Meandre	meandr
Meca	mech
Mech	mechovatý
Mechová	mechovatý
Med	Méd
Medea	Medek
Medeo	Medek
Medica	Medina,medit
Medicejský	Medicej
Medici	Medina,medit
Medvědice	medvěd
Medvědov	medvěd
Medvěděv	medvěd
Meissner	Messner
Melko	Melk
Melo	Melk
Melvile	Melvill
Melville	Melvill
Melč	Melk
Memorial	memoriál
Mendele	Mendel
Menš	menšina
Menší	menšina
Menší	menšina
Mero	Meroe
Mertens	Merten
Mertin	Merten
Merunka	meruňka
Merč	merk,merčit
Mesticová	mestic
Metal	metál
Meteora	meteor
Metropole	metropol
Metálová	metál
Metánov	metan
Mezuláník	mezulán
Mia	mina
Michalik	Michalič
Michalovce	Michalov
Michalovic	Michalov,Michalovič
Michalovský	Michalov
Michalský	Michal
Michel	Michelin
Michelangeli	Michelangelo
Micheline	Michelin
Michl	Michlík
Michnice	Michna
Michnáč	Michna
Michňák	Michna
Mihalik	Mihalík
Mihule	Mihula
Miki	Mikis
Mikulovský	Mikulov
Mikuláška	Mikuláš
Mikulášov	Mikuláš
Mikýsek	Mikes
Mila	milý
Milan	Milán
Miletínsko	Miletín
Milica	milice
Milich	milice
Milický	milice
Milička	milice
Milo	milý
Milo	milý
Milovy	milice
Miloševic	Miloševič
Milánovo	Milán
Milánovy	Milán
Mimi	mimikry,mimika,mimino
Mimica	mimino
Mimochodek	mimochod
Min	mina
Mina	minuta
Minas	Minos
Minaříček	Minařík
Minc	mince
Mineapolis	Minneapolis
Mineral	minerál
Minice	mina
Minna	mina
Mino	mina,minuta
Minoos	Minos
Minář	mina
Minářík	Minařík
Miní	mina
Mira	Mirek
Miro	Mirek
Miron	Mironov
Mironovič	Mironov
Mirský	Mirek
Misic	misie
Missek	misie
Misso	misie
Mitač	Mitáč
Mithridates	Mithridatés
Mišic	Mišík
Mlynar	Mlynář
Mlynár	Mlynář
Mléčka	mléčit
Mlíčník	mlíčný
Mníchov	Mnichov
Mobile	mobil
Modr	Modra
Modrow	Modra
Mogilevič	Mogilev
Mojžiš	Mojžíš
Moliére	Moliér
Mona	Monako
Monaco	Monako
Mons	monský
Monse	monský
Montania	Montana
Montoy	montovat,Montana
Montoya	montovat,Montana
Monty	Montana
Montána	Montana
Moravanský	Moravan
Moravík	Moravsko
Morde	mord
Mordvinsko	Mordvin
Morena	Morea
Moreno	Morea
Morrisson	Morrison
Mosty	most
Motive	motiv
Mouline	Moulin
Moulinié	Moulin
Mozík	mozek
Mořice	Mořic,Mořina
Mraz	mráz
Mrlíňák	Mrlínek
Mrština	mrštit
Multiscan	multiscanovat
Mundo	Mund
Muzička	muzika
Muška	muškař
Mája	máj
Málikí	Málik
Mánička	mánie
Mária	Maria
Márty	Mart
Mása	masa
Máče	mák
Máček	mák
Médea	Méd
Míchal	Michal
Míla	míle
Mílka	míle,Míla,mělký
Mínice	mínit
Míra	mír
Mírov	mír
Míča	míč
Míček	míč
Míčka	míč
Míčov	míč
Míšeňsko	míšeň
Mýto	mýt
Měchuřinka	měchuřina
Mělice	mělký
Mělka	mělký
Mělnice	Mělník,mělnit
Měsíček	měsíc
Měňany	měňavý
Měřinský	měřit
Měřička	měřit
Můčka	močka
Nachtmann	Nachtman
Najada	najáda
Najmann	Najman
Namib	Namibie
Namibe	Namibie
Nardo	nard
Nasadil	Sadil
Nate	Nat
Nate	Nat
Navarro	Navarra
Navrátilík	Navrátil
Nay	Nat
Nazaretský	Nazaret
Načeradský	Načerad
Neandertal	neandertálec
Neckář	neckař
Nedvědice	Nedvěd
Nepal	Nepál
Nepilý	Nepil
Neptune	Neptun
Neptune	Neptun
Nesvačily	Nesvačil
Netolicko	Netolice
Netolický	Netolice
Netřísk	netřesk
Neumann	Neuman
Neumětely	neumětel
Neurastenin	neurastenie
Nezbeda	nezbedný
Nešťastný	nešťastník
Nice	Nick
Nicky	Nick
Nicky	Nick
Nico	Nick
Niec	Nick
Nik	ničit
Nike	Nick
Niko	Nick
Nikolajevič	Nikolajev
Nikolajevna	Nikolajev
Nikolajevsk	Nikolajev
Nikotina	nikotin
Niky	Nick
Niké	Nick
Nile	Nil
Nils	Nil
Nina	Nick
Nino	Nick
Ninove	Nick
Nita	nit
Nitra	nitrace,nitro
Nitransko	Nitran
Nič	ničit
Nora	Nor
Normann	Norman
Noro	nora
Nose	nos,Nos
Nosov	nos,Nos
Nosálov	Nosál
Nouza	nouze
Nova	nový,Novák
Novak	Novák
Novo	nový
Novotníky	Novotný
Nunvářová	nunvář
Nádeníková	nádeník
Nádeníček	nádeník
Návara	Navara
Níké	Nick
Němček	Němčice
Němčicko	Němčice
Němčický	Němčice
Němčičky	Němčice
Obejd	obejda
Obejdí	obejda
Obejdí	obejda
Oblomovský	Oblomov
Obludník	obluda
Obrecht	Brecht
Obruby	obruba
Ocelka	ocel
Oceánie	oceán
Och	doch
Océ	cé
Ohaj	Háj,háj
Okoč	Koč
Okrouhlice	zokrouhlit
Oldřiš	Oldříš
Olin	Olina
Olive	Oliva,oliva
Olivieri	Olivier
Oloví	olovo
Olympia	Olympie
Olympic	Olympie
Olší	olše
Onor	Nor,donor
Opal	opál,opálka
Opal	opál,opálka
Opolánky	Opolan
Opočnice	Opočno
Opálka	opál
Opálka	opál
Ordinová	ordinovat
Orfeo	Orfeus
Organ	orgán
Oriente	orient
Orlovský	Orlov
Osetsko	Oset
Osex	sex
Oslanec	Slanec
Osmanov	Osman
Osmin	osmina
Ostaš	Ostašov
Ostaškov	Ostašov
Ostroj	stroj
Ostrovsko	ostrov
Ostrovský	ostrov
Osum	Sum
Osvětimsko	Osvětim
Otouš	Touš
Otruba	Votruba
Otta	Ottawa
Our	Zour
Ovada	ovadat
Ove	ovce
Pachta	pacht
Pacovský	Pacov
Pakistán	Pákistán
Palace	palác
Palacký	palác
Palatý	Palata,palác
Palek	palec,Palec
Palette	paleta
Palisade	palisáda
Palička	palice
Palmae	palma
Palák	palác
Palát	palác
Panay	Panák
Pandžáb	Paňdžáb
Panek	Panák
Panev	pánev
Pannonie	Panonie
Panorama	panoráma
Pansofia	pansofie
Panta	pantáta
Panta	pantáta
Pantani	pantáta
Pantano	pantáta
Pantene	pantáta
Panáč	Panák
Papa	papá,papat
Papaj	papája
Papay	papája,papat,papá
Paprskářová	paprskář
Papuk	papuč
Pardubický	Pardubice
Pardubičky	Pardubice
Parodia	parodie
Parti	part
Partizan	partizán
Pará	pára
Pascale	pascal,Pascal
Pascale	pascal,Pascal
Pascali	Pascal,pascal
Pasov	pas
Pastoriza	Pastor
Pata	Zapata
Pate	pat,pata
Patka	pata
Patric	Patrik
Patty	pata
Pauč	Pauk
Pavlačka	pavlač
Pavlice	Pavlov
Pavlič	Pavlov
Pavličič	Pavlov
Pavličko	Pavlov
Pavličky	Pavlov
Pavlovič	Pavlov
Pavlovičky	Pavlov
Pavlovna	Pavlov
Pavlovsky	Pavlov
Pavlovský	Pavlov
Pavlánský	pavlán
Pazur	pazour
Pačič	páčit
Pařížov	Paříž
Pearsonová	Pearson
Pec	Peck
Peca	pech
Pechač	Pecháč
Pecna	pecnář
Pek	pec
Pekař	pekařit
Pekařík	pekařit
Pelc	Pelé
Pele	Pelé
Pelhřim	Pelhřimov
Pelka	Pelé
Pendla	pendl
Pennsylvanie	Pennsylvánie
Pensylvánie	Pennsylvánie
Penta	pentle
Pentl	pentle
Pepe	pepa,Pepa
Pepek	pepa,Pepa
Per	pero
Perk	pero
Perka	pero
Pernek	perník
Pernický	perník
Pernik	perník,pernikář
Pernička	perník
Perníkář	pernikář
Perugino	Perugia
Pescara	Pescar
Pestřice	pestřit
Peter	Petera
Petran	Petrán
Petraš	Petráš
Petráč	Petrák
Petráň	Petrán
Petráško	Petráš
Petrželková	petržel
Petržilkovský	Petržil
Petržíl	Petržil
Petržíla	Petržil
Pešicová	Pešice
Piao	piano
Piava	Piave
Pike	Pikt
Piko	Pikt
Pilka	pila,Pila
Pilný	pila,Pila
Pilo	Pila,pila
Pilote	pilot
Pina	pinie
Pine	pinie
Pine	pinie
Pinka	pinie
Piperková	Piper
Pit	pít
Pitt	pít
Pitter	Piter
Pivonka	Pivoňka
Placentia	placenta
Plachta	Placht
Plank	Plánka
Planta	plantat
Plantae	plantat
Plastici	plastika
Plate	plátno,plát,plát
Platini	platina
Platonov	Platon
Plavka	Plávka
Plavy	plavat
Plechač	Plecháč
Plevnice	Pleva,pleva
Pleče	plečka
Pleška	pleš
Plzenec	Plzeň,plzeň
Plánice	plán
Plánička	Plánka,plán
Plánička	Plánka,plán
Plánsko	plán
Plát	plátno
Pláň	plán,Plánka
Pochylová	pochylovat
Podhorácko	podhorák
Podhoráček	podhorák
Podhájí	Podháj
Podol	podolí
Podolanky	Podolan
Podolán	Podolan
Podstatský	podstata
Podzemník	podzemní
Podzemný	podzemní
Poděbrad	Poděbrady
Poděbradovna	Poděbrady
Poděbradský	Poděbrady
Pohraniční	pohraničář
Pohánka	Pohan,pohan
Pokojov	pokoj
Pol	půl
Polc	pole
Poldová	poldovák
Poledna	poledne
Polepský	polep
Police	policie
Policko	policie,police
Polický	police,policie
Polička	police
Poličky	police
Poljanský	Poljan
Polk	pole
Polnička	polní
Polná	polní
Polník	polní
Polomí	Polomík
Polygrafia	polygrafie
Polík	políček
Políkno	políknout
Pomněnice	pomněnka
Pomněnkář	pomněnka
Pondělníček	Pondělík
Ponice	poník
Ponik	poník
Poniky	poník
Poot	pot
Pope	pop,Pop
Popelková	popelka
Popelná	popelka
Porot	porota
Portaš	portáš
Porte	port
Porte	port
Porte	port
Portmann	Portman
Portášky	portáš
Poseidonia	Poseidon
Pospíšilík	Pospíšil
Post	půst
Post	půst
Postřižiň	Postřižín
Potměšil	potměšilý
Potoček	Potůček
Poříč	poříčí
Požar	požár,Požár
Prabulhar	Bulhar
Prace	práce
Pracký	pracka
Prajza	Prajz
Prasek	prase
Prat	prát
Pravy	pravý
Prašivice	prašivý
Prašivka	prašivý
Prašivka	prašivý
Preclik	preclík
Prelude	preludovat
Premier	premiéra,premiér
Prey	prvý
Primo	prima
Prince	princ
Principe	princip
Principe	princip
Prochazka	Procházka
Proplast	plast
Propper	Popper
Prosič	prosit
Prost	prostý
Prost	prostý
Protivínsko	Protivín
Protivínský	Protivín
Prou	Proust
Prozor	pozor
Prudice	prudit
Práchenský	Prácheň
Práče	práce
Pulc	pult
Puč	pučit
Pučík	pučit
Pušča	puška
Pánov	pán
Páta	pátek,pata
Pátík	pátek
Pátý	pátek
Pávov	páv
Páč	páčit
Pék	péče
Péč	péče
Péšavár	Péšávar
Píca	píce
Pícek	píce
Pícl	píce
Píka	píča
Pískatý	pískat
Písko	písek
Písty	píst
Píč	píča
Pěna	pěnice
Pěnička	pěnice
Pěnka	pěna,pěnice
Pěník	pěnice
Pětík	pětník,pět
Pěčka	Pěč
Přes	přesný
Přeslička	přeslice
Přeštěnice	štěnice
Přibyslavský	Přibyslav
Přívozec	přívoz
Příčovy	příčit
Pšenica	pšenice
Pšenička	pšenice
Pšeník	pšenice
Quijote	Quijot
Rabe	rabi
Rabí	rabi
Rabštejnková	Rabštejn
Rachman	Rachmaninov
Rachmanin	Rachmaninov
Rachmanov	Rachmaninov
Racháč	rachat
Rade	Radek
Radecký	Radek
Radeč	Radek
Radeč	Radek
Radiolaria	radiolárie
Radoň	radon
Radošiná	Radošin
Radošín	Radošin
Radvanov	Radvan
Radvanský	Radvan
Raděj	Radějov
Raf	ráf
Raisa	Rais
Rajec	rajka
Rajko	rajka
Rakovka	Rakovník
Rakové	Rakovník
Rambouský	Rambous
Rambus	Rambo
Ramus	rámus
Ramí	rámě
Rana	rána,raný
Randa	Randák
Rank	ranč
Ranke	Rankov
Rankin	Rankov
Rankin	Rankov
Ranko	Rankov
Raná	rána
Rančin	Rankov
Raroh	roh
Rataje	rataj
Ratajský	rataj
Ratana	ratan
Raymann	Rayman
Raýman	Rayman
Raňkov	Rankov
Regere	Reger
Regularia	regulární
Rejdice	rejdit
Rejžek	rejže
Reko	rek
Relief	reliéf
Remisová	remisovat
Rena	Renáta
Rentia	renta
Report	reportovat
Retinová	retinovat,retina
Reto	ret
Rhodes	Rhodos
Rilke	Rilkov
Rilko	Rilkov
Rimbaudová	Rimbaud
Ripová	ripovat
Riva	Rive
Roberta	Robert
Roberti	Robert
Roberto	Robert
Roberts	Robert
Rodin	Rodinov
Rodrigues	Rodriguez
Rohanov	Rohan
Rohový	rohovatý,roh
Roháče	Roháč
Roja	roj
Rojek	Rojík
Rojko	Rojka
Rojo	roj,Rojka
Rokytnice	Rokyta
Rokytá	Rokyta
Rolc	role
Rolinc	Rolin
Romania	Roman
Romanovna	Romanov,Roman
Romanovov	Romanov,Roman
Ron	Ronov
Ronan	Ronov
Ronin	Ronov,ronit
Rosette	Rosetta
Rost	růst
Rostovcov	Rostov
Rostová	Rostov
Rott	rota
Route	routa
Rovere	rover
Rovina	rovinář
Rovné	rovný,Rovný
Roštění	roštěná
Rubena	Rubens
Rubin	rubín
Rubén	rubín
Rude	Ruda,rudý
Rudná	Ruda
Rudné	Ruda
Rudy	rudý
Rudá	Ruda
Rumplová	rumplovat
Rus	Rusko
Ruse	rusý
Ruse	rusý
Rusínsko	Rusín
Ruta	routa
Rutin	rutina
Ruďák	Ruda
Rybař	Rybář
Rybár	Rybář
Rybáře	Rybář
Rychtová	rychtovat,rychta
Rychtář	rychta
Ryn	Rýn
Ryt	rýt
Rytířov	rytíř
Rytířsko	rytíř
Ryšava	ryšavý
Rádl	rádlo
Rája	ráj
Rájec	ráj
Rájov	ráj
Ráček	ráčit
Révay	réva
Róbert	Robert
Rýz	ryzí
Růža	růže
Saba	Sába
Sabena	Sabina
Sabie	Sabina
Sabine	Sabina
Sabini	Sabina
Sabinov	Sabina
Sabinský	Sabina
Saccharin	sacharin
Sadek	Sádek
Sadie	sadit,Sadov
Sado	Sadov
Sadovský	Sadov
Sadík	sadit
Sakramento	sakrament
Saky	sako
Sal	sál
Sal	sál
Salajna	Salaj
Salam	salám
Salvator	Salvátor
Salámí	salám
Samaritan	Samaritán
Samec	samet
Samek	samec,samet
Samnium	Samnita
Samos	Sámos
Samsonov	Samson
Sana	saně
Sandi	Sandino
Sandia	Sandino
Sandra	Sandro
Sane	saně
Sanka	sankce
Sankt	sankce
Sano	saně
Santa	Santana
Santa	Santana
Santa	Santana
Santayana	Santana
Santi	saně
Saní	saně
Sardina	sardinka
Sardinsko	sardinka
Saskie	Sasko
Satir	satira
Saturnia	Saturn
Saturník	Saturn
Savanna	savana
Savi	savo
Savoie	savo
Schmitke	Schmitt
Schuman	Schumann
Scofield	Field
Sebastian	Sebastián
Sebastiani	Sebastián
Sedlatý	sedlat
Sedlecko	Sedlec
Sedlecký	Sedlec
Sedlčanka	Sedlčany
Segedín	Segedin
Sejk	sejček
Sekvencová	sekvencovat,sekvence
Semice	semický
Seminole	Seminol
Senay	senát
Senegalia	Senegal
Senečnice	Seneka
Sens	sen,seno
Senský	sen
Septimus	septima
Serafín	Serafin
Serafínský	Serafin
Sergijevský	Sergijev
Serpentine	serpent
Sete	set
Sete	set
Severn	Severa
Severokorejec	severokorejský
Seňo	seno
Sidonie	Sidon
Signal	signál
Siko	síci
Silans	silan
Silica	silice
Silone	silon
Silvano	Silva
Silvestro	Silvestrov
Silvestrová	Silvestrov
Simplicissimus	Simplicius
Sina	siný
Sine	siný
Sionko	Sion
Sira	sirý
Sisi	Sisa
Sisák	Sisa
Sisí	Sisa
Sita	sítina
Sitař	sitár
Siv	sivý
Sivák	Siva,sivý
Sivý	Siva
Skala	skála,Skála
Skale	Skalka
Skalica	Skalice
Skalický	Skalice
Skalička	Skalice
Skalnický	Skalník
Skalík	Skalice
Sklenár	Sklenář
Sklopek	sklopec
Skopek	skopec
Skoč	skočit
Skočov	skočit
Skočík	skočit
Skrovnice	skrovný
Skupice	skupina
Skupinová	skupina
Skupá	Skupa
Skutecký	skutek
Skuteč	skutek
Skyva	skýva
Skály	skála,Skála
Skřivaň	skřivan
Skřivánek	skřivan
Skřínský	skříň
Slad	sladký
Slade	sladký,slad,sladit
Slade	sladký,slad,sladit
Sladek	sladit
Sladovník	sladovničit
Slanina	slanit
Slanička	Slanec
Slatinice	slatina
Slatinka	slatina
Slatinky	slatina
Slatinský	slatina
Slatiny	slatina
Slatiňany	slatina
Slave	Sláva
Slavina	Slavia
Slavinský	Slavia
Slavičky	slavík
Slavníč	Slavník
Slavonice	Slavonie
Slavonicko	Slavonie
Slavoňov	Slavonie
Slavíkov	slavík
Slavíč	slavík
Slavíček	slavík
Slepica	Slepička
Sleza	Slezák
Slezak	Slezák
Sliž	Slíž
Sloboda	Slobodník
Slone	slon
Slonin	slon
Sloupsko	sloup
Sloupský	sloup
Smek	smeč
Smet	smetí
Smetan	smetana
Smetaník	smetana
Smets	smetí
Smolenice	Smolen
Smolensko	Smolen
Smolíkovský	Smolík
Smrčí	Smrk,smrk
Smutny	smutný,Smutný
Sobek	sobec
Sochora	sochor,Sochor
Sokolovo	sokol
Sokolí	sokol
Sol	sůl
Sol	sůl
Solanec	Solana
Solany	Solana
Solferino	Solferina
Soliman	Solimán
Solnicko	solnice
Solniční	solnice
Solár	solar
Sonata	sonáta
Sopko	sopka
Sovič	Sovík
Sovák	sova,Sova
Sovětice	sovět
Spade	spad
Spade	spad
Spasič	spasit
Spinek	Spina
Spořice	spořit
Spriengfield	Springfield
Srní	Srník
Stalinec	Stalin
Stalinka	Stalin
Stalino	Stalin,Stalinov
Stanický	Staník
Staniek	Staník
Stanislavov	Stanislav
Stanislavský	Stanislav
Stanič	Staník
Stanovič	stanovit
Stanovnice	stanovit
Staněk	Staník
Starka	star
Staré	star
State	stát,stát,stát
Staňkovsko	Staňkov
Staňkovský	Staňkov
Sterne	Stern
Stine	Stin
Stine	Stin
Stodo	Stoy
Stolica	stolice
Stolička	stolice
Ston	Stone
Straky	straka
Straňany	Straňan
Straňánek	Straňan
Strnady	strnad
Strojná	stroj
Strání	strana
Stráňa	strana
Stráňan	Straňan
Strýcová	strýc
Studecký	studený,Studený
Studenka	Studénka
Studené	Studený,studený
Studénky	Studénka
Stupno	Stupa
Style	styl
Stáník	Staník
Stáníček	Staník
Stáry	starý
Stěnka	stěna
Stěžov	stěžovat
Středozemě	středozemí
Střevlíček	střevlík
Stříbrnice	Stříbrný
Střížkov	stříž,Stříž
Střížková	stříž,Stříž
Střížov	stříž,Stříž
Substantia	substance
Suchanov	Suchan
Suchopárková	suchopár,Suchopár
Suchánek	Suchan
Sucháň	Suchan
Sud	osud
Sultan	sultán
Surovka	surový
Sutice	sutit
Svinná	Sviny
Svinov	svině
Svitava	Svitavy
Svitavsko	Svitavy
Svitávka	Svitavy
Svoboďák	svoboda
Svora	svor
Svéraz	svéráz
Svítek	svítit
Svítkov	svítit
Svítkovák	svítit
Svědík	svědek,svědět
Svědínek	svědět,svědit
Světce	svět,světnice
Světec	světnice
Světice	svět,světnice
Světnica	světnice
Světnička	světnice
Světnov	světnice
Světví	svět
Světí	svět
Světík	svět
Sylvan	Sylván
Sylvania	Sylván
Synek	syn
Syrov	syrový
Syrovice	syrový
Syrovátko	syrový
System	systém
Sáde	Sádek
Sádecký	Sádek
Sák	sak
Sámara	Samara
Sány	saně
Sání	saně
Sátí	sát
Sáňka	sáňkář
Sémiotica	sémiotika
Sén	sen
Sín	síň
Sísa	Sisa
Sítek	sítina
Sítiny	sítina
Sítné	sítina
Sítá	sítina
Sůva	sova,Sova
Tabaček	tabák
Tabáček	tabák
Tajná	tajný,taj
Tajo	taj,tajný
Tajov	taj
Talibánec	Taliban
Tana	tank,tanout
Tanguy	tango
Tano	tanout,tank
Tanzánie	Tanzanie
Tara	tára
Taranová	taranovat
Tata	táta,Tate,tát
Tata	táta,Tate,tát
Tatarka	Tatar
Tatce	Tate,tát,táta
Tatek	Tate
Tatár	Tatar
Tchan	tchán
Technia	technika
Technik	technika
Technosta	techno
Teig	Teigov
Teke	Teka
Teko	Teka
Tel	tele,Telč
Tela	tele
Telemarka	telemark
Tenk	tenký
Tenna	Tennant
Teplický	Teplice
Teplička	Teplice
Ter	teriér
Tercier	tercie
Terciera	tercie
Teren	terén
Terer	teriér
Terka	terč
Terminalia	terminál
Tesco	test
Testa	test
Tetov	tetovat
Tetovo	tetovat
Textilia	textil
Thakur	Thákur
Theodore	Theodor
Tichon	Tichonov
Tichonovič	Tichonov
Tichonovna	Tichonov
Tichá	Tichák
Ticháč	Tichák
Timúr	Tímúr
Tis	tisíc,Tisov
Tisá	Tisa
Tisý	Tisa
Titan	Titán
Tiziano	Tizian
Tkaloun	tkalounkář
Tlustice	tlustý
Tolarský	tolar
Tomanec	Toman
Tomáško	Tomáš
Tone	tonout
Tono	tonout
Toskánec	Toskána
Total	totál
Tottl	totál
Trajanov	Trajan
Trave	tráva
Tree	trek
Trentini	Trentin,Trent
Trentino	Trentin,Trent
Trentino	Trentin,Trent
Trento	Trent,Trentin
Trenčínsko	Trenčín
Tribune	tribun
Tricky	triko
Tripolisko	Tripolis
Tristane	Tristan
Tristán	Tristan
Trna	trn
Trnička	trn
Trnov	trn
Trnovo	trn
Trnský	trn
Trník	trn
Troja	Troják
Trojak	Troják
Trojanovo	Trojan
Trojačka	Troják
Trojna	trojka
Trost	Troy
Trávička	trávit
Trávník	trávníkář
Trávníček	trávníkář
Tun	tuna
Tune	tuna
Tunka	tuna
Tuppy	tupý
Tura	tur
Turanský	Turan
Turay	tur
Turbin	turbína
Turbine	turbína
Tureč	Turek
Turin	Turín
Turkmensko	Turkmen
Turner	turnér
Turský	Tursko
Tutka	tutový
Tutt	tutový,Tutu
Tutte	tutový
Tutti	tutový
Tutty	tutový,Tutu
Tvaroha	tvaroh
Tvarůžková	tvarůžkář
Tyle	Tyl
Tyne	týn
Tyč	tyčit
Téra	tér
Tóno	tón
TýTý	týt
Týl	Tyl
Týle	týl,Tyl
Týna	týn
Týne	týn
Týnec	týn
Týnice	týn
Týč	tyč
Týř	Týr
Těšínov	Těšín
Těšínský	Těšín
Třebanice	Třebaň
Třebeč	Třebíč
Třebonín	Třeboň
Třebáň	Třebaň
Třebíčko	Třebíč
Třeštice	třeštit
Tříletá	tříletý
Udeřice	udeřit
Udine	udice
Uhorčík	uhorčit
Ujung	Jung
Ulický	ulice
Umane	umanout
Umbro	Umbr
Unia	uniat,unie
Unika	unie
Unička	unie
Urban	Urbán
Urbana	urbánní
Urbářová	urbář
Ustrašín	Strašín
Valdens	Valden
Vale	Val
Vale	Val
Valenca	Valentina
Valent	Valentina
Valenta	Valentýn,Valentina,Valentin
Valente	Valentina,Valentin
Valente	Valentina,Valentin
Valente	Valentina,Valentin
Valenti	Valentina,Valentin
Valentia	Valentina,Valentin
Valentine	Valentina,Valentin
Valentine	Valentina,Valentin
Valentini	Valentina,Valentin
Valentino	Valentina,Valentin
Valentinovna	Valentina,Valentin
Valentiová	Valentin,Valentina
Valentín	Valentýn,Valentin
Valentýnová	Valentýn
Valečík	Valeč
Valko	valkovat
Valníček	valník
Valový	Val
Valčik	valčík
Valčič	valčík
Valčák	valčík
Vanc	vana
Vandrovec	vandrovat
Vane	vana
Vanek	Vaník
Vano	vana
Varadin	Varadín
Varhan	varhánek
Varhaník	varhánek,varhaničit
Vartovna	vartovat,varta
Vartovná	vartovat
Vavrík	Vavrik
Vaňáč	Vaňák
Veen	ven
Vegeta	vegetovat
Veje	vejce
Velc	velký
Vele	Vela,velký
Velebný	velebník
Velenice	Velen
Velenka	Velen
Velenov	Velen
Velenovy	Velen
Velenský	Velen
Veleň	Velen
Velička	veličit
Velkoněmecko	velkoněmec
Velková	velký
Velká	velký
Venca	Vencl
Vence	Vencl
Venice	ven
Venn	ven
Venová	ven
Verbovský	verbovat
Verbová	verbovat
Verlaine	Verlain
Verne	Verna
Vesec	ves
Veselí	Veselý,veselý
Veteška	veteš
Vett	veto
Vette	veto
Večeř	večer
Viki	viks
Vilič	vilik
Vilno	vilný
Vilík	vilik
Vilímec	Vilím
Vilímeč	Vilím
Vinay	vina
Vinařice	vinařit
Vincenc	Vincent
Vincente	Vincent
Vinice	vina
Vinklar	Vinklár
Vinklárková	Vinklár
Vinklář	Vinklár
Vino	vina
Vino	vina
Vinova	vina
Virgilio	Virgil
Virgina	Virginie
Virginia	Virginie
Virgínie	Virginie
Virgínie	Virginie
Viscontiové	Visconti
Viver	vivér
Vizina	vizita
Vizina	vizita
Vizovicko	Vizovice
Vladek	Vladík
Vladimirov	Vladimir
Vladimirovna	Vladimir
Vladimirovo	Vladimir
Vladimirsko	Vladimir
Vladimirský	Vladimir
Vladimiřsko	Vladimir
Vlas	Vlasov
Vlasta	vlast
Vlastik	Vlastík
Vlaštovičky	vlaštovka
Vlaštovková	vlaštovka
Vltavský	Vltava
Vládek	vládný
Vládík	Vladík
Vláďa	vládný,vládat
Vlčí	vlk,Vlk,vlčit
Vochlová	vochlovat
Vodnik	vodničit
Voděrek	Voděra
Vojenice	Vojen
Vojnice	vojna
Vojničky	vojna
Vojtěchov	Vojtěch
Vokal	vokál,Vokál
Vokurka	okurka
Volan	volán
Volante	volant
Vonica	vonice
Vos	Nos,nos
Voskár	Oskar
Voslař	oslař
Voslář	oslař
Vosoba	osoba
Vostrov	ostrov
Vostruha	struha,ostruha
Vostrý	ostrý
Vostál	Dostál
Vousův	vous
Voves	oves,ves
Voštice	voština
Vrabel	Vrábel
Vrané	Vrana
Vratislavice	Vratislav
Vratislávka	Vratislav
Vražina	vražit
Vrtel	Vrtěl
Vrána	Vrana
Vránský	vrána
Vrátný	vrátit
Vráto	vrátit
Vulkan	vulkán
Vyhlíd	vyhlídka
Vyhnálek	Vyhnal
Vyjídák	vyjídač
Vysoká	Vysoký,vysoký
Vyškovský	Vyškov
Vyškovák	Vyškov
Vác	vát
Václavov	Václav
Václaví	Václav
Vála	Vala
Vápenice	vápenět,vápeník,Vápeník
Váňa	vana
Vášeňka	vášeň
Vídenský	Vídeň
Vídeňský	Vídeň
Vítání	vítat
Vítů	vít,Vít
Vítů	vít,Vít
Věcheta	věchet
Věcov	věc
Věděno	vědět
Věnecký	věnec
Věnek	věnec
Věžky	věž
Všeteč	všetečný
Všetečka	všetečný
Vůjtěch	Vojtěch
Wait	Waits
Waite	Waits
Washingtonia	Washington
Washingtonians	Washington
Watts	Watt,watt
Weis	Weiss
Wellek	Welles
Wellingtonia	Wellington
Westfálsko	Westfál
Westwoodowá	Westwood
Whitmann	Whitman
Wikipedia	Wikipedie
Witte	Witt
Witti	Witt
Woody	Wood
Wágner	Wagner
Yoko	oko
Ypsilonka	ypsilon
Yser	user
Zababa	baba
Zabadal	Badal
Zabel	Zábel
Zada	záda
Zadin	zadina
Zahořansko	zahořan
Zajak	jak
Zajaroš	Jaroš
Zamora	zámora
Zborná	Zborný
Zborovy	Zborov
Zbožice	zboží
Zbožnice	zbožnit
Zbožnov	zbožnit
Zbrojová	zbroj
Zdenek	Zdeněk,Zdena
Zdeňa	Zdena
Zdeňa	Zdena
Zdeňo	Zdena
Zdík	Zdíkov
Zdíkovsko	Zdíkov
Zdíkovský	Zdíkov
Zednik	Zedník
Zeleneč	zelený
Zelenka	Zelenkov
Zelenov	Zelenkov
Zelené	zelený
Zenica	zenit
Zerzan	Zerzán
Zerzáň	Zerzán
Zhouf	houf
Zicho	Zich
Zinci	zinek
Zink	zinek
Zita	zíta
Zitko	Zita
Zitte	Zita
Zlatko	zlatý,zlatý
Zlatník	zlatničit
Zlatohlávek	zlatohlavý
Zlatohřívák	zlatohřivák
Zlosyň	zlosyn
Znamenka	znamení
Znamenský	znamení
Znamenáček	znamenat
Zoch	doch
Zornica	zornit
Zornice	zornit
Zouza	Zuza
Zubek	Zubík
Zuni	Zuna
Zuno	Zuna
Zvada	zvadat
Zvěstov	zvěstovat
Zvěřina	zazvěřit
Zykán	Zykan
Zábraní	Zábrana
Zábělá	záběl
Záhora	Záhor
Záhorí	Záhor
Záhoř	záhoří
Záhořice	záhoří
Záhořík	záhoří
Zákupsko	zákup
Zápeca	zápecník
Zátko	zátka
Závitkovský	závitka
Záškoda	záškodný
Zín	zen
Zítek	zíta
Zítko	zíta
absolutný	absolutní
abstraktno	abstraktní
abstraktno	abstraktní
acetylen	acetylén
acetylovaný	acetyl
adhezin	adheze
aerobic	aerobik
afiš	afišovat
africko	Afrika
ageneze	geneze
akacie	akácie
aktinita	aktin
aktuář	aktuár
akvarium	akvárium
alan	Alán
alavita	Alávita
albatrosí	albatros
albumin	albuminóza
albánsko	albánský
aligátoří	aligátor
alimentář	alimenty
alpínka	alpínkář
alumina	aluminium
amalgamový	amalgam
amalgovna	amalgovat
amazonit	Amazonie
ambice	ambit
ambrozie	Ambroz
američka	Amerika
amina	amin
amino	amin
anabaptizmus	anabaptismus
anaerobní	anaerob
anarchosyndikalismus	anarchosyndikalizmus
androidí	android
andulčí	andulka
anestézie	anestezie
anglica	Anglie
anglicko	Anglie
angolo	Angola
anorektička	anorektik
anta	anténa
anton	Antoník
apateka	apatekář
apolita	apolit
apologet	apologetika
apologetik	apologetika
apretovna	apretovat
aranž	aranžovat
argentea	Argentina
argentinsko	Argentina
argentit	Argentina
arijský	árijský
arián	ariánský
arkebuzýr	arkebuza
armovna	armovat
arte	art
arzen	arzén
asociát	asociál
aspirín	aspirin
astra	strast
asynchron	synchron
atlantica	Atlanta
atmosférik	atmosféra
atribuce	atribut
autentifikace	autentifikovat
autentično	autentický
automodelářství	automodelář
autooprava	autoopravář
autoritární	autorita
ašik	Šik
baby	baba
baby	baba
backup	backupovat
bafuňářství	bafuňář,bafuňařit
bagatel	bagatela
bal	bál
balistička	balistika
balkánsko	Balkán
balonek	balon
balonkový	balon
balonovitý	balon
balvanitý	balvan
balvanovitý	balvan
balvanování	balvan
balíčkář	balíkář
balónovitý	balón
ban	bán,báň,banka
banderie	Bandera
bank	banka
banyán	banán
bančička	banka
baně	banát
bardo	bard
bartoňky	Bartoň
bat	bát
batman	Batmanov
batmanovka	Batmanov
baňatý	banát
bednárna	Bednár
beduin	Beduín
benk	Benák
benzen	benzín
benzen	benzín
benzin	benzín
benátsko	Benátky
beraniční	beranit,beran
bergenie	Bergen
berla	berle
bernardýní	bernardýn
beryllnatý	berylnatý
beránky	beran
bezpečník	bezpečí
bezpečíčko	bezpečí
bezpáteřnatý	bezpáteřní
bilance	bilancovat
biobiftek	biftek
biofyzička	biofyzika
biohedvábí	hedvábí
bionanotechnologie	biotechnologie
biootop	biotop
bitumenovaný	bitumen
blank	Blanka
blankotradice	blankotradovat
blatnice	blata,Blatný
blatnička	Blatnice
blato	bláto,Blatný,blata
blechavec	blecha
blábolil	blábol
blýštět	blyštět,blýštit
bobře	bobr
bohumilý	Bohumil
bojný	boj
boliviano	Bolivián
bombarda	bombarďák
bombarďáky	bombarďák
bombař	bomba
bombér	bomber
bondovka	Bondy
bonin	bon
bootový	bootovat
bordelní	bordel
borlandí	Borland
borůvkovitý	borůvka
borůvkovo	borůvka
božkost	Božka
brahma	Bráhma
bramborovka	brambor
brdek	Brdečka
brdo	Brdy
breakdancer	breakdance
britsko	Brit
brokařka	brokař
brýlky	brýle
buchar	Buchár
buchar	Buchár
bucharinec	Bucharin
bukař	bukařit
bukovník	bukovat
bukureštský	Bukurešť
buldočit	buldok
burgunda	Burgund
burgundsko	Burgund
burianovka	Burian
buďák	Buda
buřena	buřina
byronia	Byron
bábel	Babel
báchor	bachor
báj	báje
bárd	bard
básnířství	básníř
báza	báze
bílkovitý	Bíl
bílohlavý	bělohlavý
bědák	běda
bělice	Bělov,běl,Bělina,Běla
bělinový	Bělina
běličký	Bělov,běl,Bělík
bělka	běl,Běla
bělo	Běla,běl,Bělov
bělorus	Bělorusko
bělý	Běla,běl,bílý
břevnoví	břevno
březoví	březí
cancák	cancat
cemento	cement
censurový	censurovat
ceremoniel	ceremonie
ceremoniál	ceremonie
chalcedonica	chalcedon
charvátka	Charvát
charvátsko	Charvát
chatt	chata
cherubí	cherub
chetito	Chetita
chladno	chladnice,chlad
chlupáček	Chlupáč
cholerae	cholera
cholerína	cholera
cholový	chochol
chraptit	chraptět
chrastice	Chrasta,chrastit
chrastí	Chrasta
chrnout	ochrnout
chrobákovitý	chrobák
chromatizmus	achromatizmus
chromitý	ochromit
chrtice	chrt
chruščovka	Chruščov
chrásteček	Chrástek
chuliganství	chuligán
chumelice	chumel
chřestýší	chřest
chřestět	chřestit
cibetčí	cibet
cihlovo	cihla
cimbálovka	cimbál
cintal	cintat
cirkulář	cirkulární
citronan	citron
citronek	citron
citronát	citron
cliftonka	Clifton
cmrndal	cmrndat
cracker	crack
cuc	cucek
cukrovarna	cukrovar
cukrovárek	cukrovar
cvičný	cvičit
cyklon	cyklona
cár	car
daimonion	Daimon
dak	Dák
dalajláma	dalajlama
dalmatinec	dalmatin
dama	dáma
dan	Dán,daň
dan	Dán,daň
danien	Daniel
darí	Dárí
davidovec	Davidov
defétizmus	defétismus
dehtárna	dehtář
deko	deka
delfíně	delfín
dementia	dementi
demobrana	demobranec
denaturovna	denaturovat
depozitární	depozitář
desetice	desetina
desetiletka	desetiletý
desetimilion	desetimilión
desetiprstý	desetiprstový
desetnický	desetník
desátka	desátek
desátníček	desátník
desítečka	desítka
detaš	detašovat
detektorářství	detektorář
determinizmus	determinismus
devadesátka	devadesátník
devítečka	devítka
devítice	devítka
devětašedesátka	devětašedesátník
deziluzní	deziluze
diamagnetismus	diamagnetizmus
diblíček	diblík,Diblík
diference	diferencovat,diferenciovat
digitalin	digitál
dik	dík
dimitrovák	Dimitrov
diplomatik	diplomatika
diplomatiční	diplomatika
direktiva	direktovat
direktorář	direktor
disciplin	disciplinovat
disco	disk
disco	disk
diskotékovka	diskotéka
dispense	dispens
dispenze	dispenz
diva	divý
divinace	Divina
dluž	dluh
dohodné	dohodnout
doktrina	doktrína
dokumentní	dokument
dol	důl
dolinatý	Dolina,dolinář
doliňačka	doliňák
domestik	domestikovat
donna	donace
doosídlenec	dosídlenec
dosev	osev
dosud	osud,sud
dovolenkářka	dovolenkář
draha	dráha
dramatično	dramatika
drancovné	drancovat
drba	drbat
dribler	driblér
drnda	drndat
drobek	drobeček
drobíček	drobeček
drozdovitý	Drozdov
drátění	drát,drát
dršťkovka	dršťka
dršťkář	dršťka
ducatý	ducat
dunit	dunět
dvojice	dvojí
dvojkolo	dvojkolí
dvojpremiér	dvojpremiéra
dvoulet	dvouletý
dvouprstový	dvouprstý
dále	dál
démonično	démonie
dírný	Dírná
dít	dítě
dýmák	Dymák
dřevařina	dřevařit
dřevěnička	dřevěnkář
džbánkařství	džbánkař
edikt	edice
ej	oj
ekofarma	ekofarmář
ekofyziologie	fyziologie
ekokonference	konference
ekosféra	sféra
ekostratigrafie	stratigrafie
ekotoxikologie	toxikologie
eleaté	eleata
elektrit	elektrický
električka	elektrický
elektronikář	elektronika
elektroopravna	elektrooprava
eloxovna	eloxovat
empir	empirie
empirový	empirie
encyklopédie	encyklopedie
environmentalizmus	environmentalismus
eremita	Eremit
ergometrin	ergometrie
eskymácko	Eskymák
esoterika	esoterik
eter	éter
eurocentrismus	eurocentrizmus
eurokomunismus	eurokomunizmus
excel	excelovat
exemplifikace	exemplifikovat
exhibice	exhibovat
exhibicionizmus	exhibicionismus
exhibit	exhibovat
exotično	exotika
expatriot	expatriovat
experimentík	experiment
expres	exprese
expres	exprese
extrémizmus	extrémismus
extrémno	extrém
fabrikát	fabrika
fabriční	fabrika
facebookař	Facebook
facebookář	Facebook
facetový	facetovat
faksimile	faksimilovat
falckrabě	falckrabí
falsifikát	falsifikovat
fandítko	fandit
fantaz	fantazie
fantazijní	fantazie
fantomka	fantom
farizeus	farizej
farmaka	farma
fase	fasit
fasetář	faseta
fatalizmus	fatalismus
fauní	fauna,faun
fašank	fašankář
fašančář	fašankář
fašaňk	fašankář
fedosejevec	Fedosejev
fedrovka	fedrovat
fedrovní	fedrovat
fefrmincka	fefrmincový
fejetonní	fejeton
femininní	feminní
feminizmus	feminismus
fenologie	fenomenologie
fenomen	fenomén
fenomen	fenomén
ferie	ferit
feromagnetismus	feromagnetizmus
ferrari	Ferrara
festivalovka	festival
festiválek	festival
figurina	figurína
filantropin	filantropie
filantropní	filantropie
filetka	filet
filiace	filiální
filipi	Filip
filipinský	Filipíny
filosofos	filosofie
filozofično	filozofie
fils	fil
filé	filc
finale	finále
finis	finiš
finka	Fink
finsko	Fin
finta	fintit
finálka	finále
finálovka	finále
fischeri	Fischer
fischerky	Fischer
fiála	Fiala,fiala
flamengo	flamenco
flaše	flaška
flektivní	flektovat
flemingovka	Fleming
flink	flinkat
flitr	flitrovat
flitrovávaně	flitrovat
flitrovávatelně	flitrovat
florencit	Florencie
florentsko	Florentina
florentýnka	Florentina
florenus	Florena
florin	Florena,Florian
floriánský	Florian
folio	folium
fontani	fontána
formalistní	formalismus
formalizmus	formalismus
formař	forma
fotbál	fotbal
fotbálek	fotbal
fotoarchív	fotoarchiv
fotometricky	fotometrie
fousky	fous,Fous
frajír	frajer
francium	Francie
franco	Francie,frank
francovka	Francie
franko	Franky,Franke,frank
frantík	František
freerider	freeride
freerider	freeride
freudovka	Freud
frik	Frič,Fric
frivolitkování	frivolita
frontier	fronta
frézie	fréza
fríska	Frísko
frček	frčka
fundamentalizmus	fundamentalismus
futro	futrovat
fángle	fangle
féra	fér
férie	fér
gabrielovci	Gabriel
gagat	gágat
gagát	gágat
galeje	galejní
galey	Gal
galilei	Galilea
galérie	galerie,galéra
garážník	garáž
generálie	generál
generálka	generál
generálsko	generál
genin	gen
gentile	Gent
geodemografie	demografie
geodézie	geodezie
gerlachy	Gerlach
giboně	gibon
glazovna	glazovat
glazé	glazovat
globalizmus	globalismus
globulín	globulin
gobelin	gobelín
goethit	Goethe
gorgonin	Gorgona
gradovna	gradovat
graffiťačka	graffiťák
granula	granule
granátit	granát
grosso	Gross
grošovatý	groš
guberna	gubernie
guvernérování	guvernér
habří	habr
halný	hala
hamak	Hamák
hambalka	hambalek
hamburgrárna	hamburgr
handle	Handl,handl
handle	Handl,handl
harcový	harcovat
hardcorář	hardcore
harmonit	harmonie
harmoniář	harmonie
havlovec	Havlov
havlovka	Havlov
havlovství	Havlov
havranovitý	havran
hebrejka	Hebrej
hedváb	hedvábí
henleinovec	Henlein
hermafroditický	hermafrodit
hermafrodití	hermafrodit
hezko	hezký
hindustání	Hindustán
hipsteřina	hipster
hispanica	Hispanie
hispanista	Hispanie
hlady	hlad
hlaholný	hlahol
hlavák	hlava,Hlava,Hlaváč
hledítko	hledět
hlezenný	hlezno
hlino	Hlinka,Hlinsko
hláď	hlad
hmoždík	hmoždit
hmyzožravka	hmyzožravý
hnáta	hnát,Hnát,hnát
hodovna	hodovat
hodovní	hodovat
hollywoodsko	Hollywood
homogenát	homogenní
honda	Honza
hore	Hora,hora
hornicko	horna,Hornik
hornina	horna,hornatý
horní	horna,hornatý
hospitální	hospital
hranař	hrana
hranec	hrana
hranolky	hranolkář
hranostajník	hranostaj
hranostají	hranostaj
hraníčko	hraničník
hrd	hrdý
hromaďák	Hromada,hromada
hroudovatý	hrouda
hrubo	hrubý
hrubovat	ohrubovat
hrudovatý	hrudovat
hrudovitost	hrudovat
hrudí	hrudovat,hruď
hruškař	hruška
hruškovka	hruška
hulváctví	hulvát
humanizmus	humanismus
hurtovnice	hurtovat
husto	hustý
hypostáze	hypostaze
háro	hárat
hérós	héros
hřebeník	hřebec
hřebice	hřebit
hřebí	hřebit,hřeb
hřebí	hřebit,hřeb
hřivna	hřivnatý
iOne	iont,ion
identikit	identický
imaginální	imaginace
imobiliář	imobilie
imperium	impérium
indiánsko	Indián
instabilní	stabilní
institut	instituce
intarzit	intarzie
intelektualizmus	intelektualismus
intelový	Intel
intruzní	intruze
inventní	inventář
inzulin	inzulín
ionský	ion
izolacionizmus	neoizolacionizmus
izoprén	izopren
izraelsko	Izrael
jablkovec	jablko
jablkovitý	jablko
jablonecko	Jablonec
jacht	jachta
jachtička	jachta
jaloviční	jalový
jansenista	jansenita
japončičí	japončík
jasnovidný	jasnovidec
jatka	jatky
javajka	Java
jedinký	jediný
jedlovec	Jedlov
jednice	jednička
jednokolejnicový	jednokolejka
jednostranický	zjednostranit
jednotvárný	zjednotvárnit,zjednotvárnět
jehnice	jehně
jehněcí	jehně
jemno	jemný
jesenec	Jesenin
jeseň	jesen,Jesenin
jin	jiný,Jinek,jíní
jirchárna	jircha
jogurtík	jogurt
jorkšírský	jorkšír
jorkšíráček	jorkšír
jugoslávka	Jugoslávie
jukata	jukat
jungmannovec	Jungmann
justy	Just,justice
jár	Jar
jílovatý	jíl
jízlivka	jízlivý
kabaretík	kabaret
kabelička	kabel
kabinovka	kabina
kachlářství	kachlář
kachlíčky	kachlíkář
kacířstvo	kacíř
kafko	Kafka
kalcifikace	kalcifikovat
kalifornium	Kalifornie
kalifornsko	Kalifornie
kaligrafik	kaligrafie
kaligrafista	kaligrafie
kaliko	Kalik
kalič	Kalik
kalo	kalý
kalorimetricky	kalorimetrie
kalíš	Kališ
kamenáč	kameňák
kampán	kampan
kamzíče	kamzík
kana	Kanak
kancléřování	kancléř
kandida	kandidovat
kanon	kánon
kanonový	kánon
kanta	kantýna
kantka	Kant
kapitálovka	kapitál
kapsařina	kapsařit
karcinogenit	karcinogen
kariera	kariéra
karikaturistický	karikatura
karmazin	Karmazín
karpat	Karpaty
kartouzek	kartouza
karát	karate
katarakt	katarakta
katétr	katetr
kava	káva
kazivost	kazit
kačák	káča
kaňón	kanón
kena	Keňa
keramikář	keramika
klarina	klarinet
klasička	klasika
klempírna	klempíř
klempířina	klempíř
klepač	Klepáč
klepec	klepeto
kleštičky	kleště
klihovatý	klih
klingonština	Klingon
klinička	klinika
klinkáček	klinkat
kličička	klika
klokanovitý	klokan
kloset	Klos
klubkovitý	klubko
klubky	klubko
klát	klátit
klátět	klátit,klát
kmenovaný	kmen
kmenovka	kmen
kmetcí	kmet
knedlik	knedlík
knoflíkovitý	knoflík
kněžice	Kněž
kněží	Kněž
koblih	kobliha
kocábka	Kocáb
kognace	kognát
kokoko	koka,kočí
kolejivo	nakolejit
koloběžkař	koloběžka
kolomazní	kolomaz
kolon	kolona,kolonie
kolon	kolona,kolonie
kolumbit	Kolumbie
kombiné	kombinovat
komercializmus	komercialismus
kometka	kometa
komiský	komise
komička	komika
komorář	komora
kompenzovna	kompenzovat
kompetetní	kompetence
komplementární	komplementář
komturie	komtur
komuniké	komunita
komunisticko	komunismus
komunizmus	komunismus,neokomunizmus
komínovitý	komín
komínovka	komín
kona	konat
koncertíček	koncert
konga	Kongo
konga	Kongo
konjunkturalistický	konjunkturalismus
konkretní	konkrétní
konkrétno	konkrétní
konserva	konservovat
konstance	Konstantin,konstanta
konstantan	konstanta,Konstantin
konstruktivizmus	neokonstruktivizmus
kontamin	kontaminovat
kontokont	konto
konvalinka	Konvalina
kopulové	kopulovat
kopák	Kopáč
korektiva	korektní
korintka	Korint
koroze	korozní
korsičtina	Korsika
korunáč	koruna
korál	korálkář
korále	korál,korálkář
korálky	korál,korálkář
korálkářství	korálkář
korálovitý	korál
korály	korál
kosmo	kosmos
kosmopolit	kosmopolita,kosmopolitický
kosmopolitizmus	kosmopolita
kosmopolitnost	kosmopolita,kosmopolitický
kosovo	kos
kostlivka	kostlivý
kota	Kott
kotelní	kotel
kotlař	kotlář
kotlárna	kotlář
koučka	kouč
kozorohý	kozoroh
kozák	koza
kočí	Koč
kočí	Koč
kořenovitý	kořen
kořenovka	kořen
kořenovník	kořen
kořání	Kořán
košťátkovávaně	košťátkovat
košťátkovávatelně	košťátkovat
kožedělnictví	kožedělný
krakatice	krakat
krakatit	krakat
krejčí	Krejčík
krevský	krev
krise	Krist
kristiánka	Kristián
kristuska	Kristus
krizet	krize
krkatý	krkat
krně	Krn
kroječek	Kroječ
krokodýlkovitý	krokodýl
krunýřovka	krunýř
krupárna	krupař
krušec	krušit
kružský	kruh
kryptokomunismus	kryptokomunizmus
krákorec	krákorat
královehradecký	královéhradecký
králíče	Králík
králčin	Král,král
krát	krátký
krátecký	krátký
krátkař	krátký
kuklice	kuklit
kulinární	kulinář
kupé	kupčit
kupónovka	kupón
kurziva	kurzíva
kurát	kurátor
kvalitečka	kvalita
kvart	kvarta,kvartýr
kvartér	kvartýr
kvintance	kvintán
kvádro	kvádr
kvítí	květ
květinovka	květena
květňák	květena
kyblíčkovávaně	kyblíčkovat
kyblíčkovávatelně	kyblíčkovat
kyj	Kyjov
kyjovitý	Kyjov
kypřice	kypřit
kyselo	Kysela,kyselý
kytára	kytara
káčko	káča
křehko	křehký
křemenitý	Křemen,křemen
křemeno	Křemen,křemen
křepel	křepelka
křepký	křepčit
křivský	křivý,Křiva,Křivák
křišťálný	křišťál
křižný	Křiž
křís	křísit
křís	křísit
křížatý	Kříž,kříž
kšírky	kšír
kšíry	kšír
kůča	kočí
labužnicko	labužník
lamento	lamentovat
lanička	Laník
laníčko	Laník
lapis	lápis
larvae	larva
latino	latina
latička	latina
latro	látro
ledek	Ledeč
ledvinitý	Ledvina
ledvinář	Ledvina
legend	legenda
leggero	Leger
leguánovitý	leguán
leguání	leguán
leninsko	Lenin
lennonky	Lennon
leone	Leona
leptač	leptat
leva	levý
levity	Levit
levno	levný
levno	levný
lhostejno	lhostejný
libace	Liba
lichoběžníkovitý	lichoběžný
lidojem	lidojed
likérna	likérník
likérník	likér
likérníček	likérník
lila	lilie
liliputánče	lilipután
liliputí	liliput
lilík	lilek,lilie
limita	limit
limonádička	limonáda
limonádník	limonáda
limonádovka	limonáda
link	linkař
lino	linout,linie
lipanovitý	lipan
lobelin	lobelka
lobkowiczký	Lobkowicz
loděný	loděnka
logista	logistika
lomoz	lomozit
loutkování	loutka
louč	Loučka,loučit
louž	louh
love	lov
luciferský	Lucifer
ludmilka	Ludmila
lumík	lumek
luninec	Lunin
luník	Lunin
lužský	luh
lysáček	Lysák
lák	lak,láčka
lázeňsko	lázeň
lázeňský	lázeň
lázeňský	lázeň
líha	líh
líhnař	líhňař
líhně	líhnout,líh
lůs	los
machiaveliamus	machiavelizmus
machiavelismus	machiavelizmus
madonna	Madona
magazin	magazín
magazínek	magazín
magdalenka	Magdalena
magdalénien	Magdaléna
magna	magnát
magneto	magnet
maklér	makléř
makovina	Makov
makrobiotička	makrobiotika
malorážný	malorážní
malorážový	malorážní
malárie	malarie
maléř	malér
mama	máma
mamá	máma
manas	Maňas,maňas
manažér	manažer
manažér	manažer
manda	mandant,mandát
mandarin	mandarín
mandátář	mandatář
manganan	mangan
mangrove	mangrový
mann	man
manýrizmus	manýrismus
maně	Mání
marathonec	Marathon
marina	Maria,Marie
markrabě	markrabí
marmeládovna	marmeláda
marnotratnictví	marnotratný
martini	Martin
martinka	Martin
marína	Marie
masaryčka	Masaryk
masochizmus	masochismus
mater	mateř
materie	Mater,mateř
materiálno	materiál
matrice	matrika,matricovat
maxima	maximum
maximalistický	maximalismus
maximalizmus	maximalismus
mazník	maznice
mačka	mačkář
mařice	mařit
mechano	mechanika
mechovitý	mechovatý
medica	Medina,medit
megalománie	megalomanie
melodram	melodrama
mera	Meroe
meruňkovník	meruňka
meruňkovo	meruňka
mestička	mestic
metastáze	metastáza
meziskládka	mezisklad
mihule	Mihula
mikrofišový	mikrofišovat
mile	milý
milička	milice
milánek	Milán
min	mina
mincař	mince
mindráček	mindrák
mini	Minos,mina
minimainframe	mainframe
minimalizmus	minimalismus
minimonografie	monografie
minižákyně	minižák
minižáček	minižák
minus	Minos
mira	Mirek
mixtecký	Mixték
mičurinec	Mičurin
miškař	miškář
miškářství	miškář
mláto	mlátit
mlékovitý	mléko
mléč	mléčit
mobilka	mobil
moce	moci
modráky	Modrák
molybdenan	molybden
molybdén	molybden
monofyzitismus	monofyzita
monofyzitizmus	monofyzita
monoteizmus	monoteismus
montanní	Montana
montánní	Montana
motylek	Motýlek
motýlovitý	motýl
mozet	mozek
mořena	Mořina
mramorovo	mramor
mufloně	muflon
multimiliardový	multimiliardář
multimilionový	multimilionář
multiscannovávat	multiscanovat
multivitamin	multivitamín
mumio	mumie
mundánní	mundant
museum	muset
mydlárna	mydlář,Mydlář
máje	máj
mán	man
máčka	mák
místy	místo
míšenina	míšeň
mědikovna	mědikovec
mělnicko	Mělník
měřík	měřit
nabalíčkovávaně	nabalíčkovat
nabalíčkovávatelně	nabalíčkovat
nacionál	nacionální
nacionále	nacionální
nacionálie	nacionální
nagana	Nagano
nanotechnologie	technologie
nao	Nat
naos	Nos,nos
narativ	narativní
narkotin	narkotický
nasion	Sion
nasladko	sladký
nasyrovo	syrový
nato	Nat
natuchnout	tuchnout
natěsno	natěsňovat
načerveno	červený
neandertalec	neandertálec
neekvivalence	ekvivalence
nekompetence	kompetence
neokomunismus	neokomunizmus,komunismus
neokonfuciánský	konfucián
neokonstruktivismus	konstruktivismus
neosocialismus	socialismus
neosurrealismus	surrealismus
neosymbolismus	neosymbolizmus
neplodnost	zneplodnit
nepořádnost	nepořádník
nepravidelnost	znepravidelnit,znepravidelnět
neprůchodnost	zneprůchodnit
neprůhlednost	zneprůhlednit
neprůjezdnost	zneprůjezdnit
nepálsko	Nepál
nepřehledno	znepřehlednit
nepřehlednost	znepřehlednit
nepříjemnost	znepříjemnit,znepříjemnět
nerovnoprávnost	znerovnoprávnit
nesolidárnost	solidární
nespravedlivost	spravedlivý
nesvobodomyslnost	svobodomyslný
nevděčnost	nevděčník
nevýraznost	znevýraznit
nevěrnost	nevěrník
nezaměstanost	nezaměstnaný
nezaměstnanost	nezaměstnaný
nezaměstnatelnost	nezaměstnaný
nezaměstnavatel	nezaměstnaný
nezaměstnavatelnost	nezaměstnaný
nezdárnost	nezdárník
neznabůh	neznaboh
nešťastnost	nešťastník
nicka	Nick
nigero	Niger
nirvana	nirvána
nocležné	nocležna
nomina	nominovat
nosálí	Nosál
notař	notář
notifikát	notifikovat
nova	nový,Novák
novoromantizmus	novoromantismus
novosymbolizmus	neosymbolizmus
nude	nuda
nunvářství	nunvář
náplet	záplet
nápojářství	nápojář
nápravnice	Nápravník
nící	Nick,nit
níž	nížit
několikanásobek	zněkolikanásobit,zněkolikanásobnit
obousměrný	zobousměrnit
obroční	obročí
obíhač	obíhat
odhadné	odhadnout
odmalovávaně	odmalovat
odmalovávatelně	odmalovat
odnít	dnít
odorologie	urologie
odsouhlas	souhlas
odtučnět	odtučnit
odvětví	odvětit
odřez	dřez
oflitrovávaně	oflitrovat
oflitrovávatelně	oflitrovat
ofěra	ofěrovat
ohlas	hlas
ohněstrojný	ohněstrůjný
oklika	klika
okolky	okolkovat
okrouhlice	zokrouhlit
oktáv	oktáva
okurkovka	okurka
oligarch	oligarchie
oliví	oliva,Oliva
oman	Omán
oocysta	cysta
ooplazma	plazma
oosféra	sféra
oospora	spora
opovědek	opovědný
orchestre	orchestr
orchestrovávaně	orchestrovat
orchestrovávatelně	orchestrovat
ordinární	ordinář
ordner	ordnér
orebice	orebita
organový	orgán
ortodoncie	ortodontie
osmaosmdesátník	osmdesátník
osmačtyřicátiny	osmačtyřicátník
osmašedesátka	osmašedesátník
osmdesátka	osmdesátník
osmitisícina	osmitisícovka
osmitisícový	osmitisícovka
ostatní	ostat
ostříží	stříž,Stříž
otecko	otec
otlak	tlak
otoman	Toman
ouřední	Ouředník
ouředníček	Ouředník
ovzdušní	vzdušnice
oxyd	oxydovat
oxygene	oxygen
ozub	zub
paběrky	paběrkář
pacifikál	pacifikovat
padesátka	padesátník
pagina	paginovat
palatinát	palatin
palačinkovač	palačinka
paleogeografie	paleografie
pancířnatý	pancíř
panteří	panter
pantomimus	pantomima
papaja	papája
papu	papá,papuč
papírní	papír
par	pár
para	pára
para	pára
parte	part,parta
particie	partie
partiční	part
pas	pás
pastvice	pastvit,pastvinář
patentka	patent
pater	páter
patriotství	patriot
pauzák	pauza
pavláč	pavlač
pařížsko	Paříž
pecnářství	pecnář
pelerina	pelerína
pence	pentle
penicilin	penicilín
pension	pensionovat
pensionát	pensionovat
pentanon	pentan
penten	pentle
pentit	pentle
pentlice	pentlit
penál	penále
penální	penále
perfekcionizmus	perfekcionismus
pergamenování	pergamen
perk	pero
perka	pero
permanece	permanence
pernice	perník
perný	pero
persiko	Persie
pesimizmus	pesimismus
piko	Pikt
piko	Pikt
piko	Pikt
pikolo	pikola
pikovník	pikovat
piky	Pikt
piké	Pikt
pilnice	pila,Pila
pinas	Pinkas
pini	pinie
pinka	pinie
pionýrka	pionýr
pirátsko	pirát
pistol	pistole
pit	pít
piáno	piano
pižmoní	pižmo
plachtička	Placht
plantace	plantat
plastinát	plastinovat
platformář	platforma
platinovo	platina
platnéřství	platnéř
platonsko	Platon
plavka	Plávka
plavý	plavat
plejtvák	plejtvat
plemeniště	plemenit
plentička	plenta
plocký	Ploc
ploštice	Ploština
plást	plast
pobočný	poboční
podhorní	Podhora
podhájí	Podháj
podpůrce	odpůrce
podsední	Podsedník
podseznam	seznam
poflitrovávaně	poflitrovat
poflitrovávatelně	poflitrovat
pohodnice	pohodnout
pohodný	pohodnout
poháňka	Pohan,pohan
pointe	pointa
polar	polára
polednový	poledne
poloautomatický	poloautomatizovat
polosedě	polosedět
polostín	polostínovat
polypropylén	polypropylen
polypropylénový	polypropylen
polštářkovitý	polštář
polštářovitý	polštář
pomalo	pomalý
pomatovák	pomatovat
pomnožný	množný
pomníčkář	pomníkář
ponička	poník
popelna	popelka
popelnatý	popelka
popelčí	popelka
popletka	popleta
populár	populární
posilvestrovský	Silvestrov
post	půst
post	půst
postkomunismus	postkomunizmus
poto	pot
poustka	Pousta
pozdní	Pozdník,pozdě
pozitívní	pozitivní
pořečtělý	pořečtit
pořád	pořad
pragmatička	pragmatika
prasecký	prase
prelude	preludovat
premiera	premiéra
presentant	presentovat
pribináček	Pribina
procesí	proces
prohibicionismus	prohibicionista
prohibicionistický	prohibicionista
prohibitní	prohibice
proinzulín	inzulín
projezd	průjezd
prokorupční	korupčník
prolet	prolét
proprétor	prétor
prostný	prostý
prostátní	prostata
prostřed	prostřední
protiblok	protiblokovat
protěžovitý	protěžovat
provazolezení	provazolezec
provozce	provoz
provozní	provoz
provozní	provoz
provázeček	Provázek
prsť	prst
prve	prvý,první
prápor	prapor
právě	pravý
prťáctví	prťák
průkop	Prokop
průseč	průsek
průvoz	provoz
psychično	psychika
psychotronička	psychotronika
ptáček	pták,Pták
puchýřka	puchýř
puchýřnatý	puchýř
pudlárna	pudlař
punc	punk,punč,puncovat
puncovna	puncovat
puncovní	puncovat
punkce	punk
punt	punk
punčocháčky	punčocha
punčák	punk
purkrabě	purkrabí
purpurový	purpur
pusta	pustý
pyrománie	pyromanie
pác	pac
pákistánsko	Pákistán
párky	párkář
pásek	pás
pávě	páv
páček	páčit
páže	paže
písák	písek
píárko	píár
píďo	píď
póvlizace	póvlizovat
póvlizovávaně	póvlizovat
póvlizovávatelně	póvlizovat
pěkno	pěkný
pětadevadesátka	pětadevadesátník
pětaosmdesátiny	pětaosmdesátník
pětaosmdesátka	pětaosmdesátník
pětapadesátka	pětapadesátník
pětapadesátkař	pětapadesátník
pětasedmdesátiny	pětasedmdesátník
pětasedmdesátka	pětasedmdesátník
pětatřicátiny	pětatřicátník
pětačtyřicátiny	pětačtyřicátník
pětašedesátiny	pětašedesátník
pětašedesátka	pětašedesátník
pětinásobek	pětinásobit
pětinásobný	pětinásobit
pětička	pětník
pětset	pět
předindoevropský	indoevropský
předletní	předlétnout
předčítač	předčítat
předžákyně	předžák
překup	překupník
přenýtovávaně	přenýtovat
přenýtovávatelně	přenýtovat
přes	přesný
přesilný	přesila
přesvatý	svatý,Svatý
přešraňkovávaně	přešraňkovat
přešraňkovávatelně	přešraňkovat
přeštíhlý	štíhlý
přeštědrý	štědrý
přiblblo	přiblblý
přizdisráčství	přizdisráč
přástevna	přástevník
přírodno	příroda
příroďák	příroda
příční	příčit
pšenický	pšenice
pšeníčko	pšenice
půlhodinovka	půlhodina
rabí	rabi
rachotina	rachotit
radio	rádio
radiolarit	radiolárie
radlo	rádlo
radno	rada
radní	rada
rajcovní	rajcovat
raketnice	raketa
rank	ranč
raroh	roh
raubířina	raubíř
raubířství	raubíř
reaganovec	Reagan
realný	reálný,reální
reces	recese
reflektivní	reflektovat
regália	regál
regálie	regál
rehabilitát	rehabilitovat
rektifikát	rektifikovat
rekvizice	rekvizita
religionostika	religionistika
remonstrace	remonstrant
rentgenka	rentgen
rentgenář	rentgen
repetice	repetit
repetitivní	repetit
report	reportovat
representační	representace
restitut	restituce
resynchronisace	resynchronisovat
revaskularizační	revaskularizovat
reverz	reverzovat
reverze	reverzovat
rezervo	rezerva
reál	reální
robertek	Robert
robě	robit
rodice	rodit
roentgenka	Roentgen
roentgenův	Roentgen
rohlíčkář	rohlíkář
rohovnictví	rohovník
ron	Ronov
rosenkruciánství	rosenkrucián
rostlinolékářský	rostlinolékař
rotundata	rotunda
rozbroj	zbroj,výzbroj
rozezlit	zezlit
rozkolí	rozkol
rozpínák	rozpínat
roztesknět	ztesknět
rozvozce	rozvoz
roští	rošt
rubato	rubat
rubikovka	Rubikov
rudnina	Ruda
rukodílný	rukodělný
rulík	rulička
rumplovna	rumplovat
rusocentrismus	rusocentrizmus
rutin	rutina
rutinář	rutina
rychlomluvka	rychlomluva
rytírna	rytíř
ryšavo	ryšavý
ráno	rána,raný
rét	ret
rýna	Rýn
sacharina	sacharin
sado	Sadov
sajdkár	sajdkára
sakramenta	sakrament
salajka	Salaj
saldo	saldovat
samaritan	Samaritán
samolepicí	samolepící
samomluvka	samomluva
samovyměření	samovyměřovat
sanitník	sanita
sanktusní	sanktusák
sanktusník	sanktusák
sanktusový	sanktusák
satí	sát
savojsko	Savoj
schema	schéma
sebekriticismus	sebekritika
sebelítost	sebelítostivý
sebelítostný	sebelítostivý
sebemodifikace	sebemodifikovat
sebenaplnění	sebenaplňovat
sebeobhajný	sebeobhajovat
sebeobnova	sebeobnovovat
sebeobnovení	sebeobnovovat
sebeobvinění	sebeobviňovat
sebeobětovný	sebeobětovat
sebeobětující	sebeobětovat
sebeobžaloba	sebeobžalovat
sebeodcizení	sebeodcizovat
sebeodcizený	sebeodcizovat
sebeohrožení	sebeohrožovat
sebeorganizace	sebeorganizovat
sebeoslovení	sebeoslovovat
sebeospravedlnění	sebeospravedlňovat
sebeosvobození	sebeosvobozovat
sebeovlivnění	sebeovlivňovat
sebeozbrojování	sebeozbrojit
sebepochybnost	sebepochybovat
sebepodcenění	sebepodceňovat
sebepotvrzení	sebepotvrzovat
sebepozorovatelský	sebepozorovat
sebeprosazení	sebeprosazovat
sebepřecenění	sebepřeceňovat
seberealizace	seberealizovat
sebereflektivní	sebereflektovat
sebeshazovačný	sebeshazovat
sebestylizace	sebestylizovat
sebetrýznivý	sebetrýznitel
sebetrýznění	sebetrýznitel
sebeusvědčení	sebeusvědčovat
sebeutvrzení	sebeutvrzovat
sebeuzdravení	sebeuzdravovat
sebevymezení	sebevymezovat
sebevyplnění	sebevyplňovat
sebevysvětlení	sebevysvětlovat
sebezaměstnavatel	sebezaměstnat
sebezapírač	sebezapírat
sebezesměšnění	sebezesměšňovat
sebezlepšení	sebezlepšovat
sebezničování	sebezničit
sebezničující	sebezničit
sebeztrapnění	sebeztrapňovat
sebezviditelnění	sebezviditelňovat
sebezáchova	sebezachovat
sedmapadesátka	sedmapadesátník
sedmdesátka	sedmdesátník
sedmikrásný	sedmikrása
sedmák	sedma
sekreta	sekretář
sekunďák	sekunda
sekvencovitý	sekvencovat
sekvoje	sekvoj
sekvojec	sekvoj
selektin	selektiva
semišky	semiš
senegala	Senegal
senoseč	seno
sentimentalistický	sentimentalismus
serologie	sérologie
serpentin	serpent
sexovávaně	sexovat
sexovávatelně	sexovat
sešeřet	zešeřet
sférik	sféra
sgrafitář	sgrafitovat
sice	síci
siciliána	Sicilián
silický	silice
siliko	silika,silice
siličný	silika
silnoproudý	silnoproud
simplifikace	simplifikovat
simultálnní	simultánní
singulare	singulár
sisál	sisal
siře	sirý
ska	skica
skalkař	Skalka
skart	skartovat
skejťačka	skejťák
sklerotik	sklerotický
skulinatý	skulina
skupinovka	skupina
skvít	skvět
skřetí	skřet
skřivanovitý	skřivan
skřivaní	skřivan
slepicovost	Slepička
slepičárna	slepičář
sleď	sled
slinutí	slina
slinutý	slina
sloganovitý	slogan
sloupkaření	sloupkař
slovosled	sled
sloň	slon
sluj	sloj
sléz	slez
slínek	slín
slínitý	slín
smilka	smilný
smrčí	Smrk,smrk
smutnice	smutný,Smutný
smíchy	smích
snadnince	snadný
sociál	sociální
sociálimperializmus	sociálimperialismus
sociálno	sociální
sofista	sofistika
sol	sůl
sol	sůl
solani	Solana
solník	solnice
solárko	solar
sommeliérský	sommeliér
sorbový	sorbovat
sosnoví	Sosna
souběžec	souběžný
souběžka	souběžný
soukromnictví	soukromničit
souček	součin
special	speciál
specialisace	specialisovat
spin	Spina
spinus	Spina
spola	spolu
spolucestující	spolucestovat
spolucestující	spolucestovat
spoluinvestice	spoluinvestovat
spolupůsobnost	spolupůsobit
spolutrpící	spolutrpitel
spolutrpící	spolutrpitel
spoluzavazadlo	spoluzavázat
spár	spára
spížička	spíž
srbochorvatsko	Srbochorvat
srbochorvátský	Srbochorvat
stadiónovka	stadión
stalinec	Stalin
staničník	Staník
statista	statistika
stehlíček	Stehlík
sterilis	sterilisovat
stinka	Stin
stoa	Stoy
stodvacetiminutový	dvacetiminutový
stolický	stolice
stomilionový	stomilionář
ston	Stone
stooký	Stoy
stotisíc	stotisící
strachy	strach
strečový	strečovat
strnadí	strnad
strojivo	strojit
strůj	stroj
studenka	Studénka
studio	studit,stud
studně	stud,studený,Studený
stánka	stánkař
státo	stát,stát,stát
státík	stát,stát,stát
stélé	stéla
stínka	stín
stěží	stěžovat
střízličí	střízlík
substitut	substituce
suchozemě	suchozemský
suicida	suicidovat
sumatrae	Sumatra
summmit	summit
superkonstruktivizmus	neokonstruktivizmus
supozice	pozice
suprasexdadaizmus	suprasexdadaismus
surovo	surový
surrealizmus	neosurrealizmus
surrrealismus	surrealismus
svatý	svat
svinný	svině,Sviny
sviň	svině
sviňa	Sviny
sviště	svišť
svoboďák	svoboda
svrchnice	svrchní
svrškař	svrškář
svářka	svářit
svítítko	svítit
svědečný	svědek
světínský	světnice
symbolizmus	neosymbolizmus
synchronisace	synchron
synod	synoda
systemisace	systemisovat
sádeček	Sádek
sálovka	sálovkář
sámek	samec
sáo	sát
sítí	sít,sítina
sítění	sítina
sůva	sova,Sova
tablet	tableta
tabula	tabule
tabákovka	tabák
tajemnůstka	tajemnůstkář
tajtrlíček	tajtrlík
takto	taktika
také	takt
talentík	talent
talk	Tala
tanka	tank
tapecír	tapecírovat
tata	táta,Tate,tát
tatina	táta,Tate
tatranka	Tatran
tatí	Tate,tát,táta
techničák	technika
techné	techno
teigovec	Teigov
temovák	temovat
temperovka	temperovat
temporálie	temporální
tennis	tenis
tenísek	tenis
teplo	Teplý,teplý
teriéří	teriér
termití	termit
termínovka	termín
teslo	Tesla
tetřeví	tetřev
thonetka	Thonet
tibeto	Tibet
tibetsko	Tibet
tis	tisíc,Tisov
tisovitý	Tisov
tisíceronásobný	ztisíceronásobit
titulka	titul
tkaloun	tkalounkář
tkvít	tkvět
tokáta	tokat
toxikománie	toxikoman
trabantík	trabant
tradicionalisty	tradicionalistický
tragik	tragika
tragikomično	tragikomika
tral	trať
tranda	trandat
transvestitismus	transvestit
traverz	traverzovat
travesti	travestovat
travestie	travestovat
tresť	trest
trhovní	Trhovky
tribunát	tribun
trinitární	trinitář
triál	trial
tričo	triko
trofie	atrofie
troglodytsví	troglodyt
trojitý	trojice
trojička	trojice
trojlistý	trojlist
trojný	trojka
trojí	trojice,trojka
trojče	trojka,trojčit
truchlič	truchlit
truck	truc
trávař	tráva,travař
trávníkářství	trávníkář
trén	trénovat
tulipánovitý	tulipán
tunningový	tunningář
tupo	tupý
turbina	turbína
turbinář	turbína
turtur	tur
tuto	tutový,Tutu
tutti	tutový
tutti	tutový
tyl	týl
typografička	typografie
tátština	táta
téka	Teka
tělka	tělo
těšínka	Těšín
těšítko	těšit
těžko	těžký
třasořitný	třasořitka
třebícký	Třebíč
třiatřicátník	třicátník
třináct	Třinec
třičtvrtinka	tříčtvrtina
třmení	třmen
tříslovný	tříslo
tůně	tonout
uherskohradištský	uherskohradišťský
ukládač	ukládat
ukrajinist	Ukrajina
ulický	ulice
ultraformalizmus	ultraformalismus
ultraimperializmus	ultraimperialismus
ultrapokrokový	ultrapokrokář
ultrapravý	ultrapravice
unikát	unikat
unit	unita,unie
univerzál	univerzální
univerzál	univerzální
univerzália	univerzální
upomínavý	napomínat
upíří	upír
uranan	Uran
uranin	Uran
urbur	urbura
určito	určit
uzlovač	uzlovatý
vagina	vagína
vagonka	vagonkář
vagonový	vagonovat
vale	Val
valencienka	Valencien
valenciánka	Valencián
valentýnování	Valentýn
valeriána	Valerián
valin	Valina
valnice	valník
vandrovné	vandrovat
vandrovák	vandrovat
vaselin	vaselinovat
vaselina	vaselinovat
vat	vát
vazodilatace	vázodilatace
vazokonstrikce	vázokonstrikce
vašnost	vašnosta
vdovní	vdova
vedro	Vedra
vegeta	vegetovat
vegetárka	vegetář
vegetárna	vegetář,vegetovat
vejměnek	vejměník,vejměnkář
vekovka	veka
velbloudovitý	velbloud
veleduchý	veleduch
velehory	velehora
velkoagrární	velkoagrárník
velkochov	velkochovatel
velkoprodejce	velkoprodej
velkošmelina	velkošmelinář
velociped	velocipéd
venský	ven
vepřo	vepř
vepřovka	vepřovina
verbovné	verbovat
verbovní	verbovat
verbovní	verbovat
verbovní	verbovat
verbovník	verbovat
vertikál	vertikála
veršotepný	veršotep
veršovní	verš
vesmíreček	vesmír
vetše	veta
veverče	veverka
vhrdlolhář	vhrdlolhát
vicekancléř	vícekancléř
videat	video
videc	video
vidio	video
vinařina	vinařit
vincentinka	Vincent
vincentka	Vincent
vino	vina
virginiana	Virginie
virginál	virginal
virtuálno	virtuál
virtuálno	virtuál
vitamin	vitamín
vitrina	vitrína
vitrit	vitrína
vitálný	vitální
viz	vize
vlasovitý	Vlasov
vlastel	vlastelin
vlastimilovný	Vlastimil,vlastimil
vlastimilý	Vlastimil,vlastimil
vlastizrada	vlastizrádce
vlaštovice	vlaštovka
vlaštovník	vlaštovka
vlaštovče	vlaštovka
vlaštůvka	vlaštovka
vláknění	vláknit
vlásnice	vlásnička
vlídno	vlídný
vobluda	obluda
vochlovna	vochlovat
vodnička	vodničit
vodoměrka	vodoměr
vodovatý	vodovod
vojevod	vojevodit
vojka	vojna
vojník	vojna
vokres	okres
volač	volačit
volky	vole
volnomyšlenářský	volnomyšlenkář
vopravit	dovopravit
vorák	Voráč
vosel	osel
vosoba	osoba
vostat	ostat,dostat
vostražitost	stražit
vostrov	ostrov
vostrý	ostrý
votrok	otrok
vousky	vous
vovce	ovce
vraskatý	vraskat
vroucno	vroucný
vráně	vrána,Vraný
vršatka	Vršata
vršatý	Vršata
vteřinečka	vteřina
vteřinovka	vteřina
vychladatelný	vychládat
vyflekace	vyflekat
vyhnalost	Vyhnal
vyhnalov	Vyhnal
vysmívač	vysměvač
vysádrovávaně	vysádrovat
vysádrovávatelně	vysádrovat
vysáňkovávaně	vysáňkovat
vysáňkovávatelně	vysáňkovat
vyvadnout	vadnout
vyvojář	vývojář
vyšklíbačný	vyšklíbat
vyšťuchatelný	šťuchat
vzdušní	vzdušnice,vzdušnit
vzorkovna	vzorkovat
vzpomínáček	vzpomínat
vzteky	vztek
vápenička	Vápeník,vápeník,vápeničit
váreční	várečný
vé	ovce,vně
véča	véčko
vídeňsko	Vídeň
výjezdný	výjezda
výložní	výložný
výminek	výminka
výměnička	výměničit
výmětný	výmět
výplavky	výplav
výsevek	výsev
výstředník	výstřední
výstředný	výstřední
výtopný	výtopna
výzvuk	zvuk
výčepný	výčep
věrověst	věrozvěst
větevnice	větev
větevní	větev,věta
věštice	věštit
věžovatý	věž
vřesovitý	vřesovina
vřeten	vřeteno
vřetení	vřeteno
vřeteň	vřeteno
vřeštit	vřeštět
všeobjímající	všeobjímajímat
vševěda	vševěd
všudybylý	všudybyl
wait	Waits
workholička	workholik
yobjekt	objekt
ypsilonovský	ypsilon
zakabonět	kabonět
zaktuálnět	zaktuálnit
zamčitý	zamčít
zatravnatit	zatravnatět
zatímný	zatím
zazpátek	zpátek
zbankrotit	zbankrotět
zbojný	zbojník
zbor	bor
zbujnictví	zbujnit
zdrava	zdravý
zdrsnatit	zdrsnatět
zdymat	zdýmat
zelenec	zelený
zelenkův	Zelenkov
zelenče	Zelenkov
zemanín	zeman
zenice	zenit
zextensivnět	zextensivnit
zeťství	zeť
zfilmovatět	zfilmovatit
zhavranit	zhavranět
zhost	host
zhudebnět	zhudebnit
zima	Zimák
zinko	zinek
zjednoslovnění	zjednoslovňovat
zkrkavčit	zkrkavčet
zkrutný	zkrutnout
zlatný	zlatý,zlatý
zlatohřivý	zlatohřivák
zlatotepecky	zlatotepec
zlostnictví	zlostnit
zludařelý	zludařit
zludrařelý	zludrařit
zmaloměšťáčtělý	zmaloměšťáčtět
zmatkaření	zmatkař
zmetkař	zmetkařit
zmlada	zmladnout
znamenavost	znamenat,znamení
znamenitý	znamení
znamenák	znamenat
znatelkyně	znatel
znojný	znoj
znovuprojednání	znovuprojednat
znovuzalesňování	znovuzalesnit
znáčka	znát
zobatý	zobat
zobkatý	zobkat
zoogeografie	geografie
zooplankton	plankton
zoospora	spora
zooterapie	terapie
zopravdy	doopravdy
zoun	pozoun
zplnomocník	zplnomocnit
zpráchnilý	zpráchnět
zprázdna	prázdný
zrnič	zrnit
zrost	Zrůst
zrzatý	zrzavý
zrůžovatit	zrůžovatět
ztenka	ztenknout
ztrpka	ztrpčit
zuávka	Zuáv
zvodnět	zvodnit
zvor	zázvor
zvostatní	zvostat
zvěřena	zvěř
zvěřní	zvěř
zábojce	záboj
záhora	Záhor
záhumenec	záhumenka,záhumení
záhumenice	záhumení,záhumenka
záhumenní	záhumenka,záhumení
záhumeň	záhumení,záhumenka
záhumní	záhumení
záhvozdí	záhvozd
zákeří	zákeřný
zákeřňák	zákeřný
základnice	základna
zálud	záludný
zápecní	zápecník
zápřezka	přezka
zápůjčna	zápůjční
zástěnek	zástěna
zástění	zástěna
zátinka	zátinek
závitina	závitka
závojovitý	závoj
zázvuk	zvuk
zářek	záře
záškodné	záškodný
záškodí	záškodný
zřit	zřít
Áron	aron
Ávila	Avila
Úhlavanka	Úhlava
ágama	agama
ájatolláh	ajatolláh
áron	aron
ázerbájdžánsko	Ázerbájdžán
ážio	ažio
éther	ether
údol	údolí
úhlopříčna	úhlopříčka
úhořina	úhořit
ústrojitý	ústroj
ústrojní	ústroj
ústrojný	ústroj
ústrojí	ústroj
útulna	útulný
úvozní	úvoz
účetní	účet
úštěpný	úštěp
úžlab	úžlabí
Čaja	čaj
Čajka	čaj
Čajka	čaj
Časta	častý
Častovec	častovat
Čechmánek	čechman
Čecho	Čech
Čecho	Čech
Čechovka	Čechov
Čecháčková	čecháček,Čechák
Čekanka	Čekan
Čekanov	Čekan
Čelada	Čeladná
Čelákovicko	Čelákovice
Čenková	Čenkov
Čepek	čepec
Čepelík	čepel
Čepice	čepit
Čepička	čepit
Černek	Černík
Černice	Černík
Černický	Černík
Černigová	Černigov
Černička	Černík
Černičí	Černík
Černobýl	Černobyl
Černohlávek	černohlavý
Černovcy	Černov
Černovičky	Černov
Černovka	Černov
Černová	Černov
Černá	černý
Černíkov	Černík
Černíkovsko	Černík
Černíky	Černík,černý
Černínsko	Černín
Černínský	Černín
Černíny	Černín
Černíč	Černík
Červenkov	Červenka
Červenkov	Červenka
Čerňanský	Čerňan
Česník	česnek
Čeček	čeka
Češtice	češtit
Činov	čina
Čipera	čiperný
Čistá	čistý
Čižmář	čižma
Člunek	člun
Čočková	čočka
Čtyřkoly	čtyřkolý
Čudek	Čud
Čája	čaj
Čáslavka	Čáslav
Čáslavky	Čáslav
Čáslavský	Čáslav
Částka	část
čajka	čaj
čap	čáp
čapatý	čapat
časoměřický	časoměřič,časoměr
černobýl	Černobyl
černobýlí	Černobyl
černooce	Černo
černooký	Černo
černoočko	Černo
černočerno	Černo
černočerný	černý,Černo
červotočí	červotoč
čibča	Čibč
čiperno	čiperný
čičina	čina
čočkovka	čočka
čtvrtek	čtvrt
čtvrthodinovka	čtvrthodina
čtyrkrejcar	čtyřkrejcar
čtyřiačtyřicátník	čtyřicátník
čtyřicátiny	čtyřicátník
čtyřkolkář	čtyřkolkař
čtyřkolo	čtyřkolý
čtyřproud	čtyřproudý
čtyřče	čtyřka
čtyřčárkový	čtyřka
čuně	Čunek
čáslavka	Čáslav
Ďuran	Duran
Ďurik	Ďurič
Ďuričko	Ďurič
ďouba	Douba
ňádro	ňadro
Ředice	ředina
Řehnice	řehnit
Řemenov	řemen
Řenče	Řenč
Řevnice	řevnit
Řečický	Řečice
Řimsa	římsa
Řáda	řada
Římek	Řím
Římský	Řím
Římsy	římsa
ředinký	ředina
řeháček	Řehák
řevnice	řevnit
řevný	řevnit
řezbařina	řezbařit
řezníček	Řezník
Šacha	šach
Šafránka	šafrán
Šafár	šafář
Šah	šáh
Šalinová	šalina
Šalit	šálit
Šaman	Šamánek
Šan	Šanov,šanovat
Šanc	šance
Šanca	šance
Šanovice	Šan,Šanov
Šarovec	šarovat
Šarovy	šarovat
Šata	šaty
Šašecí	šašek
Šebele	Šebela
Šec	šek
Šedo	šedý
Šeredová	šereda
Šerkov	šerka
Šibeník	šibenice
Šid	šidit
Šidík	šidit
Šiko	Šik
Šilhan	Šilhán
Šilhánková	Šilhán
Šimlová	šiml
Šimo	Šima,Šimák
Šimoni	Šimon,Šimoník
Šimonič	Šimoník
Šimonko	Šimon
Šimra	šimrat
Šimáně	Šima
Šimášek	Šimák
Šira	širý,široký
Šiškin	šiška
Šiškov	šiška
Škatula	škatule
Školař	školařit
Škopec	škopek
Šlik	Šlikov
Šlosár	Šlosar
Šmelko	šmelc
Šmodrcha	šmodrchat
Šmolc	šmolka
Šohaj	šohajík
Šohájek	šohaj,šohajík
Šošok	šok
Špagetka	špageta
Špale	špalek
Španěly	Španěl
Špatka	špatný
Špendlíček	špendlík,špendlíkář
Špeník	špenát
Šperer	šperk
Špet	špetka
Špeta	Špetík,špetka
Špetková	špetka
Špic	špice
Špicar	špice
Špicl	špice
Špika	špice
Špiner	Špinar
Špinov	Špina
Špit	špice,špicl,špic
Špita	špice
Špitová	špitat
Špitt	špice
Špitálka	špitál
Špitálsko	špitál
Špitálský	špitál
Špička	špice
Špičky	špice
Šplechtová	šplechtat
Špálek	špalek
Špánik	špánek
Špát	špatný
Špáňa	špánek
Šram	šrám,Šrám
Šraňka	šraňkovat
Šraňko	šraňkovat
Šruc	Šrut
Štafetka	štafeta
Štefanič	Štefánik
Štencl	Štenc
Štolc	Štoll,štola
Štírek	štír
Štírský	štír
Štítina	štítit,štít,štětina
Štítné	štítit,štít
Štítný	štít,štítit
Štítov	štítit
Štíty	štít,štítit
Štýrský	Štýr
Štěnec	štěnice
Štěno	štěně
Štěpař	štěpařit
Štěpánov	Štěpán
Štětař	štětkář,Štětkař,štětina
Štětice	štětina
Štětina	štětkář
Štětinský	štětina
Štětka	štětina,štětkář,Štětkař
Štětkářová	štětkář,Štětkař
Štětovice	štětina
Štětsko	štět
Štětí	štět,štětina
Štětín	štětina
Štůla	štola
Šuranský	Šuran
Šuránek	Šuran
Šuráň	Šuran
Šusta	Šust
Šustera	Šuster
Šušák	Šuša
Švadlenka	švadlenčit
Švejkovský	Švejk
Švenka	švenknout
Švestková	švestka
Švihla	švihlý
Švihovsko	Švihov
Švábky	šváb,Šváb
Švábov	šváb,Šváb
Švéda	Švéd
Šára	šárat
Šárský	Šárka
Šíša	Šiša
Šťasta	Šťastný
Šťovička	šťovík
Šůs	šos
šablonář	šablona
šacunk	šacuňk
šafránovitý	šafrán
šakalí	šakal
šansonovitý	šanson
šarka	Šárka
šedesátka	šedesátník
šedobílo	šedobílý
šedohnědo	šedohnědý
šedomodro	šedomodrý
šedošedý	šedý
šenkovní	šenk
šestiúhelníkovitý	šestiúhelný
ševcovka	Ševcov
ševcovna	Ševcov
šibenický	šibenice
šimlovatý	šiml
šimlovitý	šiml
šimy	Šima
široširý	širý
šišato	šišatý
šiškovna	šiška
škarohlídný	škarohlíd
škemra	škemrat
školometný	školomet
škrunda	škrundat
šlahounovitý	šlahoun
šlechtictvo	šlechtit
šlehátko	šlehat
šlojířník	šlojíř
šmajchlovna	šmajchlovat
šmajchlovný	šmajchlovat
šminka	šmink
šmirglovka	šmirgl
šmodrcha	šmodrchat
šmrncovní	šmrnc
šmír	šmírař,šmírovat
šmíra	šmírovat,šmírař,šmírařit
šmírařina	šmírařit
španělsko	Španěl
špendličí	špendlík
špendlíčkovitý	špendlík
šperkovna	šperk
špic	špice
špica	špice,špicl,špic
špinivost	Špina
špinka	Špina
šplechta	šplechtat
šprajc	šprajcnout
šraňka	šraňkovat
šraňkovník	šraňkovat
šraňkovávaně	šraňkovat
šraňkovávatelně	šraňkovat
šraňky	šraňkovat
štrajk	štrajkovat
štráda	štrádovat
štítnatý	štítit
štítovitý	štítit
štítský	štít
štíře	štír,štířit
štěničí	štěnice
štětovka	štětina
štětovnice	štětina
šustí	Šust
švestkovice	švestka
švestkovo	švestka
švestkování	švestka
švidratý	švidrat
švih	Švihov
švihovka	Švihov
švédsko	Švéd
švýcarsko	Švýcar
šách	šach
šíroširý	širý
šíša	Šiša
šťárátko	šťárat
ťápa	ťápat
Žaba	žába
Žale	žalost,žal
Žalský	žal
Žalud	žaludek
Žaluda	žaludek,žalud
Žaludko	žalud,žaludek
Žalý	žalost
Žatecký	Žatec
Ždanová	Ždanov
Ždánov	Ždanov
Žehra	žehrat
Želivsko	Želiv
Želivský	Želiv
Želí	želé
Žemla	žemle
Žemlička	žemle
Žen	žena
Ženatý	žena
Žertvy	žertva
Žeňa	žena
Žežulková	žežulka
Žitek	Žítek
Živič	živit
Živko	Živkov
Živkovič	Živkov
Žižice	Žižka
Žižkovský	Žižkov
Županský	župan
Žára	žár
Žíteč	Žítek
žandarmie	žandarm
žardiniera	žardiniéra
žblabunil	žblabunit
žblabuňka	žblabunit
žblabuňka	žblabunit
ždibet	ždibec
žeberný	žebernatý
žebr	žebro
žebrovatý	žebro
žebří	žebro
železa	železo
železí	železo
železí	železo
žemla	žemle
ženačka	žena
ženec	žena
žengla	žengle
ženní	žena
žernosek	Žernoseky
žernový	žernov
žežulkovatý	žežulka
žežulčí	žežulka
žinka	žinkař
žitavák	Žitava
žitnice	Žitný
živitelkyně	živit
živorodnost	živorodý
žižkovka	Žižkov
žílový	žíla
žďářený	žďářit
žďářívaný	žďářit
žďářívatelný	žďářit
