Abraham	Abrahám
Abrahám	Abraham
Adam	Adamík
Adamík	Adam
Afrika	afrikán
Albany	albánský,Albánie
Albánie	albánský,Albany
Alexandr	Alexandrov
Alexandrov	Alexandr
Alexej	Alexejev
Alexejev	Alexej
Aleš	Leš
Almohada	Almohád
Almohád	Almohada
Aman	amant
Amor	amur
Andrej	Andrejs,Andrejev
Andrejev	Andrej,Andrejs
Andrejs	Andrej,Andrejev
Anna	Annan,Annen
Annan	Annen,Anna
Annen	Annan,Anna
Antily	antika
Antoník	Antonín
Antonín	Antoník
Apollon	Apollón
Apollón	Apollon
Astrachaň	astrachán
August	Augustin,Augustýn
Augustin	Augustýn,augustinián,August
Augustýn	Augustin,August
Avar	var
Avila	vila
Ašanin	Šan
Babice	babit,babičkovat,Babík,bábita,baba
Babák	baba,Babán,Bába,bába,Babík
Babán	Babák,baba
Babík	babičkovat,babit,Babice,Babák,baba
Bach	bachař
Baloun	balon
Bambar	Bamber
Bamber	Bambar
Bantu	bantovat
Bardejov	bard
Bardot	bard
Barina	bariéra
Barma	barman
Bartes	Barthes
Barthes	Bartes
Baťa	Baťka
Baťka	Baťa
Bednár	bedna
Ben	Benák,bé
Benák	Benátky,Ben
Benátky	Benák
Bikey	bikovat,biker
Blanka	blána,Blansko
Blansko	Blanka
Blatnice	blata,Blatný,bláto
Blatný	blata,Blatnice,bláto
Bob	nabob,bobař
Bohdal	Bohdan
Bohdan	Bohdal
Bojan	boj
Bolev	bolet
Bombaj	bomba
Bond	Bondy
Bondy	Bond
Borat	borec,Born
Born	bor,Borovan,Borat
Borovan	Born
Bosna	bos
Boudný	bouda
Boulez	boule
Bourne	bourat
Bořík	bořit
Božka	bůh
Brandejs	Brandýs
Brandýs	Brandejs
Brdy	brzy
Brod	brodit
Brook	brok,brouk
Brooker	broker
Broum	Broumov,brum
Broumov	Broum
Brozan	brozovat
Brunej	brunet,brunátný
Buchanan	buchancovat
Buchara	Buchár
Buchár	Buchara
Buda	budovat,Budín,bouda
Budín	Buda
Bumbál	bumbat
Bunin	buňka
Burda	burza
Bury	burza
Bába	baba,Babák
Bánovec	bán,báň,bánit
Bárt	Bárta
Bárta	Bárt,bárka
Bíl	bílý,běl,Bělík,Bělina,Bělov
Bój	bóje,boj
Běla	Bělina,běl,Bělov,bílý,Bělík
Bělina	Běla,běl,Bělov,Bělík,bílý,Bíl
Bělov	běl,Bělík,Bělina,Běla,Bíl,bílý
Bělík	běl,Bělov,Bíl,Bělina,Běla
Břehov	břeh
Břest	Březa
Březa	bříza,březí,Březnice,zabřezat,Břest
Březnice	Březa
Chalupník	chalupa
Charous	Charouz
Charouz	Charous
Chile	chinin
Chopin	chopit
Chrasta	chrastit,Chrástek
Christián	christianizovat
Chruščev	Chruščov
Chruščov	Chruščev
Chrástek	Chrasta
Cibula	cibule
Cikán	cikánit
Cvrk	cvrčet
Daan	Dan
Dalmácie	dalmatin
Dan	Dán,daň,Daan,daněk
Daniel	daň
David	Davidov,davidián,Davis
Davidov	David,davidián
Davis	David
Divina	divý
Dlabač	dlabat
Dobš	Dobšík
Dobšík	Dobš
Dolina	dolinář,doliňák,Olina,dole
Dominic	Dominik
Dominik	Dominic
Don	nový,donace
Drda	Drdák
Drdák	Drda
Drozdov	drozd
Držovice	držka
Dublin	dubl
Duran	Uran
Duša	duše
Dyk	Ryk,dýka,dík
Dák	dát
Dán	Dan,daň
Dárí	dar
Dírná	díra
Děd	dědit,dědina
Efes	efekt
Ellington	Wellington
Eva	Evans
Evans	Eva
Fabián	Fábina
Fantomas	fantom,fantóm
Fatos	fatovat
Fikar	fikat
Fin	Fink
Fink	Fin
Florena	Florentina,Florian,Florencie
Florencie	Florentina,Florena
Florentina	Florena,Florencie,Florian
Florian	Florena,Florentina
Fojtka	fojt
Fojtík	fojt
Fon	fonovat
Forman	forma
Fous	fousy
Francie	frank,Franke,Franky,František,Franic,frankismus
Franic	Francie,frankismus
Franke	Franky,frank,frankismus,Francie
Franky	frank,Franke,frankismus,Francie
František	frank,Francie
Fric	Frič
Frič	Fric
Fryg	Frýg
Frísko	freska
Frýg	Fryg
Fučík	fučet
Fábina	Fabián
Fénicie	fénix,fén,fen
Gajda	gajdy,Gajdar
Gajdar	gajdy,Gajda
Gal	Gál,gall,Galicie,Galen,galejní,Galat
Galat	Gal
Galen	Gal,galejní,gall,Gál
Galicie	Gal,galejní
Gent	agent,gen
Get	Gét
Gorbačev	Gorbačov
Gorbačov	Gorbačev
Gota	Gott,Gotha
Gotha	Gota
Gothard	Gotthard
Gott	Gota
Gotthard	Gothard
Gál	Gal,gall,Galen
Gét	Get
Halas	halasit
Halič	halit,halit
Hamas	Hamák
Hamák	Hamas
Hana	Haná,hanit,Hanus
Hanus	Hana,Haná
Haná	Hana,Hanus,hanit
Havaj	Havana
Havana	Havaj
Havel	Havlov
Havlov	Havel,Havlíček
Havlíček	Havlov
Hay	Haydn
Haydn	Hay
Hašler	hašlerka
Hejnice	hejno,hejsek
Helvét	helvet,helvít
Henoch	Henry
Henry	Henoch
Herakleitos	Hérakleitos
Hermite	hermetika
Hispanie	Hispánie
Hispánie	Hispanie
Hlava	Hlaváč,hlavička
Hlaváč	hlava,Hlava
Hlinka	Hlinsko
Hlinsko	Hlinka
Hlohov	hloh
Hnát	hnanec
Hora	horor,horna,hůra,horký,horovat,Horác,Horka,hoře,hornatý
Horka	horký,horor,hora,Hora,Horác,horna,horovat
Horniak	Hornik,horňák,horna
Hornik	Horniak,horna,horňák
Horác	Hora,hora,horký,Horka
Housar	husar
Hověz	hovězí
Hořan	Hořín,zahořan
Hořín	Hořan
Hošta	Hoštice
Hoštice	Hošta
Hrab	hrabě
Hrabal	hrabat,Hrabánek
Hrabák	hrabat,Hrabánek
Hrabánek	Hrabák,hrabat,Hrabal
Hrdina	hrdý
Hromada	zhromadnit
Hron	Hroník
Hroník	Hron
Hroza	hrůza,hrozen
Hrádek	hradit
Hulín	hulán
Hus	husa
Husák	husa
Hvězdář	hvězda
Hádek	hádat
Háj	hájit,hajat
Hérakleitos	Herakleitos
Hřebeč	hřebec,hřebit,hřeb,hřebenatý
Hřib	hřížit
Iber	Stoiber
Ikar	kar
Ilava	Sláva
Indrák	Jindrák
Istar	star
Itálie	italika
Jan	Ján
Janouš	Janoš
Janoš	Jánoš,Janouš
Janus	Janák
Janák	Janus
Jar	jarý,var
Java	Jáva
Jedlov	jedle
Jelena	jelenář,jelen
Jesenin	jesen
Jindrák	Indrák
Jinek	jiný,jíní
Jirous	Jirout,Jirouš
Jirout	Jirous
Jirouš	Jirous
Jiří	jiřina
Johan	johanita,pohan,Pohan
Jon	jonák
Joza	jod
Juda	judo,Judea
Judea	Juda,judo
Julin	Julián
Julián	Julin
Junona	junák
Jurač	Jurák
Jurák	Jurač
Just	justice,justovat,Justýna
Justýna	justice,Just
Jut	juta
Ján	Jan
Jánoš	Janoš
Jáva	Java,jatky
Kabát	překabátit
Kachyňa	kachna
Kain	Kainar
Kainar	Kain
Kalinin	kalit
Kamenec	Kamený,kameňák,kámen,kamna
Kamený	Kamenec,kameňák,kamna,kámen
Kanada	kanár
Kanak	kanec,kanout,kanava
Kanaán	kanec,kanovník,kanál,kanout,kanava
Kant	kanout,kantýna
Kantor	kantořit
Kap	kapka,kápo,kapsa
Kapitol	kapitola,kapitál
Karel	Karen,Karela
Karela	Karel
Karen	Karel
Karter	karta,kartel
Kasák	kasa,kasat
Kašpar	Kašper
Kašper	Kašpar
Kelč	kelt
Kladno	kladný,kláda
Klatovy	klátit
Klepáč	klepat
Klimek	Klimák,klima
Klimák	klima,Klimek
Klos	Kloss
Kloss	Klos
Klusák	klusat
Klučov	klučit,kluk
Klíma	klima,klímat
Klíč	klít,kleč
Klíš	klíště
Kohl	Kohlík
Kohlík	Kohl
Kohout	kohoutit
Koleč	koleno
Konstantin	konstanta
Kopač	Kopáč,kopat,kopa
Kopernik	Koperník
Koperník	Kopernik
Kopeč	kopec,kopí,kopit
Kopáč	Kopač
Korea	korec
Korsika	korsovat
Korák	kora
Kosovo	kos,Kosák,kosa
Kostelný	kostel,kostelničit
Kosák	kosa,kosý,kos,sak,Kosovo
Kotoul	kotouč
Kott	kotník,kotel,kotovat
Kovač	Kováč,kov
Kováč	Kovač,kov
Kozár	koza
Koč	kočí,kočka,kočár,koka
Koňařík	koňařit
Kořista	kořist
Košatka	košatý,ošatka
Košice	Košík
Košta	koště
Košík	Košice,koš
Krakonoš	nakrakonošovat,dokrakonošovat
Kravák	kráva,kravata,kravál
Krejčík	krejčí
Krist	krize,Kristýna
Kristýna	Krist
Krn	Krnov,krnět
Krnov	Krn
Kroječ	krojit
Krupka	krupař
Krystin	Krystián
Krystián	Krystin
Král	Králík,Královák,Králik
Králik	Králík,Král,král,Královák
Královák	Králík,Král,král,Králik
Králík	Králik,Královák,Král,král
Krč	krk,krčit,Krčín
Krčín	krčit,Krč
Kuba	Kubák,Kubač
Kubač	Kubák,Kuba,Kubát
Kubin	Kubín,Kubič,kubík
Kubič	kubík,Kubin,Kubín
Kubák	Kuba,Kubač,Kubát
Kubát	Kubák,Kubač
Kubín	Kubin,kubík,Kubič
Kuchar	Kuchár
Kuchyňa	kuchyně
Kuchár	Kuchar,kuchat
Kudela	Kuděla
Kudlák	kudlat,kudla
Kuděla	Kudela
Kulikov	kuličkář,Kulík
Kulík	kuličkář,Kulikov
Kunc	Kunka,kuna
Kunka	Kunc,kuna
Kurily	kurie
Kurš	kurs
Kvapil	kvapit
Kyjev	Kyjov
Kyjov	Kyjev
Kypr	kyprý,kypřit
Kysela	kyselý
Káraný	kárat,kára,kárný
Křen	křeč
Křepela	křepelka
Křiva	křivý,Křivák,Křivan
Křivan	Křiva,křivý,Křivák
Křivák	Křiva,křivý,Křivan,křik
Křiž	kříž,Kříž,křižovník,Křižan
Křižan	Křiž
Kříž	Křiž,křižovník
Kůst	kost,košt,koza
Lada	ladit,ládovat
Ladislav	Vladislav
Lakota	lakotit
Lange	lano
Laník	Láník,lano,lán
Laurent	laureát
Lačina	láčka
Laškov	laškovat
Lebeda	lebedit
Ledeč	lednit,led
Ledvina	ledví
Leibnitz	Leibniz
Leibniz	Leibnitz
Lena	len,Lenin,lenit,léno
Lenin	lenit,len,Lena
Lennon	len
Leona	Leontina
Leontina	Leona
Lepík	lepit
Letov	letovat,letět
Levit	levý,lev,ulevit,levitovat,levný,vylevit
Leš	lešení,Aleš
Lhota	Lhotka,lhůta
Lhotka	Lhota
Liba	Libý,libý,Libye
Liberec	Libérie
Libye	Libý,libý,Liba
Libérie	Liberec
Libý	Libye,Liba
Lichtenstein	Liechtenstein
Liechtenstein	Lichtenstein
Lipina	Lipka
Lipka	Lipina
Litva	litec,litice
Lobeč	lob
Lodín	loděnka,loď
Lojza	lůj
Lombardie	lombard
Lomič	lomit
London	Londýn
Londýn	London
Loos	los
Loun	Louny,Loučka
Louny	Loun,Loučný,Loučka,loučit
Loučka	loučit,Loučný,louka,Loun,Louny
Loučný	loučit,Loučka,louka,Louny
Lubina	Lublin
Lublin	Lubina
Lucern	lucerna
Ludvík	Ludvíkov
Ludvíkov	Ludvík
Lunin	Luňák
Luňák	Lunin
Luženice	Lužice,luh
Lužice	Luženice,luh
Lyko	lýko
Lynch	Lynchov
Lynchov	Lynch
Lysák	lysat
Láník	Laník,lán
Lída	lid
Lízal	lízat
Lýd	Lýdie
Lýdie	Lýd
Magdalena	Magdaléna
Magdaléna	Magdalena
Magic	magie
Mali	malý,malina
Malič	Málik
Malta	maltárna
Malák	Malát,malátný
Malát	malátný,Malák
Malín	malina
Manet	man,Mann
Mann	man,Manet
Mansfeld	Mansfield
Mansfield	Mansfeld
Mao	May
Maor	Maur
Marathon	Marathón
Marathón	Marathon
Marcel	Marcin
Marcin	Martin,Marcel
Marek	Mareček,Mareš,Marie,Mars,markovat
Mareček	Marek
Mareš	Marek
Maria	Marija,Marie,mariáš,mariňák,mařit
Marie	Maria,mařit,Marek,Marija,mariňák
Marija	Maria,Marie
Markovič	markovat
Markéta	market
Mars	Marek
Mart	Martin,Marten,Martyn,Martín
Marten	Martín,Martin,Martinov,Martyn,Mart
Martin	Martinov,Martín,Marten,Mart,Marcin,Martyn
Martinov	Martin,Martín,Marten
Martyn	Martín,Marten,Martin,Mart
Martín	Marten,Martin,Martinov,Martyn,Mart
Maryna	máry,rozmarýn
Masaj	masař,masáž
Masný	masa,masař,mast
Masters	masterovat
Mastný	mast
Masár	masař
Mater	mateř
Matouš	Mattuš
Mattuš	Matouš
Maur	Maor
Maxim	maximum
May	Mao,Mání
Mazák	mazat
Medek	medit,Medina,med
Medicej	medicína,medicina
Medina	medit,Medek,medicina
Meliš	Melišík
Melišík	Meliš
Menšík	menšit,menšina
Meroe	merk
Merta	Merten
Merten	Merta
Mesa	mísa,mést
Michael	Michal
Michal	Michalov,Michalič,Michael,Michalovič
Michalič	Michalovič,Michal,Michalov
Michalov	Michalovič,Michal,Michalič
Michalovič	Michalov,Michalič,Michal
Mikes	Mikis
Mikis	Mikes
Mikloš	Mikloško
Mikloško	Mikloš
Mikola	Nikola
Mikulič	Mikulík,Mikulov
Mikulov	Mikulič
Mikuláš	mikulášenec
Mikulík	Mikulič
Ming	mina
Minos	minus,mina,minuta
Mináč	mina,minuta,minus
Mitrov	Mitrovic
Mitrovic	Mitrov
Mnichov	mnich
Modra	modrý,Modrák
Modrák	Modra
Monako	Monet
Monet	moneta,Monako
Montana	montovat
Morava	Moravany,Moravsko,Moravan
Moravan	Morava,Moravany,Moravsko
Moravany	Morava,Moravan,Moravsko
Moravsko	Morava,Moravany,Moravan
Motýlek	motýl,motýlkář
Močik	moč,mok
Mořic	Mořina
Mořina	Mořic
Mrštík	mrštit
Mužík	muž
Mácha	máchat
Málik	Malič
Mánes	Mání,mánička
Mání	mánička,man,mánie,Mánes,May
Méd	med
Míla	míle,mělký,milý,Mílek,milice
Mílek	míle,mělký,Míla
Mína	mina,mínit,minuta
Mělník	mělnit,mělký
Nat	vně,nový,oj,nynat,vát,nit,necky,pot,půst
Nick	nit,nový,necky,ničit,Novák,Nil,nikl,poník
Nikola	Mikola
Nil	nit,Nick,nový
Nitran	nitrace
Nizozemsko	Nizozemí
Nizozemí	Nizozemsko
Nor	nora,donor
Norman	norma
Nos	los
Nosál	sál
Novák	nový,Nick,nit
Němčice	zněmčit
Ob	obec,niob
Oborný	Zborný,Voborný,Zborov
Oděsa	děs
Ola	Zola,olovo
Olina	Dolina,dolinář
Olymp	Olympie
Olympie	Olymp
Onan	nový
Ondrák	Vondrák
Opasek	opak
Orlov	orloj
Orta	aorta,Orten
Orten	Orta
Oset	Osetie,set,osev,vyosit,sít
Osetie	Oset
Osman	osma
Osvětim	světnice,osvětář,svítit
Ota	cé,otec
Oton	proton
Ouředník	zouředničit
Ořechov	ořech
Pacifik	pacifikovat
Pacov	pac
Paka	pakt
Palata	Palau,palatin,palatála,palác
Palau	Palata
Palec	palice
Palin	palice
Palán	palác
Pan	pán,propan,pánev
Panuš	panoš
Panák	paňák,panika
Papák	papá,papat
Parth	parta
Pastor	pastorovat
Pavlov	pavlač
Pavlát	pavlač
Pazdera	pazderník
Pašta	paštika
Paštun	Paštún
Paštún	Paštun
Pecina	pecka,pec
Peck	pec,pecka
Pepa	pepř
Perout	Peru,pero
Peru	Perout,Perun
Perun	Peru,Peruán
Peruán	Perun
Perštejn	Perštýn
Perštýn	Perštejn
Petrarca	Petrarka
Petrarka	Petrarca
Petrus	Petrák,Petruš
Petruš	Petrus
Petrák	Petrus
Petržela	petržel
Petržil	petržel
Peřina	pero
Piave	piano
Pikt	píst,píka,píča
Pila	píle,Pilát
Pilát	pila,Pila
Pivoňka	pivoň
Placht	plachta
Platon	platonik,novoplatonský
Plečnik	plečka
Plánka	plán,Plávka
Plávka	Plánka,plán,plátno
Podhora	podhorák
Poe	půst,vně,pot
Pohan	Johan
Poledník	poledne
Polena	poleno
Polsko	pole,police,polní
Pop	op
Popel	popelka
Portnoy	porta
Portugalsko	portugal
Pousta	poustevna
Pozdník	pozdě
Pozník	poník
Požár	žár,pohár
Praha	prahnout,práh
Praj	Prajz,pravý
Prajz	Praj
Protivín	protivit,protivný
Provázek	provázet
Pták	ptát
Puk	puč,pučit
Puškin	puška
Pygmalion	Pygmalión
Pygmalión	Pygmalion
Párs	pár,pára
Pásek	pás,pást,pásnout,pak
Pěč	píča,zpěčit,zpěčovat
Radek	rada
Radouň	radon
Rakovník	rak
Rambo	Rambous
Rambous	Rambo
Randák	rande
Reed	reedovat
Roentgen	rentgen
Roger	Rogers
Rogers	Roger
Rohlík	rohlíkář
Rojka	roj,ráj,Rojík
Rojík	roj,Rojka
Rol	role,Rolin,rolovat
Rolin	Rol,role
Roman	Román,román,Romanov
Romanov	Roman,Román,román
Román	Roman,Romanov
Ronov	ronit
Rubák	rubat
Ruda	rudý
Rulík	rulička
Rusko	rusý
Rusín	rusý
Rybák	ryba
Rybář	ryba
Ryk	Dyk
Ráb	rab
Rákosník	rákos
Rýmařov	rýmař
Sacharov	sacharin
Sadil	sadit
Sadov	sadovník,sadit
Sandino	sandinista
Santana	santal
Sardinie	sardinka,sardinkář
Sasko	sako
Scot	Scott
Scott	Scot
Sedlák	sedlat
Seneka	seno
Serafin	Serafína
Serafína	Serafin
Severa	sever
Sinhal	Sinhálec
Sinhálec	Sinhal
Siva	sivý,Sova,sova
Skalka	Skalník,Skála,skála,skalkařit
Skalník	Skalka
Skála	Skalka
Slanec	slanit
Slavia	Slávie
Slavník	Sláva
Slepička	slepičář,naslepičit
Slezsko	slez
Slovensko	Slovinsko
Slovinsko	Slovensko
Sláva	Ilava,Slavník,Slávie
Slávie	slavit,slavík,Sláva,Slavia
Smola	smůla
Smíchov	smích
Smělý	smět
Sodoma	soma,soda
Sokrates	Sókratés
Solana	Soláň
Soliman	Solimán
Solimán	Soliman
Soláň	Solana
Sosna	sosat
Sova	Sovík,Siva
Sovík	Sova,sova
Sparta	parta,pasparta
Spina	Spinoza
Spinoza	Spina
Sporck	sport,spora,spor
Srna	srnec,Srník
Srník	srnec,Srna
Srp	sýr
Stalin	Stalinov
Stalinov	Stalin
Staník	stanovit,stájník
Stin	stín,Stoy,stěna,Stone
Stoiber	Iber
Stone	stonek,stonat,Stoy,Stin
Stoy	sto,Stin,stoik,Stone
Struž	vystružit
Studený	stud,studit,studovat,Studénka,Studnář
Studnář	Studený,studený
Studénka	Studený,studený
Stupa	stopa
Stříbrný	Stříbro,stříbro
Stříbro	stříbřit,Stříbrný
Stříž	střiž
Sudek	Sudety,sud
Sudety	Sudek
Sula	sulc
Sup	op
Sura	surový
Svatý	svat
Sviny	svině
Svitavy	Sviták
Sviták	Svitavy
Sádek	sadit,sadovník
Sókratés	Sokrates
Sýrie	sýr
Tabori	tábor
Tatar	táta,Tate,tát
Tate	tát,táta,Tatar
Teka	tečka,teč
Telč	tele,teč,otec,cé
Tennant	tenký
Teplice	zteplit,Tepličák,vyteplit
Tepličák	Teplice
Tisa	Tisov,tisíc
Tisov	Tisa,tisíc
Titov	titan,Titán
Titán	titan,Titov
Tomeš	Tomiš
Tomiš	Tomeš
Tomáš	Tomášov
Tomášov	Tomáš
Trajan	Trojan
Trent	Trentin
Trentin	Trent,Trenčín
Trenčan	Trenčín
Trenčín	Trenčan,Trentin
Trhovky	trh
Trnka	trn,trnout
Trojan	Trajan
Troják	trojka,trojčit
Troy	trojka
Trs	trsat
Turan	Turánek,Turín
Turek	tur,Tursko,turkický
Turkit	turkický,Tursko,tur
Turnov	turnaj
Tursko	Turek,Turkit,turkický,tur
Turánek	Turan
Turín	Turan
Tutu	tutový
Tyl	týl
Tyr	Týr
Tyroly	tyrolsko
Týr	Tyr
Třinec	třít
Ural	Uran
Uran	Ural,Duran
Urbán	urbánní
Vaculík	culík
Val	válka,Vala,Valina,valkovat,Válek,Valeč
Vala	Val,válka
Valdštejn	Valdštýn
Valdštýn	Valdštejn
Valencien	Valencián,Valentin,Valentina,Valentinián
Valencián	Valentinián,Valencien,Valentin
Valentin	Valentina,Valentinián,Valentýn,Valencien,Valencián
Valentina	Valentin,Valentýn,Valentinián,Valencien
Valentinián	Valentin,Valencián,Valentina,Valencien
Valentýn	Valentin,Valentina
Valeč	Válek,Val,valčík,valkovat
Valina	Val,válka,valit
Vaník	Vaněk,vana
Vaněk	Vaník,vana
Vedra	vedrat
Vela	velký,novela
Velen	velký,jelen
Veleslavín	veleslavit
Verna	Verona
Verona	Verna
Vey	ven,vně,ovce
Vietnam	vietnamka
Vilém	Vilím
Vilím	Vilém
Vinklár	vinklář
Virginie	virginal
Vizovice	vize
Vlach	Vlachov
Vlachov	Vlach
Vladimir	Vladimír
Vladimír	Vladimir
Vladislav	Ladislav
Vlasov	vlas
Vlastík	vlast
Vlk	vlčit,Vlčnov
Vlčnov	vlk,Vlk,vlčit
Voborný	Oborný,Zborný
Vocel	ocel
Voda	Vodák,vodovod,vodnář
Vodák	voda,Voda
Vojan	vojančit
Vojen	vojna,voj
Vondra	Vondrák
Vondrouš	Vondruš
Vondruš	Vondrouš
Vondrák	Vondra,Ondrák
Vont	vůně
Votruba	otruby
Vrana	vrána,Vraný
Vraný	Vrana,vrána
Vrba	Vrbata
Vrbata	vrba,Vrba
Vrtěl	vrtět
Vrzák	vrzat
Váh	váha,váhař
Válek	válka,Valeč,Val
Vápeník	vápeničit,vápenět
Vína	víno,vina,věno
Vít	větit,veto,větev
Výrov	výr
Věra	víra,věrovat
Wagner	wagnerián
Wahháb	wahhábita
Welles	Wells
Wellington	Ellington
Wells	Welles
Wild	Wilde
Wilde	Wild
Zambie	ambit
Zapata	pata
Zborný	Oborný,Voborný,Zborov
Zborov	Zborný,Oborný
Zdena	Zdeněk
Zdeněk	Zdena
Zelenkov	zelený
Zelina	zelí
Zhoř	zhořčit
Zimák	zima
Zita	zíta,zívat
Zlín	zlínět
Zmij	zmije
Změlík	změlčit
Zola	Ola
Zrůst	vzrůst,růst
Zuckerman	Zuckermann
Zuckermann	Zuckerman
Zuza	Zuzák,Zuzana,vyzuzat,nouze
Zuzana	Zuza,Zuzák
Zuzák	Zuza,Zuzana,vyzuzat
Zvíkov	víko
Zábel	Ábel,záběl
Záhor	záhoří,záhoř
Zámečník	zámečničit
Zámiš	zámišník
Závada	zavadat
Závora	závorář
Zázvora	zázvor
absolutní	zabsolutnit,zabsolutnět
absorbovat	sorbovat,adsorbovat
abstenovat	abstinovat
abstinovat	abstenovat
abstraktní	zabstraktnit,zabstraktnět
absurdní	zabsurdnit
aditivní	aditivovat
aditivovat	aditivní
adresa	adresant
adresant	adresa
adsorbovat	sorbovat,absorbovat
afinní	afinovat
afinovat	afinní
afrikanistika	afrikán
afrikán	Afrika,afrikanistika
agent	Gent
agrese	regrese
akce	akcie
akcie	akce
akord	kord
akta	aktér,aktin
aktin	aktiv,akta,aktivní
aktiv	aktivní,aktin
aktivisovat	zaktivisovat
aktivní	aktiv,aktin
aktualisovat	zaktualisovat
aktér	akta
akumulovat	kumulovat
alarm	alarmovat
alarmovat	alarm
albit	albína
albánský	Albánie,Albany
albín	albína
albína	albín,albit
alkalisovat	zalkalisovat
alternovat	alterovat
alterovat	alternovat
amalgam	amalgám
amalgám	amalgam
amant	Aman
ambit	Zambie
amortisovat	zamortisovat
amur	Amor
analysovat	zanalysovat,vyanalysovat
andrologie	dendrologie
antika	Antily,attika,etika,atika
anténa	anténář
anténář	anténa
aorta	Orta
aparatura	reparatura
apercipovat	percipovat
apolit	zápolit
aranžovat	aranžírovat,aranžér
aranžér	aranžírovat,aranžovat
aranžírovat	aranžér,aranžovat
archeologie	archeologizovat
archeologizovat	archeologie
arestant	arestovat
arestovat	arestant
armatura	armaturář
armaturář	armatura
asimilovat	assimilovat
aspirin	aspirovat
aspirovat	aspirin
assimilovat	asimilovat
astrachán	Astrachaň
ateismus	teismus
atika	attika,etika,antika
atopie	utopie
atrahovat	retrahovat
attika	atika,etika,antika
audit	auditovat
auditovat	audit
augustinián	Augustin
aut	auto
auto	aut
automatisovat	doautomatisovat,zautomatisovat,odautomatisovat,přeautomatisovat
autorisovat	zautorisovat
aval	avalovat
avalovat	aval
avisovat	visovat
avízo	avízovat
avízovat	avízo
baba	Bába,bába,Babák,Babán,Babice,Babík
babit	Babice,Babík,bábita,babičkovat
babičkovat	Babík,Babice,babit,babičkovatět
babičkovatět	zbabičkovatět,babkovatět,babičkovat
babkovatět	babičkovatět
bachař	Bach
bafunář	bafuňář,bafuňařit
bafuňařit	bafuňář,bafunář
bafuňář	bafunář,bafuňařit
bahno	zabahnout
balet	baletit
baletit	balet
balon	balonář,Baloun
balonář	balon
balzamiko	balzám
balzám	balzamiko
balík	balíkář
balíkář	balík
bandoneon	bandáž
bandáž	bandoneon
banka	baňka,báň,bán
bantovat	Bantu
banální	banát,banán
banán	banát,bán,banální,báň
banát	banální,banán,zabáňat
bard	Bardot,Bardejov
bariéra	Barina
barman	Barma
baterie	baterkář
baterkář	baterie
batika	batikovat,batikář
batikovat	batika,batikář
batikář	batikovat,batika
batůžkařit	batůžkář
batůžkář	batůžkařit
bazalka	bazalt
bazalt	bazalka
bazén	bazénář
bazénář	bazén
bačkora	bačkorář
bačkorář	bačkora
baňka	banka,báň
bedna	Bednár
bejvat	obejvat,zabejvat
bekat	békat
benediktin	benediktýn
benediktýn	benediktin
beran	beranit
beranit	beran
bez	bé,jez
bečka	bé
bigbeat	bigbít
bigbít	bigbeat
biker	Bikey
bikovat	Bikey
bilionář	biliár
biliár	bilionář
biobrambora	brambor
biografie	ideografie
bioinženýr	inženýr
biomedicína	medicína
bipolarizovat	bipolární
bipolární	bipolarizovat
bit	bít,bítník
biřmovanec	biřmovat
biřmovat	biřmovanec
blata	Blatný,Blatnice,bláto,blána
blazeovat	blázen
blb	blbý
blbý	blb
blesk	bleskat
bleskat	zableskat,blesk
blok	bloknout
bloknout	blok
blyštit	blýštit,blyštět
blyštět	blyštit,blýštit
blána	Blanka,blata
bláto	Blatný,blata,blátovatět,Blatnice,zablátit
blátovatět	bláto
blázen	blazeovat
blíženec	blížit
blížit	blíženec
blýštit	blyštit,blyštět
bob	nabob,bobař
bobař	bob,Bob
bohatý	obohatit
boj	Bojan,Bój
bolet	Bolev
bolševik	neobolševik
bolševisovat	zbolševisovat
bomba	Bombaj
bon	bonita
bonita	bon
bor	Born,borůvka,úbor
borec	Borat
borůvka	bor
bos	bosovat,Bosna
bosovat	bos
bota	botanika
botanika	bota
boubelatý	zboubelatět
bouchat	buchat
bouda	Boudný,Buda,zaboudit
boule	Boulez
bourat	Bourne
bořit	Bořík
brada	brázda
brambor	biobrambora
brand	brána
brblat	žbrblat
briketa	briketář
briketář	briketa
brnkat	přebrnkat
brodit	Brod,dobrodit,brozovat
brok	Brook,brokovnice,brokař
brokař	brok,brokovnice
broker	Brooker
brokovnice	brok,brokař
bronz	bronzař
bronzař	bronz
brouk	Brook
brozovat	brodit,Brozan
brum	Broum
brunet	Brunej,brunátný
brunátný	brunet,Brunej
brzy	Brdy
brána	obrana,bránit,brand
bránit	brána
brázda	brada
buchancovat	Buchanan
buchat	buchta,bouchat
buchcovat	buchtovatět,buchta
buchta	buchcovat,buchat,buchtovatět
buchtovatět	zbuchtovatět,buchcovat,buchta
budovat	Buda
buk	bukovat
bukovat	buk
buldok	buldočit
buldočit	buldok
bumbat	Bumbál
burza	Bury,Burda
buňka	Bunin
bydlet	rozbydlet,bydlit
bydlit	bydlet
byte	být
bzikat	bzíkat
bzíkat	bzikat
bába	baba,Babák
bábita	babit,Babice
bádat	nabádat
báje	bájit
bájit	báje
bán	báň,banka,bánit,Bánovec,banán
bánit	báň,bán,Bánovec
bárka	Bárta
bát	dbát
báň	bán,banka,bánit,baňka,Bánovec,banán
bé	bečka,bez,Ben
békat	bekat
bída	běda
bílý	Bíl,Běla,běl,Bělina,bít,Bělov
bít	bit,bítník,bílý
bítník	bít,bit
bóje	Bój
býk	býčit
být	byte
býčit	býk
běda	bída
běl	Bělov,Bíl,Bělina,Bělík,Běla,bílý
běs	oběsit
běženec	běžet
běžet	běženec
bředat	vybředat,zabředat,rozbředat
břeh	Břehov
březí	Březa,bříza
břídit	zbředit
bříza	Březa,březí
bůh	Božka
bžunknout	vyžunknout
car	cárat
cedule	cedulář
cedulář	cedule
celovat	celý
celý	celovat
cena	cent
censurovat	vycensurovat,zcensurovat,docensurovat,odcensurovat,procensurovat,rozcensurovat,zacensurovat,nacensurovat
cent	docent,cena
centralisovat	zcentralisovat,docentralisovat,přecentralisovat,decentralisovat
cesionář	cessionář
cessionář	cesionář
chalupa	Chalupník
chan	chán
charakterisovat	vycharakterisovat,zcharakterisovat
charta	charter
charter	charta
chat	chata
chata	chat
chcát	ochcat,nachcat,přechcat
cherub	cherubín
cherubín	cherub
chinin	Chile
chlad	chladnice
chladnice	chlad
chlop	chlup
chlup	chlop
chlámat	vychlámat
chopit	Chopin
chrastit	Chrasta
christianizovat	Christián
chrom	chróm,chromý
chromý	chrom
chroptit	chroptět
chroptět	chroptit
chroupat	chrupat
chrupat	chroupat
chránit	uschránit
chróm	chrom
chvalořeč	chvalořečit
chvalořečit	chvalořeč
chvoj	chvost
chvost	chvoj
chán	chan
chřest	chřestit
chřestit	chřest
chřoupat	chřupat
chřupat	chřoupat
cibule	Cibula
cifra	cifrák,šifra
cifrák	cifra
cikán	cikánit
cikánit	Cikán,cikán,zcikánět
ciselovat	vyciselovat
cisterciák	cistercián
cistercián	cisterciák
citovat	cítit
citron	citrón
citrus	citrusář
citrusář	citrus
citrón	citron
civilisovat	zcivilisovat
cizí	zcizet
clo	clona
clona	clo
cucat	cucek
cucek	cucat
culit	culík
culík	culit,Vaculík
cvikat	cvičit
cvičit	cvikat
cvok	cvočkář
cvočkař	cvočkář
cvočkář	cvočkař,cvok
cvrčet	Cvrk
cárat	car
cé	Ota,oko,ovce,tele,pot,otec,Telč
cítit	citovat
dalmatin	Dalmácie
daněk	Dan,daň
dar	Dárí
davidián	Davidov,David
daň	Dan,Dán,Daniel,daněk
dbát	bát
debrujár	debrujář
debrujář	debrujár
decentralisovat	přecentralisovat,dodecentralisovat,zcentralisovat,centralisovat,docentralisovat
dedukce	dedukovat
dedukovat	dedukce
dehydrovat	rehydrovat
deionisovat	ionisovat,zionisovat
deka	dekovat,dé
dekadence	kadence
deklamovat	proklamovat
dekomodifikovat	modifikovat
dekovat	deka
demence	dementi
dementi	demence
demilitarisovat	remilitarisovat
demobilisovat	domobilisovat,zamobilisovat,vymobilisovat,odmobilisovat,přemobilisovat,mobilisovat,vmobilisovat,zmobilisovat,umobilisovat
demografie	mamografie
demokratisovat	zdemokratisovat
demoralisovat	zdemoralisovat
den	zen
dendrologie	andrologie
denunciant	denunciovat,denuncovat
denunciovat	denuncovat,denunciant
denuncovat	denunciovat,denunciant
deportovat	reportovat
deprese	represe,depresář
depresář	deprese
deputace	deputátník
deputátník	deputace
desetina	desetník
desetník	desetina
desorganisovat	zdesorganisovat
desátek	desátník
desátník	desátek
dezert	dezertovat
dezertovat	dezert
diakritika	kritika
dietologie	etologie
diferenciovat	diferencovat
diferencovat	diferenciovat
diletant	diletovat
diletovat	diletant
dimense	dimenze
dimenze	dimense
direktor	direktovat
direktovat	direktor
disciplinovat	disciplína
disciplína	disciplinovat
dispens	dispenz,dispensovat
dispensovat	dispens
dispenz	dispens
distanc	distance
distance	distanc
distribuce	redistribuce
diversifikovat	zdiversifikovat,dodiversifikovat
divý	Divina,dívat
dlabat	Dlabač
dlouhatý	dlouhý
dlouhý	dlouhatý
dmychat	dmýchat
dmýchat	dmychat
dna	dno,dé,dýně
dno	dna,dé,dýně
dnít	znít
doautomatisovat	odautomatisovat,zautomatisovat,automatisovat,přiautomatisovat
doba	nádoba
dobrodit	dobroděj,brodit
dobroděj	dobrodit
dobuzovat	odbuzovat
dobíhat	obíhat
docelit	ucelit,zcelit,zocelet
docensurovat	procensurovat,odcensurovat,censurovat,zcensurovat,rozcensurovat,vycensurovat,zacensurovat
docent	cent
docentralisovat	zcentralisovat,centralisovat,decentralisovat
dochutit	ochutit,přichutit
docpat	procpat,pocpat
dodecentralisovat	decentralisovat,přecentralisovat
dodiversifikovat	diversifikovat,zdiversifikovat
dodrat	zadrat
dogeneralisovat	zageneralisovat,generalisovat,zgeneralisovat,vygeneralisovat
dohlédat	ohlédat
dohodnout	pohodnout,uhodnout
doinicialisovat	inicialisovat,odinicialisovat,zinicialisovat,nainicialisovat,rozinicialisovat,přeinicialisovat,reinicialisovat
dok	sok,nok
dokadit	kadit
doklimatisovat	odklimatisovat,klimatisovat,zaklimatisovat,přiklimatisovat
dokládat	ukládat,kládat,zakládat,přikládat,předkládat,odkládat,vykládat,rozkládat,překládat,donakládat,skládat
dokonsumovat	prokonsumovat,konsumovat,přikonsumovat,rozkonsumovat,vykonsumovat
dokrakonošovat	nakrakonošovat,Krakonoš
dokrojit	okrojit,prokrojit,krojit
dokrvit	prokrvit,zkrvit,okrvavit
dokvítat	zkvítat,odkvítat
dole	důl,Dolina,podolí
dolejzat	prolejzat
dolesnit	lesnit
dolhat	prolhat
dolinář	Dolina,doliňák,Olina
doliňák	Dolina,dolinář
dolétnout	dolítnout
dolíhat	líhat,vylíhat,rozlíhat
dolítnout	dolétnout
domejšlet	promejšlet,pomejšlet
domobilisovat	mobilisovat,pomobilisovat,omobilisovat,promobilisovat,zmobilisovat,zamobilisovat,demobilisovat,umobilisovat,odmobilisovat,namobilisovat,rozmobilisovat,vymobilisovat,přemobilisovat,přimobilisovat
domrazovat	promrazovat
domykat	mykat,promykat
domáčknout	promáčknout
domílat	promílat
donace	Don
donakládat	vynakládat,kládat,zakládat,dokládat,vykládat
donor	Nor,nora
donormalisovat	pronormalisovat,normalisovat,znormalisovat,přenormalisovat
doplítat	vyplítat,proplítat,zaplítat,oplítat,uplítat,podplítat
doprecisovat	precisovat,rozprecisovat,vyprecisovat
doprovodit	vyprovodit,sprovodit
dopřádat	opřádat,zapřádat,upřádat,vypřádat,rozpřádat,spřádat
doresonovat	zresonovat,rozresonovat,odresonovat,zaresonovat,resonovat
dosedat	posedat,odsedat,vysedat
dosignalisovat	signalisovat,odsignalisovat,zasignalisovat,prosignalisovat
doslat	poslat
doslýchat	zaslýchat,vyslýchat
dosrat	prosrat,přisrat,srát,odsrat
dostabilisovat	stabilisovat,ustabilisovat,přistabilisovat,nastabilisovat,zastabilisovat
dostat	ostat
dostlat	postlat,stlát
dostoupit	stoupit,prostoupit
dostrukturalisovat	strukturalisovat,nastrukturalisovat,zastrukturalisovat
dostřeďovat	středit
dostřihat	střihat,nastřihat,odstřihat,vostříhat,přistřihat,zastřihat
dostříhnout	stříhnout,nastříhnout,ustříhnout,vostříhat,zastříhnout,přestříhnout
dosychat	osychat,dosýchat,prosychat,rozsychat,vysychat,zasychat,osýchat,přisychat,sesychat
dosynchronisovat	nasynchronisovat,usynchronisovat,přisynchronisovat,přesynchronisovat,sesynchronisovat,resynchronisovat
dosystematisovat	systematisovat,nasystematisovat,rozsystematisovat,přesystematisovat
dosystemisovat	systemisovat
dosíkat	vysíkat
dosýchat	dosychat,osýchat,prosýchat,osychat,vysýchat,usýchat,přisýchat,rozsýchat,zasýchat,prosychat
doteplit	proteplit,zteplit,uteplit
dotýkat	protýkat,týkat
doufat	zoufat
dout	out,zout,rozdout
dovalorisovat	valorisovat,zvalorisovat
dovaselinovat	vaselinovat,provaselinovat,navaselinovat
dovitaminisovat	ovitaminisovat,vitaminisovat,odvitaminisovat,zvitaminisovat,přivitaminisovat,navitaminisovat
dovlíknout	zavlíknout,odvlíknout
dovolenkařit	dovolenkář
dovolenkář	dovolenkařit
dovrtit	uvrtit,povrtit,vyvrtit,vrtět
dovulkanisovat	zavulkanisovat,vulkanisovat,zvulkanisovat,předvulkanisovat
dovyšívat	zavyšívat
dovíjet	províjet,víjet,přivíjet
dozor	pozor,vzor
dočmuchat	pročmuchat,čmuchat,vočmuchat
doškicnout	oškicnout,naškicnout,přeškicnout
dravý	zdravý
dredovatět	zdredovatět
dredy	dres
drenovat	drénovat
dres	dredy
drezér	drezína,drezírovat
drezína	drezér,drezírovat
drezírovat	zdrezovat,drezína,drezér
drezúra	drezúrovat
drezúrovat	drezúra
drhat	zdrhat
drob	drobit,drobeček,drobet
drobet	drobit,drobeček,drob
drobeček	drobit,drobet,drob
drobit	drobet,drob,drobeček
drozd	Drozdov
drožka	drožkařit
drožkařit	drožka
družit	družička
družička	družit
družstevničit	združstevnit
drát	odrat
drát	odrat
drén	drénovat
drénovat	drén,drenovat
držka	Držovice
dubl	Dublin
duh	duha
duha	duh
dukát	zukat
dupat	zupat,oddupat
dusat	dusný,dusit
dusit	dusat
dusný	dusat
duše	Duša
dvojit	dvojí,dvojka,dvojný
dvojka	dvojí,dvojkař,dvojit,dvojný
dvojkař	dvojka
dvojnásobek	dvojnásobit
dvojnásobit	dvojnásobek,násobit
dvojný	dvojí,dvojka,dvojit
dvojí	dvojit,dvojka,dvojný
dychtit	dychtivec
dychtivec	dychtit,zdychtivět
dál	dálný
dálný	dál
dát	zdát,Dák
dé	dno,dík,dna,deka,dít
démon	démonie
démonie	démon
dík	dé,Dyk,dít
díra	Dírná
dít	dítě,dívat,dé,dík
dítě	dít,dívat
dívat	dít,dítě,divý
dýka	Dyk
dým	rým
dýně	dno,dna
děd	dědit,dědina
dědina	dědit,Děd,děd
dědit	dědina,Děd,děd
děs	Oděsa
dřevařit	dřevo
dřevo	dřevařit
dřevosochat	dřevosochař
dřevosochař	dřevosochat
dřín	dřít
dřít	dřín
dštít	štít,štítit
důl	dole
džbán	džbánkař
džbánkař	džbán
džíny	žíně
efekt	Efes
eklovat	klovat
ekosystém	systém
elaidinizovat	elaidinozovat
elaidinozovat	elaidinizovat
elektrisovat	zelektrisovat
elektron	elektronika
elektronika	elektron
emigrovat	migrovat
epika	epitel
epitel	epika
esej	eses
eses	esej,přesný
etika	Štika,štika,atika,attika,antika
etnomuzikologie	muzikologie
etologie	dietologie,neonatologie,poetolog
etymologie	pomologie
expedient	expedovat
expedovat	expedient
explodovat	explozíva
explozíva	explodovat
expres	exprese
exprese	expres
extrém	extrémismus
extrémismus	extrém
fabrika	fabrikovat
fabrikovat	fabrika
fabulizovat	fabulovat
fabulovat	fabulizovat
fajfka	fajfkář,fajfkař
fajfkař	fajfkář,fajfka
fajfkář	fajfkař,fajfka
faktor	faktura
faktum	faktura
faktura	faktum,faktor
falsifikovat	zfalsifikovat
fanfaron	fanfarón,fanfára
fanfarón	fanfaron
fanfára	fanfaron
fant	fantom
fantom	fantóm,Fantomas,fant
fantóm	fantom,Fantomas
fara	fárat,farad
farad	fara
fasit	fasovat
fasona	fasovat
fasovat	fasit,fasona
fatovat	Fatos
faun	fauna
fauna	faun
fašismus	neofašismus,fašisovat
fašisovat	zfašisovat,fašismus
fašírka	fašírovat
fašírovat	fašírka
feminismus	feminní
feminní	feminismus
fen	fén,Fénicie
figura	figurína
figurína	figura
fikat	Fikar,fikce
fikce	fík,fikat
fil	filc
filc	fil
filosof	filosofie
filosofie	filosof
finance	finále
fintit	fintovat
fintovat	fintit
finále	finance
firnovatět	zfirnovatět
flamenco	flám
flašinet	flaška
flaška	flašinet
flitrovat	oflitrovat,poflitrovat
fluidní	fluidum
fluidum	fluidní
flám	fláma,flamenco
fláma	flám
fojt	Fojtík,Fojtka
folie	folium
folium	folie
folklor	folklór
folklór	folklor
fonografie	monografie,sonografie
fonovat	Fon
forma	reforma,Forman
fotografie	fotografovat
fotografovat	fotografie
fous	fousy
fousy	fous,Fous
fracek	frak
frak	frakce,fracek
frakce	frak
frank	Franky,Francie,Franke,František,frankismus
frankismus	Franky,Franke,frank,Franic,Francie
freska	Frísko
fronta	frontýrovat
frontýrovat	fronta
frčet	frčka
frčka	frčet
furiant	zafuriantit
fučet	Fučík
fárat	fara
fén	fen,Fénicie
fénix	Fénicie
fík	fikce
gajdy	Gajda,Gajdar
galejní	Gal,Galen,galéra,Galicie
galerie	galéra
gall	Gal,Gál,Galen
galéra	galerie,galejní
gaullista	neogaullista
gelovatět	zgelovatět
gen	Gent
generalisovat	vygeneralisovat,zgeneralisovat,zageneralisovat,dogeneralisovat,rozgeneralisovat,přegeneralisovat
geografie	ideografie
geomorfologie	morfologie
germanisovat	zgermanisovat
gesce	gesto
gesto	gesce
glajchšaltizovat	glajchšaltovat
glajchšaltovat	glajchšaltizovat
gondat	gondola
gondola	gondat
grad	gradovat
gradovat	grad,graduovat
graduovat	gradovat
grafika	grafičit,grafit,ideografie
grafit	grafičit,grafika
grafičit	grafika,grafit,ideografie
gram	program
granit	granát
granát	granit
graviton	gravitovat
gravitovat	graviton
gravér	gravírovat
gravírovat	gravér
gubernie	gubernium
gubernium	gubernie
habilitovat	rehabilitovat
had	hadař
hadař	hádat,had
hajat	Háj,háj,hájit
hajdalačit	hajdalák
hajdalák	hajdalačit
hajduk	hajdučit
hajdučit	hajduk
halasit	Halas
halda	haldař
haldař	halda
halit	Halič,halíř
halit	Halič,halíř
halíř	halit,halit
hamburger	hamburgr
hamburgr	hamburger
hammond	hammondkář
hammondkář	hammond
hanit	hanět,Hana,Haná
hanět	hanit
harmonie	harmonika
harmonika	harmonie
harmonisovat	zharmonisovat
havran	zhavranět
hašiš	hašovat
hašlerka	Hašler
hašovat	hašiš
hec	hecovat
hecovat	hec
hedvábí	zhedvábnět
hejbat	vohejbat
hejno	Hejnice,hejsek
hejsek	hejno,Hejnice
helvet	helvít,Helvét
helvít	helvet,Helvét
hendikepovat	hendikepový
hendikepový	hendikepovat
hermetika	Hermite
heroin	heroina
heroina	heroin
hic	hit
historisovat	zhistorisovat
hit	hic
hlad	hladit
hladit	hlad
hlahol	hlaholit
hlaholit	hlahol
hlava	Hlaváč,hlavička
hlavička	Hlava,hlava
hledat	hlédat,zhlédat,ohlédat,vyhlédat,rozhlédat,hledět,nahlédat
hledět	hledat
hlemýžď	hlemýžďář
hlemýžďář	hlemýžď
hloh	Hlohov
hlouček	hloučit
hloučit	hlouček
hlédat	zhlédat,hledat,vyhlédat,ohlédat,rozhlédat,nahlédat,prohlédat,zahlédat
hlídat	zahlídat
hnanec	Hnát,hnát,hnát
hnout	prahnout
hnát	hnanec
hnát	hnanec
hníst	hnít
hnít	hníst
hobl	hoblina
hoblina	hobl
hodina	hodit,hodinkář
hodinkář	hodina,hodit
hodit	hodina,hodovat,hodinkář
hodovat	hodit
hokej	žokej
hold	holý
holkařit	holčičkář
holý	hůl,hold
holčičkář	holkařit
hora	horor,horna,hůra,horký,horovat,Horác,Horka,hoře,hornatý
horký	Horka,horor,Hora,hora,horna,Horác,horovat
horna	hornatý,hora,Hora,horňák,horký,Horniak,Hornik,horovat,horor,Horka
hornatý	horna,horňák,horovat,Hora,hora
horolezec	horolezení
horolezení	horolezec
horor	hora,Hora,horký,Horka,horovat,horna
horovat	Hora,hora,horna,horor,hornatý,horký,Horka
horňák	hornatý,horna,Horniak,Hornik
hospital	hospitant
hospitant	hospitovat,hospital
hospitovat	hospitant
hospoda	hospodář
hospodář	hospoda,vodohospodář
houně	houst
houpnout	zhoupnout,rozhoupnout,zahoupnout,vyhoupnout,přehoupnout
houst	houští,houně
houští	houst
hovězí	Hověz
hoře	hořec,hořet,hora,Hora,hořký
hořec	hořet,hoře,hořký
hořet	hořec,hoře,hořký
hořký	hoře,hořec,hořet
hrabat	Hrabák,Hrabánek,Hrabal
hrabě	Hrab
hradit	hradlo,hráz,Hrádek
hradlo	hradit
hrana	hranit,hraničník,hrát
hranit	vyhranit,hraničník,hrana,zhránit
hraničník	hranit,hrana
hrbolatit	zhrbolatět
hrdlit	hrdlo
hrdlo	hrdý,hrdlit
hrdý	hrdlo,Hrdina
hrnec	hrnout
hrnout	hrnec
hroch	hrot
hromada	zhromadnit
hrot	hroch
hrozen	Hroza
hrudovat	hruď
hruď	hrudovat
hrách	hrát
hrát	hrách,hrana
hráz	hradit
hrůza	Hroza
huba	hubnout
hubit	hubnout
hubnout	huba,hubit
hulán	Hulín
humanismus	humanisovat,humánní
humanisovat	zhumanisovat,humanismus
humánní	humanismus
husa	Husák,Hus
husar	Housar
hvozd	hvozdit
hvozdit	hvozd
hvězda	Hvězdář
hysterie	hysterčit
hysterčit	hysterie
hádat	hadař,Hádek
háj	hájit,hajat
hájit	háj,Háj,hajat
hřeb	hřebec,Hřebeč,hřebit,hřebenatý
hřebec	Hřebeč,hřeb,hřebit,hřebenatý
hřebenatý	hřebec,hřeb,Hřebeč
hřebit	hřebec,Hřebeč,hřeb
hřib	hřížit
hřížit	Hřib,hřib
hůl	holý
hůra	Hora,hora
idealisovat	zidealisovat
ideografie	geografie,grafika,grafičit,biografie
ideologie	ideologizovat
ideologizovat	ideologie
iks	viks,kiks
improvisovat	zaimprovisovat,zimprovisovat
indukce	indukovat
indukovat	indukce
industrialisovat	zindustrialisovat
informel	informovat
informovat	informel
inicialisovat	nainicialisovat,doinicialisovat,zinicialisovat,přeinicialisovat,rozinicialisovat,odinicialisovat,reinicialisovat
injekce	injektovat
injektovat	injekce
inkompatibilní	kompatibilní
inkompetence	kompetence
insolvence	solvence
intarzie	intarzovat
intarzovat	intarzie
intendance	intendant
intendant	intendance
interes	interesent
interesent	interes
interna	interní,internovat,internet
internet	interní,internovat,interna
internovat	interna,interní,internet
interní	interna,internovat,internet
intimní	intimovat
intimovat	intimní
intrika	intrikařit
intrikařit	intrika
intrudovat	intruze
intruze	intrudovat
inventarisovat	zinventarisovat
inventovat	inventář
inventář	inventovat
involovat	involvovat
involvovat	involovat
inženýr	bioinženýr
ion	iont
ionisovat	zionisovat,deionisovat
iont	ion
iris	irisovat
irisovat	iris
italika	Itálie
jachta	jachtařit,vachta
jachtařit	zajachtařit,jachta,vachtař
jak	vak
jakobita	jakobín
jakobín	jakobita
janičár	janičář
janičář	janičár
jarý	Jar
jatky	Jáva
jazyk	jazyčný
jazyčný	jazyk
jed	jez
jediný	ujedinit
jedle	Jedlov
jednat	jednička,jednota
jednička	jednat,jednota
jednosměrka	zjednosměrnit
jednota	jednat,jednička
jelen	Jelena,jelenář,Velen
jelenář	Jelena,jelen
jemný	zájemný
jesen	Jesenin
jet	jít,jetel
jetel	jet
jez	jed,bez,jezovita
jezovita	jez
ječmen	zječmenit
ješitný	zješitnět
jih	jihnout,jiný
jihnout	jih
jiný	jíní,Jinek,oj,jih
jistý	jíst
jitrnice	jitro
jitro	jitřit,jitrnice
jitřit	jitro
jiřina	Jiří
jod	Joza
johanita	Johan
jonák	Jon
jorkšír	yorkšír
judo	Juda,Judea
junák	Junona
justice	Just,justovat,Justýna
justovat	justice,Just
juta	Jut
jíní	jiný,Jinek,jít,oj
jíst	jistý
jít	jet,jíní
kabel	kabela
kabela	kabel
kabonit	kabonět
kabonět	kabonit
kabát	překabátit
kachna	Kachyňa
kacéř	kacíř
kacíř	kacéř
kadence	dekadence,kadet
kadet	kadit,kadence
kadit	dokadit,kadet,kazit
kakao	kakat,káva
kakat	kakao,káva,kat
kalich	kalit
kalit	Kalinin,kalich
kameňák	Kamený,Kamenec
kamna	Kamený,Kamenec
kampan	kampaň
kampaň	kampan
kanava	Kanak,Kanaán
kandidovat	kandidát
kandidát	kandidovat
kanec	Kanaán,Kanak,kanout,kanovník,kanár,kanál
kanout	Kant,Kanak,kanec,kánoe,Kanaán,kanár
kanovník	Kanaán,kanec
kanton	kantýna
kantor	kantořit
kantořit	kantor,Kantor
kantýna	kanton,Kant
kanál	Kanaán,kanec
kanár	kanec,Kanada,kanout
kapela	kapelničit
kapelničit	kapela
kapitalisovat	zkapitalisovat
kapitola	Kapitol,kapitála,kapitula
kapitula	kapitola,kapitála
kapitál	kapitála,kapitán,Kapitol
kapitála	kapitál,kapitola,kapitula
kapitán	kapitál
kapka	Kap
kapsa	Kap
kapuca	kapuce
kapuce	kapuca
kar	Ikar
karate	kárat
karban	karbanit
karbanit	karban
karbon	karbonář,karbonát
karbonatit	karbonát
karbonát	karbonář,karbon,karbonatit
karbonář	karbonát,karbon
karta	kartáč,Karter
kartel	Karter
karton	kartón
kartáč	karta
kartón	karton
kasa	Kasák,kasat
kasat	Kasák,kasa
kasta	kastle
kastle	kasta
kat	kát,káva,katit,kakat
katalogisovat	zakatalogisovat,zkatalogisovat
katit	kat,kát
kazit	kázat,kadit
kaše	kašna
kašna	kaše
kaštan	kaštanář
kaštanář	kaštan
kelt	Kelč
kečup	kečupář
kečupář	kečup
kiks	viks,iks,kiksat
kiksat	kiks
klacek	klátit
kladný	Kladno,kláda
klamat	sklamat
klas	klasika,klasikář
klasicisovat	zklasicisovat
klasika	klasikář,klas
klasikář	klasika,klas
klavír	klavírník
klavírník	klavír
klec	kleč,klen
klen	klenout,klenot,klec
klenot	klenout,klen
klenout	klen,klenot
klepat	Klepáč,klepeto
klepeto	klepat
klesat	vklesat
klevetit	klevetný
klevetný	klevetit
kleč	klečet,klec,klíč,Klíč
klečet	kleč
kleštit	kleště
kleště	kleštit
klid	klidit
klidit	klid
klih	klihař
klihař	klih
klihovatět	zklihovatět
klika	klikat
klikat	klika
klima	Klimák,Klíma,Klimek
klimatisovat	zaklimatisovat,překlimatisovat,doklimatisovat,přiklimatisovat,odklimatisovat
klinika	klinkat
klinkat	klinika
klofat	rozklofat
klon	klonit
klonit	klon
klopotat	klopotit
klopotit	naklopotit,klopotat
klovat	eklovat
klub	klubko
klubko	klub
kluk	klučit,Klučov
klusat	Klusák
klučit	Klučov,kluk
kláda	kládat,kladný,Kladno
kládat	kláda,dokládat,zakládat,vykládat,vynakládat,překládat,ukládat,donakládat,přikládat
klát	klátit
klátit	klát,Klatovy,klacek
klímat	Klíma
klín	klínit
klínit	klín
klít	Klíč,klíč
klíč	klít,kleč
klíště	Klíš
kmen	kmín
kmotrovatět	zkmotrovatět
kmín	kmen,nakmínovat
knot	okno
koala	koalice
koalice	koala
kohout	kohoutit
kohoutit	kohout,Kohout
koka	kočí,kočka,Koč,kokos,kočár
kokos	koks,kos,koka
koks	kokos
kolekce	kolektiv
kolektiv	kolekce
koleno	Koleč
kolo	kolona,kůl
kolona	kolonie,kolo,koloniální
kolonie	kolona,koloniální
kolonisovat	zkolonisovat
koloniální	kolonie,kolona
kolovrat	kolovrátkář
kolovrátkář	kolovrat
komercialismus	zkomercialisovat
komihat	komíhat
komika	komise
komise	komika
komparovat	komparz
kompars	komparz
komparz	kompars,komparovat
kompatibilní	inkompatibilní
kompensovat	rekompensovat
kompetence	inkompetence
komplement	komplementář,kompliment
komplementář	komplement
kompliment	komplement
komposice	kompost
kompost	kompot,komposice
kompot	kompost
komprese	kompresovat
kompresovat	komprese
kompromis	kompromisník
kompromisník	kompromis
komunismus	komunita,neokomunizmus,zkomunisovat
komunita	komunismus
komíhat	komihat
konat	konec,koňak
koncese	koncesovat,konec
koncesovat	koncese
kondensovat	zkondensovat
konec	konat,kůň,konev,koncese
konev	konec,kůň
konfekce	konfekcionář
konfekcionář	konfekce
konfigurovat	samokonfigurovat
konkretisovat	zkonkretisovat
konkrétní	zkonkrétnit,zkonkrétnět
konservovat	zakonservovat,zkonservovat
konstanta	Konstantin
konstituce	konstituovat
konstituovat	konstituce
konstruktivismus	konstruktivistický
konstruktivistický	konstruktivismus
konsumovat	dokonsumovat,vykonsumovat,prokonsumovat,přikonsumovat,rozkonsumovat
kontinuovat	kontovat,konto
konto	kontovat,kontoár,kontinuovat
kontovat	konto,kontinuovat,kontoár
kontoár	kontura,konto,kontovat
kontrakt	kontrast
kontrast	kontrakt
kontura	kontoár
konvence	konvencionální,konvenovat
konvencionální	konvence
konvenovat	konvence
konverse	konversovat
konversovat	konverse
konzervativní	zkonzervativnět,neokonzervativní
kopa	kopí,kopt,kopie,Kopač
kopat	Kopač,kopec
kopec	Kopeč,kopit,kopat
kopie	kopit,kopa,kopí
kopit	kopie,kopec,Kopeč,kopí
kopt	koptit,kopčit,kopa
koptit	kopt,kopčit
kopí	kopčit,kopa,Kopeč,kopit,kopie
kopčit	kopí,koptit,kopt
kora	kůra,Korák
kord	akord,korzo
korec	Korea
korekce	korektní
korektní	korekce,korektura
korektura	korektní
korepetitor	korepetitovat,korepetovat
korepetitovat	korepetovat,korepetitor
korepetovat	korepetitovat,korepetitor
korsovat	Korsika
koruna	stokoruna
korupce	korupčník
korupčník	korupce
korzo	korzár,kord
korzár	korzo
korál	korálkář
korálkář	korál
kos	Kosovo,kosý,kosa,kosíř,Kosák,kost,kokos
kosa	kosý,Kosák,kost,kos,Kosovo
kosmologie	seismologie
kosmopolita	kosmopolitický
kosmopolitický	kosmopolita
kost	Kůst,košt,kosa,kosý,kos,koza,koště,kostkář
kostel	Kostelný,kostelničit
kostelničit	kostel,Kostelný
kostkář	kost
kosíř	kos
kosý	kosa,kos,Kosák,kost
kotel	kotit,Kott,kotník
kotit	kotel
kotník	Kott,kotel
kotouč	Kotoul
kotovat	Kott
koupat	koupit
koupit	koupat
kout	kouč
kout	kouč
kouč	kout,kout
kov	Kováč,Kovač
koza	kozák,Kozár,kost,Kůst
kozák	koza
kočka	Koč,kočí,kočár,koka
kočár	kočka,Koč,koka
kočí	Koč,kočka,koka
koňak	konat
koňařit	Koňařík
kořen	kořit
kořist	Kořista,kořit
kořit	kořen,kořist
koš	rozkoš,Košík
košatý	Košatka
košt	koště,kost,Kůst
koště	košt,Košta,kost
krabice	zakrabit
krakat	krákat
kravata	Kravák
kravál	Kravák
krejčí	Krejčík
krepatět	zkrepatět,krepovatět
krepovatět	krepatět
kritika	diakritika
kritisovat	zakritisovat,zkritisovat
krize	Krist
krk	Krč,krčit
krkat	vykrkat
krnět	Krn
krojit	okrojit,Kroječ,dokrojit
krok	kročit,krokev
krokev	krok
kronika	kronikařit
kronikařit	kronika
kros	krosna,krosček
krosna	krosnář,kros,krosček
krosnář	krosna
krosček	kros,krosna
kročit	krok,nakročit,zakročit,rozkročit,vykročit
krupař	Krupka
kryptologie	kryptozoologie
kryptozoologie	kryptologie
krystalisovat	vykrystalisovat,zkrystalisovat
krákat	krakat,zakráknout
král	Králík,Královák,Králik
krása	krást
krást	krása
kráter	krátký
krátkokrký	krátký
krátký	kráter,krátkokrký
kráva	Kravák
krčit	Krč,Krčín,krk
kubík	Kubič,Kubin,Kubín
kuchat	Kuchár
kuchyně	Kuchyňa
kudla	Kudlák,kudlat
kudlat	Kudlák,kudla
kulinařit	kulinář
kulinář	kulinařit,kuličkář
kulisa	kulisář
kulisář	kulisa
kuličkář	Kulík,Kulikov,kulinář
kumulovat	akumulovat
kuna	Kunc,Kunka
kupa	kupčit
kupčit	kupa
kur	kura,kurýr,okurka
kura	kur,prokura,kurýr
kurie	Kurily
kurs	Kurš
kurýr	kur,kura
kužel	kuželář
kuželář	kužel
kvapit	překvapit,Kvapil
kvarta	kvartet,kvartýr
kvartet	kvarta,kvartýr
kvartýr	kvarta,nakvartýrovat,kvartet
kvačit	kvák
kvikat	kvíkat
kvák	kvačit
kvíkat	kvikat
květ	květena
květena	květ
kydat	překydat
kyprý	Kypr
kypřit	Kypr
kyselý	Kysela
kyt	kytka,kytičkář
kytara	kytarář
kytarář	kytara
kytičkář	kyt,kytka
kytka	kyt,kytičkář
kádr	kádrovat
kádrovat	kádr
kámen	Kamenec,Kamený
kánoe	kánon,kanout
kánon	kánoe
kápo	Kap
kára	kárat,Káraný,kárný
kárat	Káraný,kára,karate
kárný	Káraný,kára
kát	kat,káva,katit
káva	kát,kat,kakat,kakao
kázat	vokázat,kazit
kýkat	kýč
kýč	kýkat
křapat	křápat
křen	křeč
křepelka	Křepela
křest	křeček,křeč
křeč	křeček,křivý,Křen,křen,křest
křeček	křeč,křest
křik	křivý,Křivák
křivý	Křiva,Křivák,Křivan,křik,křeč
křižovník	Křiž,kříž,Kříž
křápat	křapat
křísit	křísnout
křísnout	křísit
kříž	Křiž,křižovník
kůl	kolo
kůr	kůra
kůra	kůr,kora
kůň	konec,konev
ladit	Lada
lahev	láhev
laicisovat	zlaicisovat
lajdat	lajdačit
lajdačit	lajdat
lak	láčka
lakotit	Lakota
lakýr	lakýrna
lakýrna	lakýr
lampa	lampas
lampas	lampa
lano	Laník,Lange
lasice	laso
laso	lasice
lata	látka,latina,látat,lát,láce
latina	lata,látka
laureát	Laurent
lavice	lavina
lavina	lavice
lačný	láčka
laškovat	Laškov
lať	lát
lebedit	Lebeda
led	Ledeč
lednit	Ledeč
ledví	Ledvina
legalisovat	zlegalisovat
legie	legovat,legista
legista	legie
legovat	legie
lehkomyslný	zlehkomyslnět
lehký	lež
len	Lenin,Lena,lenit,Lennon,léno
lenit	Lenin,Lena,len
lepit	Lepík
leptat	leptař
leptař	leptat
lesnit	nalesnit,dolesnit
letnit	letět,letovat
letovat	Letov,letět,letnit
letět	letovat,Letov,letnit
lev	levý,levný,Levit,level
level	levný,levý,lev
levitovat	Levit
levný	levý,lev,level,Levit
levý	lev,Levit,levný,level
lešení	Leš
lež	lehký
lhůta	Lhota
libý	Libye,Liba
lid	lidnit,Lída
lidnit	lid
likvida	likvidovat,zlikvidnit
likvidovat	likvida
likér	likérník
likérník	likér
lilek	lilie,liliář
lilie	lilek,liliář
liliář	lilie,lilek
linie	linout,linkař
linkař	linkařit,linout,linie
linkařit	linkař
linout	linie,linkař,líný
lis	lísa
list	lísa
litec	litice,Litva,lít,lítý
litice	litec,Litva,litr
litografie	litografovat
litografovat	litografie
litr	litice
liška	lišta
lišta	liška
lob	Lobeč
loděnka	Lodín
log	logika,login
logika	log
login	log
lokalisovat	zlokalisovat
lokat	lokální
lokální	lokat
lombard	Lombardie
lomit	Lomič
los	losos,Loos,nos,Nos
losos	los
loudat	loudit
loudit	loudat
louh	louže
louka	Loučka,Loučný,loučit
loupat	loupit,lupat
loupit	loupat
louskat	luskat
loutka	loutna
loutna	loutka
loučit	Loučka,Loučný,louka,Louny
louže	louh
loď	Lodín
lucerna	Lucern
luh	Lužice,Luženice
lupat	loupat
lupenitý	lupenka
lupenka	lupenitý
luskat	louskat
lustr	lustrovat
lustrovat	lustr
lysat	Lysák
láce	látka,láčka,lát,lata
ládovat	Lada
láhev	lahev
lán	Láník,Laník
lát	látka,látat,láce,látro,lata,lať
látat	lát,látka,lata
látka	lata,lát,láce,látat,latina,látro,láčka
látro	lát,látka
láčka	láce,lak,Lačina,látka,lačný
lék	léč
léno	Lena,len
lézt	nalézt
léč	lék
líc	lícit
lícit	líc
líh	líhnout,líhat
líhat	líhnout,vylíhat,dolíhat,líhňař,líh,rozlíhat,nalíhat
líhnout	líhat,líhňař,líh
líhňař	líhnout,líhat
línat	líný
líný	línat,linout
lípa	lípat
lípat	lípa
lísa	lísat,list,lis
lísat	lísa
lít	lítý,líto,litec,zlít
líto	lítý,lít
lítostnit	zlítostnět
lítý	lít,líto,litec
lízat	Lízal,rozlízat,podlízat
lýko	Lyko
lůj	Lojza
macecha	macek
macek	macecha
magie	Magic
magnet	magnát
magnát	magnet
malina	Mali,Malín
malomyslný	zmalomyslnit
maltárna	Malta
malátný	Malát,Malák
malý	Mali
mamografie	demografie
man	Mann,Manet,mánie,Mání,mánička,manko
mandant	mandát
mandel	mandle,mandl
mandl	mandle,mandel
mandle	mandl,mandel
mandát	mandant
manko	man
maral	maran
maran	maral
mariáš	Maria
mariňák	Maria,Marie
market	Markéta,markovat
markovat	Markovič,market,markýz,markýrovat,Marek
markýrovat	markovat
markýz	markovat
masa	maso,Masný,mast
masař	Masár,Masaj,Masný
masiv	masív
maso	masa
mast	mást,Mastný,Masný,masa
masterovat	Masters
masáž	Masaj
masív	masiv
mat	matka
matematika	tematika
mateř	Mater
matika	matka
matka	mat,matika
matricovat	matrika
matrika	matricovat
maximum	Maxim
mazat	Mazák
mařit	Marie,Maria
mech	mechovatý
mechanisovat	zmechanisovat
mechovatý	mech
med	Méd,Medek
medicina	medicína,Medina,Medicej,medit
medicína	medicina,biomedicína,Medicej
medit	Medina,Medek,meditovat,medicina
meditovat	medit
membrána	zeměbrana
mentalismus	sentimentalismus
menšina	menšit,Menšík
menšit	Menšík,menšina
merk	merčit,Meroe
merčit	merk
metalika	metalista
metalista	metalika
metan	metanář
metanář	metan
metat	zmetat,vymetat
metla	metlář
metlář	metla,pometlář
mezinárodní	zmezinárodnit
meč	míč
migrovat	emigrovat
mikulášenec	Mikuláš
milice	milý,míle,Míla
militarisovat	remilitarisovat
milý	milice,Míla
mimika	mimikry,mimino
mimikry	mimika,mimino
mimino	mimikry,mimika
mina	minuta,Mináč,Mína,minus,Minos,Ming,mince
mince	mina
minimalismus	minimalisovat
minimalisovat	minimalismus
ministr	ministrovat
ministrovat	ministr
minus	Minos,mina,minuta,Mináč
minuta	mina,minus,Mináč,Minos,Mína
misie	mísit,mísa
mléko	mléčit
mléčit	mléko
mnich	Mnichov
mnohonásobek	zmnohonásobit,zmnohonásobnit
mnohý	množný
množný	mnohý
mobilisovat	namobilisovat,vymobilisovat,domobilisovat,zamobilisovat,přemobilisovat,pomobilisovat,zmobilisovat,omobilisovat,promobilisovat,rozmobilisovat,umobilisovat,odmobilisovat,přimobilisovat,demobilisovat
moc	moci
moci	moc
modernisovat	zmodernisovat
modifikovat	dekomodifikovat
modrý	Modra
mok	moč,Močik
moneta	Monet
monografie	fonografie
monopolisovat	zmonopolisovat
montovat	Montana
morfologie	geomorfologie
most	mošt
motor	motorika,motorismus
motorika	motorismus,motor
motorismus	motorika,motor,motorisovat
motorisovat	zmotorisovat,motorismus
motýl	Motýlek,motýlkář,motýlář
motýlkář	motýl,Motýlek,motýlář
motýlář	motýl,motýlkář
moč	mok,Močik,močka,močůvka
močka	moč
močůvka	moč
mošt	most
mravenec	mravenčit
mravenčit	mravenec
mrcasatit	mrcasatět
mrcasatět	mrcasatit
mrskat	odmrskat
mrštit	Mrštík
multiprogram	multiprogramovat
multiprogramovat	multiprogram
muzikologie	etnomuzikologie
muškař	muškát
muškát	muškař
muž	Mužík
mykat	domykat,promykat,přimykat
máchat	Mácha
máma	mámit
mámit	máma
mánie	mánička,man,Mání
mánička	mánie,Mání,man,Mánes
máry	Maryna
mást	mast
mést	místo,Mesa
míle	Míla,mělký,Mílek,milice
mínit	měnit,Mína
mír	mířit
mísa	mísit,Mesa,místo,misie
mísit	mísa,místo,misie
místo	mísit,mísa,město,mést
míč	meč
mířit	mír,měřit
mýt	mýto,mýtit
mýtit	mýt
mýto	mýt
mělký	míle,Mělník,Míla,mělnit,Mílek
mělnit	Mělník,mělký
měnit	mínit,měňavý
městnat	zaměstnat
město	měsíc,místo
měsíc	město
měňavý	měnit
měřit	mířit
nabahňovat	pobahňovat,přibahňovat
nabob	bob,Bob
nabádat	bádat
nacensurovat	zacensurovat,vycensurovat,censurovat,přicensurovat,přecensurovat
nachcat	přechcat,chcát,zechcat
nachomýtat	ochomýtat
nadbíhat	podbíhat,odbíhat
nadcházet	podcházet
nadeběhnout	podeběhnout,předeběhnout
nadlábnout	vydlábnout
nadpraporčík	podpraporčík
nadrat	zadrat
nadzdvihat	nazdvihat,zdvihat
nadzvedat	nazvedat
nadít	vnadit
nahlédat	hlédat,hledat
nainicialisovat	inicialisovat,doinicialisovat,zinicialisovat,přeinicialisovat,rozinicialisovat,odinicialisovat,reinicialisovat
naklopotit	klopotit
nakmínovat	kmín
nakolejit	vykolejit
nakrakonošovat	dokrakonošovat,Krakonoš
nakročit	zakročit,kročit,vykročit,ukročit,přikročit
nakvartýrovat	kvartýr
nakárovat	zkárovat
nalejvat	přelejvat
nalesnit	lesnit
nalodit	přelodit
nalétat	nalétnout
nalétat	nalétnout
nalétnout	nalétat,nalétat,vylétnout
nalézt	lézt
nalíhat	zalíhat,líhat
nalítnout	přelítnout,zalítnout
namanout	vymanout,zamanout,zmanout
namobilisovat	mobilisovat,pomobilisovat,zamobilisovat,vymobilisovat,domobilisovat,přemobilisovat,zmobilisovat,omobilisovat,promobilisovat,rozmobilisovat,umobilisovat
namokat	zamokat
namrzat	vymrzat,zamrzat
namátnout	pomátnout,zmátnout
namáčknout	vymáčknout
namítat	vymítat
napchat	zapchat
napodobit	zpodobit,vypodobit,vypodobnit
napomínat	zapomínat,opomínat,pozapomínat,připomínat,vzpomínat
naprat	uprat
napuchnout	puchnout
napájet	pájet
napřahat	vypřahat,zapřahat,odpřahat,přepřahat
naschránit	uschránit,schránět
naskýtat	skýtat,vyskýtat
naslepičit	Slepička,slepičář
nasmrádnout	vysmrádnout
nastabilisovat	stabilisovat,zastabilisovat,ustabilisovat,dostabilisovat,přistabilisovat
nastehnout	zastehnout,přistehnout
nastrukturalisovat	strukturalisovat,dostrukturalisovat,zastrukturalisovat
nastýlat	zastýlat,ustýlat,vystýlat,přestýlat
nastřihat	střihat,zastřihat,dostřihat,přestřihat,přistřihat,vostříhat,nastříhnout,odstřihat
nastříhnout	stříhnout,ustříhnout,přestříhnout,zastříhnout,dostříhnout,vostříhat,nastřihat
nasynchronisovat	usynchronisovat,dosynchronisovat,přisynchronisovat,přesynchronisovat,sesynchronisovat,synchron,resynchronisovat
nasystematisovat	systematisovat,dosystematisovat,přesystematisovat,rozsystematisovat
naturalisovat	znaturalisovat
naturismus	turismus
nauhličit	zuhličit
navaselinovat	vaselinovat,dovaselinovat
navitaminisovat	vitaminisovat,zvitaminisovat,ovitaminisovat,odvitaminisovat,dovitaminisovat
navlhat	zavlhat,vlhat
navléknout	navlíknout,vyvléknout
navlíknout	zavlíknout,navléknout
navrtit	vyvrtit,zavrtit
navykat	vykat
nazdvihat	nadzdvihat,zdvihat,nazdvíhat
nazdvíhat	nazdvihat
nazvedat	zvedat,nadzvedat,přizvedat
načrtat	črtat
načít	začít,začít,začít,zaonačit,čít,počít
naškicnout	oškicnout,doškicnout,přeškicnout
našpekovat	vyšpekovat
neckař	necky
necky	Nick,nový,neckař,Nat,nit,nést
negativní	znegativnět
nehet	nehetnatý
nehetnatý	nehet
neobolševik	bolševik
neofašismus	fašismus,novofašismus
neogaullista	gaullista
neohegelovský	novohegelovský
neoklasický	novoklasický
neokomunizmus	komunismus
neokonzervativní	zkonzervativnět,konzervativní
neonacionalismus	neonacismus
neonacismus	neonacionalismus
neonatologie	etologie
neosurrealizmus	surrealismus
nervóza	nervóznit
nervóznit	znervóznět,nervóza
neutralisovat	zneutralisovat
nevěrec	nevěrník
nevěrník	nevěrec
nešťastník	znešťastnět
nikl	Nick
niob	Ob
nit	nový,Nick,nítit,ničit,znít,Nil,Novák,Nat,nitro,necky
nitrace	Nitran,nitro
nitro	nitrace,nit
nivelizovat	nivelovat
nivelovat	novela,nivelizovat
ničit	nit,Nick
nobilis	nobilisovat
nobilisovat	nobilis,znobilisovat
nok	dok
nora	Nor,donor
norma	Norman
normalisovat	donormalisovat,přenormalisovat,pronormalisovat,znormalisovat
nos	los
nouze	Zuza
novela	Vela,nivelovat
novelisovat	znivelisovat
novinařit	vinařit
novofašismus	neofašismus
novohegelovský	neohegelovský
novoklasický	neoklasický
novoplatonský	Platon
nový	Novák,nit,Nick,Nat,necky,Onan,Nil,Don,zen,vně,znít
nuda	nudle
nudle	nuda
nynat	Nat
nádoba	doba
nápoj	nápojář
nápojář	nápoj
národohospodář	vodohospodář
národopis	rodopis
násilnit	posilnit,zesilnit
násobit	dvojnásobit,působit
nést	necky
nítit	nit,zanítit,vznítit,roznítit,znít
nýt	výt
nýt	výt
obdukovat	subdukovat
obec	Ob
obejvat	bejvat
obhlédat	zhlédat,rozhlédat
objasnit	zjasnit
oblbit	zblbit
obohatit	bohatý
obrana	brána
obíhat	dobíhat,probíhat,odbíhat,ubíhat,zbíhat
oběsit	zběsit,vyběsit,běs
ocel	Vocel
ochcat	prochcat,chcát,vochcat,přechcat,zechcat
ochlupit	odchlupit
ochládat	prochládat,zchládat
ochmýřit	zachmýřit
ochomýtat	nachomýtat
ochrnout	poloochrnout
ochutit	dochutit,přichutit,přechutit
ocitat	procitat
odautomatisovat	zautomatisovat,doautomatisovat,automatisovat,přeautomatisovat
odblešit	zablešit
odbožštit	zbožštit
odbuzovat	dobuzovat
odbíhat	podbíhat,nadbíhat,obíhat
odcensurovat	zcensurovat,docensurovat,censurovat,vycensurovat,procensurovat,rozcensurovat,zacensurovat
odchlupit	ochlupit
odchlípit	rozchlípit
odcukernit	vycukernit,zcukernit,zcukernět
odcírkevnit	zcírkevnit
oddivadelnit	zdivadelnit
oddupat	dupat
odebíhat	podeběhnout
odendat	rozendat
odeprat	předeprat
odeslat	předeslat
odestlat	podestlat
odestýlat	podestýlat
odestřít	podestřít
odinicialisovat	doinicialisovat,rozinicialisovat,inicialisovat,zinicialisovat,nainicialisovat,reinicialisovat,přeinicialisovat
odjednoznačnit	zjednoznačnit
odklimatisovat	doklimatisovat,zaklimatisovat,klimatisovat
odkládat	dokládat,rozkládat,předkládat,přikládat
odkrouhnout	zkrouhnout,okrouhnout,zakrouhnout
odkrvit	vykrvit,zkrvit
odkvítat	zkvítat,dokvítat,rozkvítat
odkysličit	okysličit,prokysličit
odkřemenit	zkřemenět
odkřesťanit	odkřesťanštit
odkřesťanštit	odkřesťanit
odlehčit	vylehčit
odlistit	zalistit,olistit,odlistnit
odlistnit	odlistit
odlétnout	podlétnout,podlétávat,předlétnout
odlítat	přilítat
odmetat	podmetat
odmobilisovat	omobilisovat,vymobilisovat,zmobilisovat,umobilisovat,domobilisovat,rozmobilisovat,promobilisovat,mobilisovat,demobilisovat,zamobilisovat,přimobilisovat,přemobilisovat,pomobilisovat
odmrskat	mrskat
odmíchat	podmíchat
odmítat	omítat
odmývat	podmývat
odnacisovat	znacisovat
odnárodnit	znárodnět
odolat	udolat,zdolat
odplevelit	plevelit
odpovědný	opovědný
odprdelit	vyprdelit,uprdelit
odprůmyslnit	zprůmyslnit,zprůmyslnět
odpínat	podpínat,předpínat,rozpínat
odpřahat	vypřahat,spřahat,zapřahat,rozpřahat,připřahat,přepřahat,napřahat
odpřírodnit	zpřírodnit
odrat	prodrat,udrat,drát,drát
odresonovat	zresonovat,doresonovat,vyresonovat
odsadit	podsadit,sadit
odsedat	dosedat
odsignalisovat	signalisovat,dosignalisovat,zasignalisovat,prosignalisovat
odsrat	usrat,přesrat,přisrat,dosrat
odstředit	středit
odstřihat	dostřihat,střihat,nastřihat
odtučnit	vytučnit
odtínat	podtínat,roztínat
odundat	zadundat,vydundat
oduševnit	produševnit,zduševnit,zduševnět
odvitaminisovat	ovitaminisovat,dovitaminisovat,zvitaminisovat,vitaminisovat,přivitaminisovat,navitaminisovat
odvlíknout	zavlíknout,dovlíknout
odvykat	vykat
odvzdušnit	vzdušnit
odzemkář	pozemkář
odzírat	vyzírat,zírat
odželezit	odželeznit
odželeznit	odželezit
oficiant	oficiální,oficiál
oficiál	oficiální,oficiant
oficiální	oficiál,oficiant
oflitrovat	flitrovat,poflitrovat
ohloupit	prohloupit
ohlášet	vyhlášet
ohlédat	hlédat,zhlédat,dohlédat,prohlédat,uhlédat,vyhlédat,hledat,zahlédat
ohrubovat	vyhrubovat,zhrubit,zhrubět
ohvězdit	vyhvězdit,ohvězdnit,zhvězdit
ohvězdnit	ohvězdit
oháknout	vyháknout
oj	vně,ujec,Nat,jíní,jiný,voj,ovce,zajíc,vát
okno	knot
oko	cé,sto
okrojit	dokrojit,prokrojit,krojit
okrouhnout	zkrouhnout,zakrouhnout,odkrouhnout
okrvavit	zkrvavit,ukrvavit,dokrvit,zakrvavit
oktan	oktáva
oktáva	oktan
okurka	kur
okus	okusit
okusit	zkusit,okus,zakusit
okysličit	prokysličit,odkysličit,překysličit
okřídlit	rozkřídlit,zakřídlit
olistit	odlistit,zalistit
olovo	Ola
omdlet	zmdlet
omobilisovat	umobilisovat,promobilisovat,zmobilisovat,odmobilisovat,domobilisovat,zamobilisovat,mobilisovat,vymobilisovat,pomobilisovat,rozmobilisovat,přemobilisovat,namobilisovat,přimobilisovat,vmobilisovat
omrzat	promrzat,zmrzat,umrzat
omráčit	zmráčit
omítat	promítat,odmítat
onikat	vnikat,unikat,pronikat,znikat,zanikat,vynikat
op	Pop,pop,upír,Sup
opak	opakovat,pak,Opasek
opakovat	opak
opat	pat
operovat	opeřit
opeřit	zpeřit,vypeřit,operovat
oplavovat	plavat,vzplavovat
oploštit	zploštit,sploštit,oploštět,zploštět
oploštět	zploštět,oploštit,zploštit
opláchnout	pláchnout,propláchnout,vypláchnout,spláchnout
opláknout	upláknout,vypláknout
opláštit	přepláštit
oplítat	proplítat,uplítat,zaplítat,přeplítat,splítat,rozplítat,vyplítat,doplítat,připlítat,vplítat
opomínat	napomínat,zapomínat,pozapomínat,připomínat
oponovat	proponovat,suponovat
opora	rozpora,prapor
opovrhat	povrhat
opovědný	odpovědný
oprostit	zprostit,zprostit,vyprostit,sprostit
optimalisovat	zoptimalisovat
opylit	zapylit
opál	opálka
opálka	opál
opět	zpět,pět
opřádat	zapřádat,upřádat,dopřádat,vypřádat,rozpřádat,spřádat,vpřádat
orace	orat,orátor
orat	orace,orátor,proorat
orchestr	orchestrovat
orchestrovat	orchestr
ordinovat	ordinář
ordinář	ordinovat
organik	organizovat
organisovat	reorganisovat,přeorganisovat,zreorganisovat,zorganisovat
organizovat	organik
orient	orientovat
orientovat	orient
orloj	orlojář,Orlov
orlojář	orloj
ornament	ornamentální
ornamentální	ornament
orodovat	orodovník
orodovník	orodovat
orátor	orat,orace
osa	vosa,rosa
osemenit	vysemenit
osev	Oset
osivo	sivý
osliznout	přisliznout
oslnit	zaslnit
osma	Osman
osobit	usobit
ostat	dostat
ostrov	ostrý
ostruha	struha
ostrý	ostrov
osud	sud,soda
osvětář	Osvětim,světnice
osychat	dosychat,prosychat,osýchat,přisychat,sesychat,rozsychat,zasychat,vysychat,dosýchat,přesychat,prosýchat,rozesychat,přisýchat
osýchat	dosýchat,prosýchat,osychat,usýchat,přisýchat,rozsýchat,vysýchat,dosychat,přesýchat,zasýchat,prosychat
otec	Ota,Telč,tele,cé
otep	tep
otipnout	tipnout
otleskat	tleskat
otrok	strok
otrsat	trsat
otruby	Votruba
out	dout,zout
ovadat	uvadat,zavadat,zvadat,povadat
ovce	vně,oj,cé,Vey,vát,zet
oves	ves,ověs
ovitaminisovat	dovitaminisovat,vitaminisovat,odvitaminisovat,přivitaminisovat,zvitaminisovat,navitaminisovat
ověs	oves
ozdravět	zdravět
ozvláštnit	zvláštňovat
ozón	zóna
očurat	čurat
ořech	Ořechov
ošatka	Košatka
oškicnout	doškicnout,naškicnout,přeškicnout,skicnout
ošklíbat	pošklíbat,ušklíbat,zašklíbat,vyšklíbat
ošpláchnout	vyšpláchnout,špláchat
oťupat	ťupat,poťupat
oždibovat	vyždibovat
ožehat	vyžehat,zažehat,vžehat
ožvykovat	požvykovat,užvykovat,rozžvykovat
pac	Pacov
pacht	pachtit
pachtit	pacht
pacifikovat	Pacifik
padat	vypadat
pak	opak,Pásek
pakt	pást,Paka,past
palatin	Palata,palatála
palatála	Palata,palatin
palec	palice
paleničář	páleničář
palice	Palin,Palec,palec,pálit
palác	Palata,Palán
pan	pán,propan,pánev
panašovat	pašovat
panel	pánev
panika	Panák
panorama	panoráma
panoráma	panorama
panoš	Panuš
papat	papá,papája,Papák
papá	papat,papája,Papák
papája	papá,papat
papír	pápěra
parafin	parafín
parafín	parafin
paralysovat	zparalysovat
parazit	parazitit
parazitit	parazit
parkovat	párkář
parodie	parodont
parodont	parodie
part	parta,partie,parter
parta	part,Sparta,partie,Parth,partner
parter	partie,part
partie	part,parta,parter
partner	partneřit,parta
partneřit	partner
paráda	parádovat
parádovat	paráda
pas	pás,zápas,pasovat
pasivní	pasivovat,zpasivnit,pasovat
pasivovat	pasivní
pasovat	pas,pasivní
pasparta	Sparta
past	pást,pasta,pastvit,pakt
pasta	past,pastvit,pást
pastorovat	Pastor
pastvinář	pastvit
pastvit	pasta,past,pastvinář
pat	pata,opat,pátek,zupat,supat
pata	Zapata,pat,patina,pátek
patent	patentář
patentář	patent
patetika	patina
patina	pata,patetika
patro	patrona,pátrat,patron
patrola	patrona,patron
patron	patrona,patro,patrola
patrona	patron,patro,patrola
pavlač	Pavlát,Pavlov
pazderník	Pazdera
paňák	Panák
paša	pašák
pašovat	panašovat
paštika	Pašta
pašák	paša
pažit	vypažit
pec	Peck,pecka,Pecina
pecka	Peck,pec,Pecina
pelichat	přepelichat
pendl	pendlovat
pendlovat	pendl
pendrek	pendrekář
pendrekář	pendrek
pentan	pentle
pentle	pentan,pentlit,penále
pentlit	pentle
penze	peníz
penále	pentle
peníz	penze
pepa	pepř
pepř	Pepa,pepa
percipovat	apercipovat
pernikář	perník
perník	pero,pernikář
pero	perník,Peřina,Perout
persekuovat	perzekuovat
persiflovat	zpersiflovat
perzekuovat	persekuovat
pes	pesík
pestřit	zpestřit,zpestřet
pesík	pes
petržel	Petržela,Petržil
pevný	zpevnět
piano	Piave
pikantní	zpikantnit,zpikantnět
pikart	zpikartit
pikat	pikovat,piknik
pikhart	zpikhartit
piklit	piklovat
piklovat	piklit
piknik	pikat,pikovat
pikovat	pikat,piknik
pila	píle,Pilát
pindat	rozpindat
pivoň	Pivoňka
placatý	plácat,poplacat,zplacatit,zplacatět
plachta	Placht,plachtařit
plachtařit	plachta
plakat	plakát
plakát	plakat
plantat	plantáž
plantáž	plantat
plasknout	splasknout
plast	plastika
plastika	plast
platina	platit
platit	platina
platonik	Platon
plavat	oplavovat,zplavnit
plemenit	plemeno
plemeno	plemenit
plena	plenit,plenta,plečka
plenit	plena
plenta	plena
pleskat	plískat
plevelit	odplevelit
plečka	plečkař,plést,Plečnik,plena
plečkař	plečka
plnomocný	zplnomocnit
pluh	plužit
plužit	pluh
plyn	plynit,zaplynout
plynit	zplynět,plyn
plácat	placatý,poplacat
pláchnout	vypláchnout,opláchnout,propláchnout,spláchnout
plán	Plánka,Plávka
plát	plátno
plát	plátno
plátno	plát,plát,Plávka
plést	plečka
plíce	plít,plít
plíseň	plísnit
plískat	pleskat
plísnit	plíseň
plít	plíce,záplet
plít	plíce,záplet
pneumatika	pneumatizovat
pneumatizovat	pneumatika
pnout	pnít
pnít	pnout
pobahňovat	nabahňovat
pochroumat	zchroumat
pochvístnout	vychvístnout
pocpat	procpat,docpat
podbíhat	nadbíhat,odbíhat
podcházet	nadcházet
podeběhnout	odebíhat,nadeběhnout
podestlat	odestlat
podestýlat	odestýlat
podestřít	odestřít
podhorák	Podhora
podjímat	rozjímat
podloudničit	podloudný
podloudný	podloudničit
podlétnout	odlétnout,podlétávat
podlétávat	podlétnout,odlétnout
podlízat	lízat
podlý	zlý
podmetat	odmetat
podmíchat	odmíchat
podmítka	podmět
podmývat	odmývat
podmět	podmítka
podolí	dole
podplítat	vyplítat,proplítat,zaplítat,doplítat
podpořit	spořit
podpraporčík	nadpraporčík
podpínat	odpínat,předpínat,rozpínat
podsada	podsadit
podsadit	podsada,odsadit
podsekretář	sekretář
podtínat	odtínat
podvléknout	provléknout,vyvléknout
poetolog	etologie
poevropštit	zevropštit
poflitrovat	oflitrovat,flitrovat
pohan	Johan
pohodnout	dohodnout,rozhodnout
pohár	požár,Požár
pokatoličit	pokatoličtit
pokatoličtit	pokatoličit,zkatoličtit
poker	pokérovat
poklekat	přiklekat,zaklekat
pokérovat	poker
polarisovat	zpolarisovat
polda	poldovák
poldovák	polda
pole	polní,Polsko,police,půl
poledne	Poledník
polehat	poléhat
polemisovat	zapolemisovat
poleno	Polena
police	policie,políček,pole,Polsko
policie	police
polní	pole,polovat,Polsko
poloochrnout	ochrnout
polovat	polní
poléhat	polehat
polétat	zapolétat,popolétnout
políknout	zalíknout,políček
políček	police,políknout
polštář	vypolštářit
pomejšlet	domejšlet,promejšlet
pometlář	metlář
pomník	pomníkář,pomnít
pomníkář	pomník
pomnít	pomník,zapomnět,pomněnka
pomněnka	pomnít
pomobilisovat	mobilisovat,domobilisovat,namobilisovat,zmobilisovat,rozmobilisovat,omobilisovat,promobilisovat,zamobilisovat,přemobilisovat,vymobilisovat,umobilisovat,odmobilisovat,přimobilisovat
pomologie	etymologie
pomoučit	zmoučit
pompa	pumpa
pomátnout	namátnout,zmátnout
ponoukat	poňoukat
poník	Pozník,poníkář,Nick
poníkář	poník
poněmčit	zněmčit
poohlížet	zahlížet
pop	op
popel	popelka
popelka	Popel,popel
poplacat	placatý,zplacatět,zplacatit,plácat
popolétnout	polétat
popolštit	zpolštit
poposedat	posedat
popostoupit	stoupit
popularisovat	zpopularisovat
populární	zpopulárnit,zpopulárnět
porce	port
porichtovat	zrichtovat
porota	porotce
porotce	porota
port	porta,porce
porta	Portnoy,port
portugal	Portugalsko
poruštit	zruštit
posedat	dosedat,poposedat,přisedat
posilnit	násilnit
poslat	doslat
posmekat	smekat
pospat	spát
pospíchat	spíchat,spěchat
pospíšit	uspíšit,přispíšit
postlat	dostlat
postupný	postupář
postupář	postupný
postřehnout	zastřehnout,ustřehnout,vystřehnout
posunek	posuněk
posuněk	posunek
posíknout	síknout
pot	půst,cé,Nat,Poe
potakat	přitakat
potentovat	vytentovat,utentovat
potkat	protkat,vytkat
poturčenec	poturčit
poturčit	poturčenec
poustevna	Pousta
pouto	pouť
pouzdrař	pouzdřit
pouzdřit	pouzdrař
pouť	pouto
povadat	uvadat,ovadat
povrhat	vrhat,zvrhat,opovrhat,vyvrhat
povrtit	dovrtit,uvrtit
povíjet	víjet
pozapomínat	zapomínat,opomínat,napomínat,připomínat
pozdě	Pozdník
pozemek	pozemský
pozemkář	odzemkář
pozemský	pozemek
pozemštit	zpozemštět
pozor	dozor,vzor
pozápadnit	pozápadnět
pozápadnět	pozápadnit,znápadnět
pozřít	zřít
počít	načít,čít,začít,začít,začít
poňoukat	ponoukat
pořad	řad
pořečtit	zřečtit
pošklíbat	ošklíbat,ušklíbat,vyšklíbat,zašklíbat
pošušňat	ušušňat
pošvihat	švihat
pošťouchat	šťouchat
poťupat	oťupat,ťupat
požitkařit	požitkář
požitkář	požitkařit
požrat	užrat,žrát
požvykovat	ožvykovat
požár	žár,pohár
pradlář	prádlař
prahnout	zapráhnout,Praha,zpráhnout,hnout
prapor	opora
praskat	práskat
pravděpodobný	zpravděpodobnit
pravovárečný	právovárečný
pravý	Praj,prát
praštit	praštět
praštět	praštit
precisovat	zaprecisovat,vyprecisovat,rozprecisovat,doprecisovat
predikovat	předikovat
premiér	premiéra
premiéra	premiér
prim	prima
prima	primán,prim
primitivní	zprimitivnit
primán	prima
princ	princes
princes	princ
probíhat	obíhat
procensurovat	docensurovat,odcensurovat,zcensurovat,censurovat,vycensurovat,rozcensurovat,zacensurovat
prochcat	ochcat
prochládat	ochládat
procitat	ocitat
procpat	pocpat,docpat,přicpat
procuraindosament	prokuraindosament
procviknout	ucviknout,přecviknout
prodrat	odrat,proorat
produchovnit	produchovnět,zduchovnit
produchovnět	produchovnit,zduchovnět
produševnit	oduševnit,zduševnit
profesionalisovat	zprofesionalisovat,profesionál
profesionál	profesionalisovat
program	gram
progres	progrese
progrese	progres
prohloupit	ohloupit
prohlédat	ohlédat,hlédat
projasnit	zjasnit
projekce	projekt
projekt	projekce
proklamovat	deklamovat
proklubnout	zaklubnout
prokonsumovat	dokonsumovat,přikonsumovat,rozkonsumovat,konsumovat,vykonsumovat
prokrojit	okrojit,dokrojit
prokrvit	dokrvit
prokura	kura
prokuraindosament	procuraindosament
prokysličit	okysličit,odkysličit,překysličit
prokřemenit	zkřemenět
prolejzat	dolejzat,rozlejzat
proletář	prolétat
prolhat	dolhat
prolétat	proletář
promejšlet	domejšlet,pomejšlet
promobilisovat	omobilisovat,zmobilisovat,umobilisovat,rozmobilisovat,domobilisovat,mobilisovat,zamobilisovat,pomobilisovat,přemobilisovat,přimobilisovat,vymobilisovat,odmobilisovat,namobilisovat
promrazovat	domrazovat
promrzat	omrzat,zmrzat,přimrzat
promykat	promýkat,domykat,mykat,přimykat
promáčknout	rozmáčknout,domáčknout,umáčknout
promílat	domílat,umílat
promítat	omítat
promýkat	promykat
pronikat	onikat
pronormalisovat	donormalisovat,normalisovat,znormalisovat,přenormalisovat
proorat	orat,prodrat
propan	pan,Pan
propláchnout	pláchnout,opláchnout,vypláchnout,spláchnout
proplítat	oplítat,zaplítat,uplítat,vyplítat,doplítat,přeplítat,rozplítat,připlítat,podplítat,splítat
proponovat	oponovat,suponovat
propásnout	pásnout
prorajbovat	vyrajbovat
prorok	rok,úrok
prosignalisovat	signalisovat,dosignalisovat,odsignalisovat,zasignalisovat
prosit	vyosit
prosrat	přisrat,dosrat,přesrat
prostopášný	zprostopášnit
prostoupit	dostoupit,stoupit
prostý	sprostý
prostříkat	stříkat
prosvítat	vysvítat
prosychat	osychat,prosýchat,dosychat,rozsychat,přisychat,zasychat,vysychat,dosýchat,rozesychat,osýchat
prosýchat	prosychat,osýchat,dosýchat,přisýchat,rozsýchat,vysýchat,zasýchat,osychat,usýchat,rozesýchat
proteplit	doteplit,přiteplit
protest	test
protivit	protivný,Protivín
protivný	protivit,Protivín
protkat	potkat
proton	Oton
protýkat	dotýkat,týkat
proud	proudit
proudit	proud,prudit
provaselinovat	dovaselinovat,vaselinovat
provlhat	vlhat,zvlhat,zavlhat
provléknout	vyvléknout,podvléknout
provoz	provozář
provozář	provoz
provázet	Provázek
províjet	dovíjet,přivíjet,víjet
pročmuchat	dočmuchat,čmuchat,vočmuchat
pročísnout	čísnout
prošedat	ušedat,zšedat
proškrabat	škrábat
prožebrat	žebrat
prudit	proudit
pruh	pružný
pružný	pruh
první	prvý
prvý	první
pryštit	prýštit
práce	prát
práchnivý	zpráchnět
prádlař	pradlář
práh	Praha,zápraž
práskat	praskat
prát	práce,uprat,pravý,přát
právovárečný	pravovárečný
prýmek	prýmka
prýmka	prýmkář,prýmek
prýmkář	prýmka
prýštit	pryštit,prýštět
prýštět	prýštit
prťavý	prťák
prťák	prťavý
průhlednět	zprůhlednit
průsvit	průsvitnět
průsvitnět	zprůsvitnit,průsvit
psout	vsout
pták	ptát
ptát	pták,Pták,uptat
puchnout	napuchnout
puchýřovatět	zpuchýřkovatět
pulsovat	rozpulsovat
pumpa	pumpnout,pompa
pumpnout	pumpa
puncovat	punk,punktovat,punkt,punč
punk	punč,punkt,puncovat,punktovat
punkt	punk,punč,punktovat,puncovat
punktovat	punkt,puncovat,punk
punč	punk,punkt,puncovat
puč	pučit,Puk,pučet
pučet	pučit,puč
pučit	puč,pučet,Puk
puška	Puškin
páchat	vypáchat
pádit	pádlo
pádlo	pádit
pájet	napájet
pálat	pálit
páleničář	paleničář
pálit	pálat,palice
pán	pan,Pan,pánev
pánev	panel,pán,Pan,pan
pápěra	papír
pár	pára,párkář,Párs,pářit,párkař,párat
pára	pár,párat,spára,Párs
párat	pára,pár
párkař	párkář,pár
párkář	párkař,pár,pářit,parkovat
pás	Pásek,pas,pást,pásnout
pásnout	pást,propásnout,Pásek,pás
pást	past,Pásek,pásnout,pakt,pás,pasta
pátek	zpátek,pat,pata
páter	páteř
páteř	páter
pátrat	patro
pářit	pár,párkář
péci	péče,pécéčko
pécéčko	péci,péče
péče	péci,pécéčko
píce	píča,píka,pít,pět
píka	píča,píce,Pikt,píst
píle	pílit,Pila,pila
pílit	píle
písek	píst
pískat	pískař
pískař	pískat
píst	písek,pěst,Pikt,píka
pít	pět,píce,pětník
píča	píka,píce,Pěč,Pikt,zpíčit,vypíčit
pórovatět	zpórovatět
pěna	pěnice
pěnice	pěna
pěst	píst,pěstit
pěstit	pěst
pět	pít,pětník,supět,zpět,píce,opět
pětník	pět,pít
přeautomatisovat	přiautomatisovat,zautomatisovat,automatisovat,odautomatisovat
přebookovat	zabookovat
přebrnkat	brnkat
přebíhat	předebíhat
přecensurovat	přicensurovat,nacensurovat,zacensurovat
přecentralisovat	decentralisovat,centralisovat,zcentralisovat,dodecentralisovat
přechcat	nachcat,zechcat,chcát,ochcat
přechutit	přichutit,ochutit
přecviknout	procviknout
předebíhat	předeběhnout,přebíhat
předeběhnout	předebíhat,nadeběhnout
předek	přední
předeprat	odeprat
předeslat	přeslat,odeslat
předikovat	predikovat
předkládat	vzkládat,dokládat,odkládat,přikládat,vykládat,překládat,rozkládat,ukládat
předlétnout	předlítnout,odlétnout
předlítnout	předlétnout
přední	přesný,předek
předpínat	odpínat,vzpínat,podpínat
předvulkanisovat	zvulkanisovat,zavulkanisovat,vulkanisovat,dovulkanisovat
přegeneralisovat	vygeneralisovat,generalisovat,zgeneralisovat
přehlédat	zpřehledat
přehoupnout	vhoupnout,houpnout
přehvězdit	zhvězdit,vyhvězdit
přeinicialisovat	inicialisovat,reinicialisovat,nainicialisovat,doinicialisovat,zinicialisovat,odinicialisovat,rozinicialisovat
přejezdný	zájezdný
překabátit	Kabát,kabát
překlimatisovat	klimatisovat,přiklimatisovat,zaklimatisovat
překládat	přikládat,zakládat,kládat,předkládat,dokládat,vynakládat,vykládat
překrvit	zakrvit
překvapit	kvapit
překydat	kydat
překysličit	okysličit,prokysličit
přelejvat	nalejvat
přelhat	přilhat
přelodit	nalodit
přelítnout	zalítnout,nalítnout
přemetnout	vymetnout
přemobilisovat	mobilisovat,vymobilisovat,zmobilisovat,přimobilisovat,rozmobilisovat,zamobilisovat,vmobilisovat,namobilisovat,promobilisovat,pomobilisovat,umobilisovat,domobilisovat,omobilisovat,demobilisovat,odmobilisovat
přenormalisovat	normalisovat,pronormalisovat,znormalisovat,donormalisovat
přenáhlit	znáhlit
přeorganisovat	reorganisovat,zreorganisovat,organisovat,zorganisovat
přepelichat	pelichat
přepeřit	zapeřit,vpeřit,vypeřit,zpeřit
přepláštit	opláštit
přeplítat	vyplítat,zaplítat,proplítat,vplítat,oplítat,uplítat,splítat,rozplítat,připlítat
přepodstatnit	zpodstatnit,zpodstatnět
přepásat	připásat
přepírat	vpírat
přepřahat	vypřahat,vpřahat,zapřahat,připřahat,spřahat,odpřahat,rozpřahat,napřahat
přeresonovat	resonovat,zaresonovat
přeslat	předeslat,rozeslat
přesný	přísný,přední,příst,eses
přespecialisovat	zespecialisovat,specialisovat
přespořit	spořit
přesrat	přisrat,zesrat,rozesrat,odsrat,prosrat,srát
přestlat	přistlat
přestýlat	nastýlat,ustýlat
přestřihat	nastřihat,přistřihat,přestříhnout,střihat
přestříhnout	nastříhnout,stříhnout,ustříhnout,přestřihat,zastříhnout,dostříhnout
přesychat	přesýchat,rozesychat,přisychat,sesychat,osychat
přesynchronisovat	přisynchronisovat,nasynchronisovat,sesynchronisovat,resynchronisovat,usynchronisovat,dosynchronisovat
přesystematisovat	systematisovat,dosystematisovat,nasystematisovat,rozsystematisovat
přesýchat	přesychat,rozesýchat,přisýchat,osýchat
přeteplit	vyteplit,přiteplit
převitaminisovat	vitaminisovat,přivitaminisovat,zvitaminisovat
převlek	převlečný
převlečný	převlek
převléknout	vyvléknout
převor	vor
převrhat	vrhat,zavrhat
převíjet	přivíjet,víjet
převýšit	vyvýšit
převčelit	zavčelit
přezvěřit	zazvěřit,zvěř
přečíslit	začíslit
přeřizovat	uperizovat
přeškicnout	oškicnout,naškicnout,doškicnout
přežrat	zažrat
přiautomatisovat	přeautomatisovat,doautomatisovat,zautomatisovat
přibahňovat	nabahňovat
přicensurovat	přecensurovat,nacensurovat
přichutit	ochutit,přechutit,dochutit
přicmrdovat	přicmrdávat
přicmrdávat	přicmrdovat
přicpat	procpat
přiklekat	poklekat,zaklekat
přiklimatisovat	zaklimatisovat,překlimatisovat,klimatisovat,doklimatisovat
přikládat	dokládat,překládat,zakládat,předkládat,skládat,odkládat,kládat
přikonsumovat	prokonsumovat,dokonsumovat,konsumovat,vykonsumovat
přikročit	nakročit,zakročit
přilhat	přelhat
přilítat	odlítat
přimobilisovat	přemobilisovat,zmobilisovat,promobilisovat,umobilisovat,rozmobilisovat,mobilisovat,vymobilisovat,odmobilisovat,zamobilisovat,omobilisovat,pomobilisovat,domobilisovat
přimrzat	promrzat
přimykat	promykat,mykat
připlynout	zaplynout
připlítat	proplítat,zaplítat,oplítat,přeplítat
připodobit	připodobnit,zpodobit,spodobit
připodobnit	připodobit,zpodobnit
připomínat	opomínat,zapomínat,napomínat,pozapomínat
připásat	přepásat
připřahat	zapřahat,přepřahat,spřahat,odpřahat,vypřahat,rozpřahat
přisedat	posedat
přisliznout	osliznout
přispat	přispávat
přispávat	přispat
přispíšit	pospíšit,uspíšit
přisrat	přesrat,prosrat,dosrat,odsrat,zesrat
přistabilisovat	stabilisovat,ustabilisovat,dostabilisovat,nastabilisovat,zastabilisovat
přistehnout	nastehnout,zastehnout
přistlat	přestlat
přistřihat	přestřihat,střihat,nastřihat,dostřihat
přisychat	přisýchat,osychat,přesychat,prosychat,dosychat,sesychat,rozesychat
přisynchronisovat	přesynchronisovat,nasynchronisovat,dosynchronisovat,sesynchronisovat,usynchronisovat,resynchronisovat
přisýchat	přisychat,osýchat,prosýchat,přesýchat,dosýchat,osychat
přitakat	potakat
přiteplit	přeteplit,proteplit
přivitaminisovat	ovitaminisovat,převitaminisovat,dovitaminisovat,vitaminisovat,odvitaminisovat,zvitaminisovat
přivykat	vykat,uvykat
přivíjet	převíjet,províjet,dovíjet,víjet
přizvedat	zvedat,nazvedat
přišlehat	zešlehat
přát	přít,prát
příjemnit	příjemný,zpříjemnět,zjemnět
příjemný	příjemnit
přísnit	přísnět,přísný
přísný	příst,přesný,přísnit
přísnět	přísnit,zpřesnět
příst	přísný,příčit,přít,přesný
přít	přítel,přát,příst,příčit
přítel	přít
příčina	příčit,čina
příčit	příčina,příst,přít
pšoukat	pšukat
pšukat	pšoukat
půl	pole
působit	násobit
půst	vně,Poe,pot,zout,Nat
rab	Ráb,rabi
rabi	rabiák,rabiát,rab
rabiák	rabiát,rabi
rabiát	rabiák,rabi
rachat	ráchat
rada	radovat,Radek,radon,radar
radar	rada
radon	Radouň,rada,radovat
radovat	rada,radon
rafika	rafičit
rafičit	rafika
rajka	ráj
rak	zrak,Rakovník
rameno	ramenář
ramenář	rameno
rande	Randák
raný	rána,ranč
ranč	rána,raný
rap	vrap
ras	rasa
rasa	ras,řasa
realisovat	zrealisovat
recensovat	zrecensovat
recenze	recenzovat
recenzovat	recenze
recepce	recept
recept	recepce
recidiva	recidivovat,recidivismus
recidivismus	recidiva
recidivovat	recidiva
redistribuce	distribuce
reedovat	Reed
reflektant	reflektovat
reflektovat	reflektant
reforma	forma
regrese	agrese
regulovat	regulární
regulární	regulovat
rehabilitovat	habilitovat
rehydrovat	dehydrovat
reinicialisovat	přeinicialisovat,inicialisovat,doinicialisovat,odinicialisovat,nainicialisovat
rejd	rejdit
rejdit	rejd
rek	Řek,rekce
rekce	rek
reklama	reklamovat
reklamovat	reklama
rekompensovat	kompensovat
rekrut	rekrutovat
rekrutovat	rekrut
remilitarisovat	demilitarisovat,militarisovat
remisovat	zremisovat
remíz	remíza
remíza	remíz
renta	rentovat
rentgen	Roentgen
rentovat	renta
reorganisovat	zreorganisovat,přeorganisovat,organisovat,zorganisovat
reparatura	aparatura
repetent	repetovat
repetit	repetovat,repetitor
repetitor	repetit
repetovat	repetit,repetent
reportovat	deportovat
represe	deprese
resonovat	zresonovat,přeresonovat,zaresonovat,rozresonovat,doresonovat,vyresonovat
resynchronisovat	přesynchronisovat,usynchronisovat,nasynchronisovat,přisynchronisovat,dosynchronisovat,sesynchronisovat
ret	retina
retina	retinovat,ret
retinovat	retina
retrahovat	atrahovat
revanš	revanšovat
revanšovat	revanš
revolucionařit	revolucionovat
revolucionisovat	zrevolucionisovat
revolucionovat	revolucionařit
rezerva	rezervoár,rezervovat
rezervovat	rezerva
rezervoár	rezerva
reální	reálný
reálný	reální
rešerše	rešeršovat
rešeršovat	rešerše
rochnit	zarochnout,rochňat
rochňat	rochnit
rodopis	národopis
roh	rohovatý,rohovník
rohlík	rohlíkář
rohlíkář	rohlík,Rohlík
rohovatý	roh,rohovník
rohovník	rohovatý,roh
roj	Rojka,Rojík,ráj
rok	prorok
role	Rol,Rolin
rolničit	rolnička
rolnička	rolničit
rolovat	Rol
román	Roman,Romanov
ronit	Ronov
rosa	osa,vosa
rota	rotovat,routa
rotovat	rota
roubat	roubit
roubit	roubat
roura	rourař
rourař	roura
routa	rota
rozblátit	zablátit
rozbojník	zbojník
rozbolavět	zbolavit
rozbolestnit	zbolestnět
rozbočit	zbočit
rozbydlet	bydlet
rozbíhat	zbíhat,vybíhat
rozbředat	bředat,vybředat,zabředat
rozbřesknout	zabřesknout
rozcensurovat	zcensurovat,odcensurovat,censurovat,procensurovat,docensurovat,vycensurovat
rozchlípit	vychlípit,odchlípit
rozchvátit	zchvátit,vychvátit
rozcitlivit	zcitlivit,rozcitlivět,zcitlivět
rozcitlivět	zcitlivět,rozcitlivit,zcitlivit
rozdout	dout
rozedrat	zedrat
rozendat	odendat
rozeslat	přeslat
rozesrat	zesrat,přesrat
rozesychat	rozesýchat,rozsychat,přesychat,osychat,přisychat,prosychat,sesychat
rozesýchat	rozesychat,rozsýchat,přesýchat,rozsychat,prosýchat
rozgeneralisovat	zgeneralisovat,vygeneralisovat,generalisovat,zageneralisovat
rozhlédat	zhlédat,hlédat,hledat,obhlédat,vyhlédat
rozhodnout	pohodnout
rozhojnit	zhojnit,zhojnět
rozhoupnout	zhoupnout,houpnout,vyhoupnout
rozinicialisovat	zinicialisovat,doinicialisovat,inicialisovat,odinicialisovat,nainicialisovat,přeinicialisovat
rozjařit	zjařit
rozjímat	podjímat
rozklofat	klofat
rozkládat	odkládat,dokládat,předkládat
rozkonsumovat	prokonsumovat,konsumovat,dokonsumovat,vykonsumovat
rozkoš	koš
rozkročit	kročit,vykročit,ukročit
rozkvítat	zkvítat,odkvítat
rozkřídlit	okřídlit,zakřídlit
rozlejzat	prolejzat
rozlíhat	vylíhat,dolíhat,líhat
rozlítit	rozlítnout,zlítit
rozlítnout	rozlítit
rozlízat	lízat
rozmanitý	vymanit
rozmarýn	Maryna
rozmobilisovat	zmobilisovat,promobilisovat,umobilisovat,vymobilisovat,přemobilisovat,pomobilisovat,domobilisovat,odmobilisovat,omobilisovat,mobilisovat,zamobilisovat,přimobilisovat,namobilisovat
rozmrzat	zmrzat,vymrzat
rozmáčknout	zmačknout,promáčknout,vymáčknout
rozmílat	vymílat
roznítit	nítit
rozněžnět	zněžnět,zněžnit
rozohnit	zohnit
rozpindat	pindat
rozplamenit	zplamenit,zplamenět
rozplítat	proplítat,oplítat,zaplítat,vyplítat,přeplítat,uplítat,splítat
rozpora	opora,rozporovat
rozporovat	rozpora
rozprecisovat	precisovat,vyprecisovat,zaprecisovat,doprecisovat
rozprostranit	uprostranit
rozptýlit	zptýlit
rozpulsovat	pulsovat
rozpínat	odpínat,vzpínat,podpínat
rozpřahat	rozpřáhat,vypřahat,zapřahat,odpřahat,přepřahat,připřahat
rozpřádat	zapřádat,opřádat,upřádat,vypřádat,dopřádat
rozpřáhat	rozpřahat
rozradostnět	zradostnět,zradostnit
rozresonovat	zresonovat,vyresonovat,doresonovat,resonovat
rozsocha	socha
rozsychat	rozsýchat,rozesychat,osychat,prosychat,dosychat,rozesýchat,vysychat,zasychat
rozsystematisovat	systematisovat,dosystematisovat,nasystematisovat,přesystematisovat
rozsýchat	rozsychat,rozesýchat,osýchat,prosýchat,dosýchat,usýchat,vysýchat
roztrojit	ztrojit
roztrpčit	ztrpčit,ztrpčet
roztínat	odtínat
rozvichřit	vichřit
rozvojář	vývojář
rozvrtit	uvrtit,vyvrtit
rozvzpomínat	vzpomínat
rozšmaťchat	vyšmaťchat,sešmaťchat
rozšťourat	šťourat
rozžvykovat	ožvykovat
rošt	růst
rubat	Rubák
ruch	ruka
rudý	Ruda
ruka	rukovat,ruch
rukovat	ruka
rulička	Rulík
ruměnit	zaruměnět,ruměný,zruměnět
ruměný	ruměnit
rusý	Rusko,Rusín
rvát	vát,řvát
ryba	Rybák,Rybář
rychlobruslař	rychlobruslit
rychlobruslit	rychlobruslař
rychta	rychtovat
rychtovat	rychta
ryšavět	zryšavět
ráchat	rachat
ráj	rajka,roj,Rojka
rákos	Rákosník
rám	rámě
rámě	rám
rána	raný,ranč
ráčit	ráčkovat
ráčkovat	ráčit
rétor	rétorika
rétorika	rétor
rýha	rýže
rým	dým,rýma
rýma	rýmař,rým
rýmař	rýma,Rýmařov
rýže	rýha
růst	Zrůst,rošt
sacharin	Sacharov
sadit	Sadil,odsadit,Sádek,Sadov
sadovník	Sadov,Sádek
sahat	zasahat,vsahat
sajdkára	sajdkárkros
sajdkárkros	sajdkára
sak	sako,Kosák
sako	sak,Sasko
sakrament	zasakramentovat
salaš	salašit
salašit	salaš
salát	sálat
samec	samet
samet	samec
samokonfigurovat	konfigurovat
sandinista	Sandino
sanita	sanitovat,sanovat
sanitovat	sanita
sankce	sankciovat,sáňkář,saně
sankciovat	sankce
sanovat	saně,sanita
santal	Santana
saně	sankce,sanovat,sát
sardinka	sardinkář,Sardinie
sardinkář	sardinka,Sardinie
satira	satyr
satyr	satira
schroupnout	uchroupnout
schroustnout	zachroustnout
schránět	naschránit,uschránit
sebeparodie	sebeparodizovat
sebeparodizovat	sebeparodie
sebeprodukovat	sebereprodukovat
sebereprodukovat	sebeprodukovat
sebeuspokojit	sebeuspokovat
sebeuspokovat	sebeuspokojit
sebezpyt	sebezpytovat
sebezpytovat	sebezpyt
sedlat	Sedlák
seismologie	kosmologie
sekce	sekta,set
sekretář	podsekretář
sekta	sekce
sekvence	sekvencovat,sekvenovat
sekvencovat	sekvence,sekvenovat
sekvenovat	sekvencovat,sekvence
selekce	selektiva,selektovat
selektiva	selektovat,selekce
selektovat	selektiva,selekce
semický	semita
semita	semický
sen	seno
seno	senát,sen,set,Seneka
sentimentalismus	mentalismus
senzibil	senzibilní
senzibilní	senzibil
senzitiv	senzitivní
senzitivní	senzitiv
senát	seno
sesmekat	smekat
sesychat	osychat,přesychat,dosychat,přisychat,vysychat,rozesychat,zasychat
sesynchronisovat	přesynchronisovat,přisynchronisovat,nasynchronisovat,usynchronisovat,dosynchronisovat,resynchronisovat
set	Oset,sít,sto,seno,sát,sekce
sever	Severa
sešeřit	šeřit
sešikmit	zešikmit
seškrtat	škrtat
sešmaťchat	vyšmaťchat,rozšmaťchat
siena	siný
signalisovat	dosignalisovat,odsignalisovat,zasignalisovat,prosignalisovat
silice	silika
silika	silice,silikát
silikát	silika
sinus	siný
siný	sinus,siena
sirý	síra
sivý	Siva,osivo,sít,vyosit
skalkařit	Skalka,skalničkařit
skalničkařit	skalkařit
skalp	skialp
skandalisovat	zeskandalisovat
skialp	skalp
skica	skicnout
skicnout	skica,oškicnout
skladnit	zkladnit
sklamat	klamat
sklep	sklepník
sklepník	usklepnit,sklep
sklovatět	zesklovatět
skládat	přikládat,dokládat
skomírat	zkomírat
skrovný	uskrovnit
skála	Skalka
skýtat	naskýtat,vyskýtat
skřípat	skřípět
skřípět	skřípat
slabika	slabý,uslabit
slabý	slabika
slad	sladký,sladit,sladovník
sladit	sladký,slad,sladovník
sladký	sladit,slad,sladovník
sladovničit	sladovník
sladovník	sladovničit,slad,sladit,sladký
slanit	Slanec
slavit	slavík,Slávie
slavík	slavit,Slávie
sled	slez
slepičář	Slepička,naslepičit
slez	Slezsko,sled
slon	slunce
sloup	sloupkář
sloupkař	sloupkář
sloupkář	sloupkař,sloup
slunce	slon
slída	slídit
slídit	slída
smekat	sesmekat,vysmekat,posmekat
smetana	smetat
smetat	smetana
smradit	zasmradit
smích	Smíchov
smírný	směr
směr	smírný
smět	Smělý
smůla	Smola
sněm	sněmovat
sněmovat	sněm
socha	rozsocha
soda	sud,osud,Sodoma
sok	dok
solvence	insolvence
soma	Sodoma
sonet	sonáta
sonografie	fonografie
sonáta	sonet
sorbovat	adsorbovat,absorbovat
sosat	Sosna
sova	Sovík,Siva
spam	spamovat
spamovat	spam
specialisovat	přespecialisovat,zespecialisovat
spedice	speditér
speditér	spedice
splasknout	plasknout
sploštit	zploštit,oploštit
spláchnout	opláchnout,vypláchnout,pláchnout,propláchnout
splítat	oplítat,přeplítat,vyplítat,proplítat,rozplítat
spodobit	zpodobit,připodobit
spolkař	spolkařit,spolčit
spolkařit	spolkař
spolufinacovat	spolufinancovat
spolufinancovat	spolufinacovat
spoluodpovídat	spoluzodpovídat
spoluovládat	spoluvládnout
spolupoužít	spoluprožít
spoluprožít	spolupoužít
spolupřepravovat	spolupřipravit
spolupřipravit	spolupřepravovat
spoluučinkovat	spoluúčinkovat
spoluvládnout	spoluovládat
spoluzodpovídat	spoluodpovídat
spoluúčinkovat	spoluučinkovat
spolčit	spolkař
spor	spora,sporý,Sporck
spora	spor,sporý,Sporck
sport	spurt,Sporck
sporý	spora,spor
spořit	přespořit,podpořit
spravedlivý	spravedlný
spravedlný	spravedlivý
sprostit	oprostit,sprostý,zprostit,zprostit,vyprostit
sprostý	sprostit,prostý
sprovodit	vyprovodit,doprovodit
spurt	spurtovat,sport
spurtovat	spurt
spára	pára
spát	pospat
spíchat	pospíchat,spěchat
spěchat	spíchat,pospíchat
spřahat	odpřahat,připřahat,přepřahat,vypřahat,zapřahat,vpřahat
spřádat	opřádat,zapřádat,vypřádat,dopřádat,upřádat
srnec	Srník,Srna
srp	sýr
srát	přesrat,dosrat
sršatý	sršet
sršet	sršatý
stabilisovat	dostabilisovat,nastabilisovat,přistabilisovat,ustabilisovat,zastabilisovat
standardisovat	zestandardisovat
stanovit	Staník
star	starý,Istar
staromil	staromilec
staromilec	staromil
starý	star
statika	statistika,statovat
statistika	statika
statovat	stát,stát,stát,statika
stenografie	stenografovat
stenografovat	stenografie
step	stepovat
stepovat	step
sterilisovat	vysterilisovat
sterilní	sterilovat
sterilovat	sterilní
stlát	dostlat
sto	Stoy,set,oko
stoik	Stoy
stokoruna	koruna
stolice	stolit
stolit	stolice
stonat	Stone,stonek
stonek	Stone,stonat
stop	stopa
stopa	stop,Stupa
stoper	stopér
stopér	stoper
stoupit	dostoupit,zastoupit,popostoupit,prostoupit
stražit	zostražitět
stroj	strojit,ústroj
strojit	stroj
strok	otrok
strouhat	vystrouhat
struha	ostruha
strukturalisovat	dostrukturalisovat,nastrukturalisovat,zastrukturalisovat
stréc	strýc
strýc	stréc
stud	studit,studovat,studený,Studený
studený	stud,studit,studovat,Studénka,Studnář
studit	stud,Studený,studený,studovat
studovat	stud,studený,Studený,studit
stylisovat	vystylisovat,zestylisovat,ustylisovat
stáj	stájník
stájník	stáj,Staník
stánkař	stánkařit,stávkař
stánkařit	stánkař
stát	statovat
stát	statovat
stát	statovat
stávkař	stánkař
stáž	stážovat
stážovat	stáž
sténat	stínat
stín	Stin,stínat,stěna
stínat	sténat,stěna,stín
stýsknout	zastýsknout
stěhovat	stěhovák
stěhovák	stěhovat
stěna	stínat,stín,Stin
střebat	vstřebat
středit	odstředit,dostřeďovat
střihat	nastřihat,dostřihat,vostříhat,zastřihat,odstřihat,přistřihat,přestřihat
střiž	stříž,Stříž
stříbro	stříbřit,Stříbrný
stříbřit	stříbro,Stříbro,zestříbřet
stříhnout	ustříhnout,nastříhnout,dostříhnout,přestříhnout,vostříhat,zastříhnout
stříkat	prostříkat
střízlivý	střízlík,zestřízlivit
střízlík	střízlivý
stříž	střiž
subdukovat	obdukovat
subvence	subvencovat
subvencovat	subvence
sud	osud,soda,Sudek
sulc	Sula
suma	sumec
sumec	suma
supat	zupat,pat
suponovat	oponovat,proponovat
supět	pět,zpět
surový	Sura
surrealismus	neosurrealizmus
svat	Svatý,svatý
svatý	svat
svině	Sviny
svitek	svítit
svor	svora
svora	svor
svrbit	svrbět
svrbět	svrbit
svítit	světnice,svět,svitek,Osvětim
svědek	svědit,svědět
svědit	svědět,svědek
svědět	svědit,svědek
svět	světnice,svítit
světnice	svět,svítit,Osvětim,zesvětovět,zásvětný,osvětář
swing	swingovat
swingovat	swing
symbolisovat	zesymbolisovat
sympatie	sympatisovat,zesympatičtit
sympatisovat	zesympatisovat,zasympatisovat,sympatie
synchron	nasynchronisovat
syndikalismus	zesyndikalisovat
syndikovat	syndikát
syndikát	syndikovat
synkopa	synkopovat
synkopovat	synkopa
systematisovat	nasystematisovat,dosystematisovat,přesystematisovat,rozsystematisovat
systemisovat	dosystemisovat
systém	systémák,ekosystém
systémák	systém
sál	Nosál
sálat	salát
sát	set,saně
sáňkář	sankce
série	síra
sérologie	urologie
síci	sít
síknout	posíknout
síra	sirý,série
sít	sítina,síť,vyosit,set,sivý,síci,Oset
sítina	sít
síť	sít
sýr	Sýrie,Srp,srp
taj	tajný
tajemný	tajemnůstkář
tajemnůstkář	tajemný
tajný	taj
takt	taktika
taktika	takt
tanec	tank,tanout,tango
tango	tanec
tank	tanout,tanec
tanout	tank,tanec
tavit	zotavit
teatrální	zteatrálnit
technika	techno,zootechnika
techno	technika
teismus	ateismus
tele	Telč,cé,otec
telit	tetelit
tematika	matematika
tendr	tendrovat
tendrovat	tendr
tenký	Tennant,ztenknout
tep	otep
teriér	terč,teror
termika	termit
termit	termika
teror	teriér
terorismus	terorisovat
terorisovat	zterorisovat,terorismus
terč	teriér
test	protest
teta	tetovat
tetelit	telit
tetovat	teta
text	textil
textil	text
teč	tečka,Teka,Telč
tečka	Teka,teč
tip	tiper
tiper	tipér,tip
tipnout	otipnout
tipér	tiper
tisíc	Tisa,Tisov
titan	Titán,Titov
tknout	tkát
tkát	tknout
tleskat	otleskat
tmívat	vytmívat,tmět
tmět	tmívat,vytmívat
tonout	tonus
tonus	tonout
topor	topořit
topořit	topor
totál	totální
totální	totál
trafika	trafikařit
trafikařit	trafika
trakce	trakt
trakt	trakce
tramvaj	tramvajář
tramvajář	tramvaj
transgredovat	transgrese
transgrese	transgredovat
transit	transitovat
transitovat	transit
trasa	trasovat
trasovat	trasa
tratit	trať
travař	tráva
trať	tratit,tráva
trek	trest,treta
trest	trek
treta	trek
trh	Trhovky
trik	triko,trio
triko	trik,trio
trio	triko,trik
trn	Trnka,trnout
trnout	trn,Trnka
trojice	trojka,trojčit
trojka	trojčit,trojice,Troy,Troják,tropy
trojnásobek	ztrojnásobit
trojčit	trojka,Troják,trojice
tropy	trojka
trouchnivý	ztrouchnět
trsat	otrsat,Trs
tráva	travař,trávit,trať
trávit	tráva
tuha	tuhý
tuhý	tuha
tuna	tuňák,tung
tunel	tunelit
tunelit	tunel
tung	tuna
tupat	ťupat
tur	Turek,Turkit,Tursko
turismus	naturismus
turkický	Turkit,Tursko,Turek
turnaj	Turnov
turner	turnér
turnér	turner
tutový	Tutu
tuňák	tuna
tuš	tušit
tušit	tuš
tvar	tvářit,tvárný,tvářet
tvaroh	tvarohář
tvarohář	tvaroh
tvárný	tvar,tvářit
tvářet	tvářit,tvar
tvářit	tvářet,tvar,tvárný
tykat	zatykat,týkat,tyknout
tyknout	tykat
tyrolsko	Tyroly
tyč	tyčit,tyčinka
tyčinka	tyčit,tyč
tyčit	tyč,vytýčit,tyčinka
tábor	Tabori
tápat	ťápat
tát	Tate,táta,Tatar
táta	Tate,tát,Tatar
tón	tónika
tónika	tón
týkat	tykat,protýkat,dotýkat
týl	Tyl,týn,tělo
týn	týl
tělo	týl
těsný	těsto
těsto	těsný
těžit	těžký
těžký	těžit
třeskat	třískat
třeštit	tříštit
třáseň	třást
třást	třáseň,třít
třídit	třídník
třídník	třídit
tříska	třískat
třískat	třeskat,tříska
třít	Třinec,vatřit,třást
tříštit	třeštit
ublinknout	vyblinknout
ubreptnout	zabreptnout,vybreptnout
ubíhat	obíhat
ucelit	zcelit,docelit,zacelit
uchechtnout	zachechtnout,vychechtnout
uchichtnout	zachichtnout
uchramostit	zachramostit
uchroupnout	zachroupnout,schroupnout
uchvátit	zchvátit
uchřoupnout	zachřoupnout
uchřádat	zchřádat
ucviknout	procviknout
udice	udit
udit	udice
udolat	odolat,zdolat
udomácnit	udomácnět,zdomácnit
udomácnět	udomácnit,zdomácnět,zdomácnit
udrat	odrat,zadrat
uhládnout	zhládnout
uhlédat	ohlédat
uhodnout	dohodnout
uhorčit	zhorčit
uhášet	zhášet,zahášet
ujec	zajíc,oj
ujedinit	jediný
uklihnout	zklihnout
ukládat	dokládat,kládat,zakládat,předkládat
ukročit	nakročit,zakročit,rozkročit
ukrvavit	zkrvavit,okrvavit,zakrvavit
ulevit	Levit
ultramaraton	ultramaratón
ultramaratón	ultramaraton
um	zem
umanout	zmanout
umobilisovat	omobilisovat,zmobilisovat,promobilisovat,rozmobilisovat,zamobilisovat,domobilisovat,odmobilisovat,přemobilisovat,mobilisovat,přimobilisovat,pomobilisovat,vymobilisovat,namobilisovat,vmobilisovat,demobilisovat
umounit	zamounit
umoučit	zmoučit,zamoučit
umrnět	zamrnět
umrzat	omrzat,zmrzat
umáčknout	promáčknout
umílat	zamílat,promílat
unavit	znavit
uniat	unie,unita
unie	unita,uniat
unikat	onikat,znikat,zanikat,vynikat
unita	unie,uniat,unitární
unitární	unita
uondat	zondat
upchnout	zapchnout
uperizovat	přeřizovat
uplatnit	zpoplatnit
upláknout	opláknout
uplítat	oplítat,proplítat,zaplítat,přeplítat,doplítat,rozplítat,vyplítat,vplítat
upovšechnit	zpovšechnit,zpovšechnět
uprat	prát,naprat
upravdit	zpravdit
uprdelit	vyprdelit,odprdelit
uprostranit	rozprostranit
uprázdnit	zprázdnět
uptat	ptát
upír	op
upřádat	opřádat,zapřádat,dopřádat,vypřádat,rozpřádat,vpřádat,spřádat
urbanisovat	zurbanisovat
urbánní	Urbán
urologie	sérologie
urputit	urputný
urputník	urputný
urputný	urputník,urputit
uryšit	urýšit
urýšit	uryšit
uschopnit	zneschopnit
uschránit	naschránit,schránět,chránit
usklepnit	sklepník
uskromnit	zeskromnit,zeskromnět
uskrovnit	zeskrovnit,skrovný
uslabit	slabika
usobit	osobit
uspíšit	pospíšit,přispíšit
usrat	odsrat
ustabilisovat	stabilisovat,dostabilisovat,nastabilisovat,přistabilisovat,zastabilisovat
ustesknout	zastesknout
ustydat	zastydat
ustylisovat	stylisovat,vystylisovat
ustýlat	nastýlat,zastýlat,přestýlat
ustřehnout	vystřehnout,zastřehnout,postřehnout
ustříhnout	stříhnout,nastříhnout,dostříhnout,přestříhnout,zastříhnout,vostříhat
usynchronisovat	nasynchronisovat,dosynchronisovat,přisynchronisovat,přesynchronisovat,sesynchronisovat,resynchronisovat
usápnout	vsápnout,zasápnout,vysápnout
usýchat	osýchat,dosýchat,prosýchat,zasýchat,rozsýchat,vysýchat
utentovat	potentovat,vytentovat
uteplit	zteplit,doteplit
utichat	zatichat
utilisovat	zutilisovat
utilita	utilitář
utilitarianismus	utilitarismus
utilitarismus	utilitarianismus
utilitář	utilita
utopie	atopie
utrakvisovat	zutrakvisovat
uvadat	ovadat,zavadat,povadat,zvadat
uvrtit	dovrtit,rozvrtit,povrtit,vrtět,vyvrtit,zavrtit
uvykat	vykat,zvykat,přivykat
uvědomit	zvědomit
uvěčnit	zvěčnět
uzlit	zauzlit
učlověčit	zčlověčit,zčlověčtit
uřknout	zařknout
ušedat	zšedat,zašedat,prošedat
ušklíbat	ošklíbat,zašklíbat,vyšklíbat,pošklíbat
uškrouknout	zaškrouknout
ušmourat	zašmourat
ušporovat	zašporovat
ušpoulit	zašpoulit,vyšpoulit
uštkat	uštknout
uštknout	uštkat
ušukat	šukat
ušušňat	pošušňat
uživotnit	zživotnit
užmoulit	zažmoulit
užrat	požrat,zažrat
užvykovat	ožvykovat
vachta	vachtat,vachtař,jachta
vachtat	vachtař,vachta
vachtař	vachtat,vachta,jachtařit,zajachtařit
vagabund	vagabundit
vagabundit	vagabund
vagant	vagantit
vagantit	vagant
vagonkář	vagonář
vagonovat	vagonář
vagonář	vagonovat,vagonkář
vahař	váhař
vak	jak
valit	Valina
valkovat	Val,válka,Valeč
valorisovat	dovalorisovat,zvalorisovat
valčík	Valeč
vana	vanad,Vaník,Vaněk
vanad	vana
vandalisovat	zvandalisovat
var	várka,Avar,Jar
varhanit	varhanět,varhaničit,varhánek,varhany
varhaničit	varhanit,varhánek,varhany,varhanět
varhany	varhánek,varhanit,varhaničit,varhanět
varhanět	varhanit,varhaničit,varhany,varhánek
varhánek	varhany,varhaničit,varhanit,varhanět
variance	varianta
varianta	variance
varta	vartovat
vartovat	varta
vaselinovat	dovaselinovat,navaselinovat,provaselinovat
vata	vát
vatřit	třít
vazný	váza
vbočit	zbočit
vcupotat	vycupotat
vdechat	vdéchat,zdechat
vdova	vdovit
vdovit	vdova
vdychat	vdýchat,vydychat
vdéchat	vdechat
vdýchat	vdychat
vedrat	Vedra
vegetit	vegetář,vegetovat
vegetovat	vegetář,vegetit
vegetář	vegetovat,vegetit
vejce	vejl
vejl	vejce
vejměnkář	vejměník
vejměník	vejměnkář
vejvoda	vývoda,vojvoda
veka	véčko
velebit	velebník,zvelebnit
velebník	zvelebnit,velebit
veleslavit	Veleslavín
veličit	zveličet
velkostatek	velkostatkář
velkostatkář	velkostatek
velký	Velen,Vela
ven	Vey
ventil	ventilovat
ventilovat	ventil
vepř	vepřovina
vepřovina	vepř
ves	oves
vestylisovat	zestylisovat
veta	veto
vetkat	veto
veto	veta,vít,Vít,vetkat
vhoupnout	přehoupnout,vyhoupnout
vichr	vichřit
vichřit	rozvichřit,vichr
video	vidle,vidět
vidle	video
vidět	video
vietnamka	Vietnam
viks	kiks,iks
vila	vilný,víla,Avila,vina
vilný	vila
vina	Vína,vila,víno
vinařit	novinařit
vinklář	Vinklár
viola	violina
violina	viola
vir	víra
virginal	Virginie
visatý	viset,visovat
viset	visatý,visnout,visovat
visitovat	zvisitovat
visitýrovat	zvisitýrovat
visnout	viset
visovat	avisovat,viset,visatý
vitaminisovat	ovitaminisovat,zvitaminisovat,dovitaminisovat,navitaminisovat,odvitaminisovat,převitaminisovat,přivitaminisovat
vize	Vizovice,vizír
vizita	vizitovat
vizitovat	vizita
vizír	vize
vklesat	klesat
vkotoulet	zakotoulet
vlas	Vlasov,vlasař
vlasař	vlas
vlast	Vlastík
vlekat	vlékat
vlhat	provlhat,zavlhat,zvlhat,navlhat
vlk	vlčit,Vlčnov
vládat	vládný,vovládnout
vládný	vovládnout,vládat
vláknit	vlákno
vlákno	vláknit
vlékat	vlekat,vlíkat
vlídný	zvlídnit
vlíkat	vlékat
vlčet	vlčit
vlčit	vlčet,Vlk,vlk,Vlčnov
vmobilisovat	přemobilisovat,vymobilisovat,zmobilisovat,zamobilisovat,demobilisovat,omobilisovat,umobilisovat
vnadit	nadít
vnikat	onikat,vynikat,zanikat,znikat
vnoukat	vnukat
vnukat	vnoukat
vně	vát,Nat,oj,ovce,půst,Vey,Poe,nový
vochcat	ochcat
vochle	vochlovat
vochlovat	vochle
voda	Vodák,vodovod,vodnář
vodnář	voda,Voda
vodohospodář	národohospodář,hospodář
vodovod	Voda,voda
vohejbat	hejbat
voj	vojna,Vojen,oj
vojančit	Vojan
vojevoda	vojevodit
vojevodit	vojevoda,vojvodit
vojna	voj,Vojen
vojvoda	vojvodit,vejvoda
vojvodit	vojvoda,vojevodit
vokazovat	vokázat
vokázat	kázat,vokazovat
vole	vůle,volný
volný	vole
vonice	vonět
vonět	vonice
vor	převor
vosa	osa,rosa
vostříhat	stříhnout,střihat,dostříhnout,nastříhnout,dostřihat,nastřihat,ustříhnout
vovládnout	vládný,vládat
vočmuchat	čmuchat,dočmuchat,pročmuchat
vpeřit	přepeřit
vplítat	přeplítat,oplítat,uplítat,vyplítat
vprysknout	vyprysknout
vpírat	přepírat
vpřahat	vpřáhat,přepřahat,vypřahat,zapřahat,spřahat
vpřádat	vypřádat,zapřádat,opřádat,upřádat
vpřáhat	vpřahat
vrap	vráp,rap
vraštit	vráštit
vrba	Vrbata
vrhat	vyvrhat,zavrhat,zvrhat,převrhat,povrhat
vroucnit	vroucný
vroucný	vroucnit
vrtačit	vrtáčet
vrtichvost	vrtichvostit
vrtichvostit	vrtichvost
vrtohlavět	zvrtohlavit
vrtáčet	vrtačit
vrtět	uvrtit,dovrtit,Vrtěl,vyvrtit
vrzat	Vrzák
vrána	Vrana,Vraný
vráp	vrap,vrápat
vrápat	vráp
vráskatět	vráskovatět
vráskovatět	vráskatět
vráštit	vraštit
vsahat	vsáhat,sahat
vsouknout	vysouknout
vsout	psout,vsouvnout
vsouvnout	vsout,vysouvnout
vstřebat	střebat
vsáhat	vsahat
vsápnout	usápnout
vtip	vtipkař
vtipkal	vtipkař
vtipkař	vtipkařit,vtip,vtipkal
vtipkařit	vtipkař
vtínat	vtít
vtít	vtínat
vulgarisovat	zavulgarisovat,zvulgarisovat
vulgární	zvulgárnit
vulkanisovat	zavulkanisovat,zvulkanisovat,dovulkanisovat,předvulkanisovat
vyanalysovat	analysovat,zanalysovat
vybledat	zbledat
vyblinknout	ublinknout
vyblízat	vyblíznout
vyblíznout	vyblízat
vyboulovat	zboulovat
vybreptnout	zabreptnout,ubreptnout
vybulat	zbulat,zabulat
vybíhat	zbíhat,rozbíhat
vyběsit	zběsit,oběsit
vybředat	bředat,zabředat,rozbředat
vycensurovat	censurovat,odcensurovat,zcensurovat,zacensurovat,procensurovat,nacensurovat,rozcensurovat,docensurovat
vycharakterisovat	charakterisovat,zcharakterisovat
vychechtnout	uchechtnout,zachechtnout
vychládat	zchládat
vychlámat	chlámat
vychlípit	vychlípět,rozchlípit
vychlípět	vychlípit
vychrkat	vychrknout
vychrknout	vychrkat
vychvistnout	vychvístnout
vychvátit	zchvátit,rozchvátit
vychvístnout	vychvistnout,pochvístnout
vychytrat	zchytrat
vyciselovat	ciselovat
vycukernit	zcukernit,odcukernit,zcukernět
vycupotat	zacupotat,vcupotat
vydejchnout	zdejchnout
vydlažit	vydlážit
vydlábnout	nadlábnout
vydlážit	vydlažit
vydrezovat	zdrezovat
vydundat	odundat,zadundat
vydychat	vdychat
vydřevit	vydřevnit
vydřevnit	vydřevit
vyeskamotovat	zaeskamotovat
vygeneralisovat	zgeneralisovat,generalisovat,zageneralisovat,rozgeneralisovat,přegeneralisovat,dogeneralisovat
vyhládnout	zhládnout
vyhlášet	ohlášet
vyhlédat	vzhlédat,zhlédat,hlédat,ohlédat,hledat,rozhlédat
vyhopcovat	zahopcovat
vyhoupnout	houpnout,zhoupnout,rozhoupnout,vhoupnout
vyhourat	zahourat
vyhranit	hranit
vyhrubovat	ohrubovat
vyhvězdit	zhvězdit,ohvězdit,přehvězdit
vyháknout	oháknout
vyjekat	zajekat
vyjiknout	vyjíknout
vyjíknout	vyjiknout
vykat	uvykat,přivykat,zvykat,navykat,odvykat
vyklechtat	zaklechtat
vyklinout	zaklinknout
vykládat	kládat,zakládat,předkládat,dokládat,vynakládat,donakládat,překládat,vzkládat
vykoketnout	zakoketnout
vykolejit	nakolejit
vykolit	zakolit
vykonsumovat	konsumovat,prokonsumovat,rozkonsumovat,přikonsumovat,dokonsumovat
vykotoulet	zakotoulet
vykrkat	krkat
vykročit	nakročit,zakročit,kročit,rozkročit
vykrvit	zkrvit,zakrvit,odkrvit
vykrystalisovat	krystalisovat,zkrystalisovat
vykudlit	zakudlit
vykuknout	zakuknout
vykutalit	zakutalit
vykvitnout	vykvítnout,zakvitnout,vzkvitnout
vykvítnout	vykvitnout
vykáznit	zkáznit
vylehčit	odlehčit
vylevit	Levit
vylétnout	nalétnout
vylíhat	líhat,rozlíhat,dolíhat,zalíhat
vymanit	rozmanitý
vymanout	zmanout,namanout,zamanout
vymetat	zmetat,metat,vymetnout
vymetnout	vymetat,přemetnout
vymezit	zmezit,zamezit
vymobilisovat	mobilisovat,přemobilisovat,zamobilisovat,zmobilisovat,odmobilisovat,rozmobilisovat,omobilisovat,namobilisovat,demobilisovat,domobilisovat,vmobilisovat,promobilisovat,pomobilisovat,umobilisovat,přimobilisovat
vymokat	zmokat
vymrzat	namrzat,zamrzat,zmrzat,rozmrzat
vymutýrovat	zmutýrovat
vymáčknout	zmačknout,namáčknout,rozmáčknout
vymílat	rozmílat
vymítat	namítat
vymědlit	změdlit
vynakládat	zakládat,kládat,donakládat,vykládat,překládat
vynikat	vnikat,zanikat,onikat,znikat,unikat
vyoblit	zaoblit
vyobloučit	zobloučit,zaobloučit
vyosit	sít,Oset,sivý,prosit
vyoslit	vyvoslit
vypadat	padat
vypartykařit	zpartykařit,zapartykařit
vypažit	pažit
vypchnout	zapchnout
vypeřit	zpeřit,zapeřit,přepeřit,opeřit
vyplanit	zplanit
vyplavět	zplavět,výplav
vypláchnout	pláchnout,opláchnout,propláchnout,spláchnout
vypláknout	opláknout
vyplítat	zaplítat,přeplítat,doplítat,proplítat,podplítat,oplítat,splítat,rozplítat,uplítat,vplítat
vypodobit	zpodobit,napodobit,vypodobnit
vypodobnit	zpodobnit,vypodobit,napodobit
vypolštářit	polštář
vyprahat	vypráhat,zprahat,vypřahat
vyprdelit	odprdelit,uprdelit
vyprecisovat	zaprecisovat,precisovat,rozprecisovat,doprecisovat
vyprostit	zprostit,zprostit,oprostit,sprostit
vyprovodit	doprovodit,sprovodit
vyprysknout	vprysknout
vypráhat	vyprahat
vypulerovat	vypulérovat
vypulérovat	vypulerovat
vypáchat	páchat
vypíčit	zpíčit,píča
vypřahat	zapřahat,napřahat,přepřahat,odpřahat,rozpřahat,vpřahat,vyprahat,vzpřahat,připřahat,spřahat
vypřádat	zapřádat,dopřádat,opřádat,upřádat,rozpřádat,vpřádat,spřádat
vyrajbovat	prorajbovat
vyresonovat	zresonovat,rozresonovat,odresonovat,resonovat
vyrotit	zarotit
vyrudat	zarudat
vysedat	dosedat
vysemenit	osemenit
vyskytat	vyskýtat
vyskýtat	vyskytat,skýtat,naskýtat
vyslat	zaslat
vyslýchat	zaslýchat,doslýchat
vysmekat	smekat
vysmrádnout	nasmrádnout
vysouknout	vsouknout
vysout	vysouvnout
vysouvnout	vsouvnout,vysout
vysterilisovat	sterilisovat
vystrouhat	strouhat
vystroužit	vystružit
vystružit	Struž,vystroužit
vystydat	zestydat
vystylisovat	stylisovat,ustylisovat,zestylisovat
vystýlat	nastýlat
vystřehnout	ustřehnout,postřehnout,zastřehnout
vysvítat	prosvítat
vysychat	vysýchat,zasychat,osychat,dosychat,sesychat,prosychat,rozsychat
vysámečkovat	vysámkovat
vysámkovat	vysámečkovat
vysápnout	zasápnout,usápnout
vysíkat	dosíkat
vysýchat	vysychat,zasýchat,osýchat,dosýchat,prosýchat,usýchat,zasychat,rozsýchat
vytentovat	potentovat,utentovat
vyteplit	zteplit,Teplice,přeteplit
vytkat	potkat
vytmívat	tmívat,tmět
vytučnit	ztučnit,odtučnit
vytýčit	tyčit
vyvléknout	navléknout,provléknout,podvléknout,převléknout
vyvoslit	vyoslit
vyvrhat	vrhat,zvrhat,zavrhat,povrhat
vyvrtit	zavrtit,navrtit,dovrtit,uvrtit,vrtět,rozvrtit
vyvýšit	převýšit
vyzuzat	Zuza,Zuzák
vyzírat	zírat,odzírat
vyčouhat	čouhat
vyšklíbat	zašklíbat,ušklíbat,pošklíbat,ošklíbat
vyškviknout	zaškviknout
vyšmaťchat	rozšmaťchat,sešmaťchat
vyšpekovat	našpekovat
vyšpláchnout	ošpláchnout,špláchat
vyšpoulit	zašpoulit,ušpoulit
vyšpánkovat	vyšpánovat
vyšpánovat	vyšpánkovat
vyštkat	štkát
vyštráchat	štrachat
vyštěrbat	vyštěrbit
vyštěrbit	vyštěrbat
vyšustět	všustět,zašustět
vyžblunknout	zažblunknout
vyždibovat	oždibovat
vyžehat	ožehat,vžehat
vyžunknout	bžunknout
vzdor	vzor
vzdušnice	vzdušnit,vzdušnět
vzdušnit	vzdušnice,vzdušnět,odvzdušnit
vzdušnět	vzdušnit,vzdušnice
vzdýmat	zdýmat
vzhlédat	vyhlédat,zhlédat,vzhlídat
vzhlídat	vzhlédat
vzkládat	předkládat,vykládat
vzkvetnout	vzkvétnout,vzkvětnout,vzkvitnout
vzkvitnout	vykvitnout,vzkvetnout,vzkvětnout
vzkvétnout	vzkvetnout,vzkvětnout
vzkvětnout	vzkvetnout,vzkvétnout,vzkvitnout
vznikat	znikat
vznítit	nítit,znít
vzor	vzdor,pozor,dozor
vzorkař	vzorkář
vzorkovat	vzorkář
vzorkář	vzorkař,vzorkovat
vzplavovat	oplavovat
vzpomínat	rozvzpomínat,napomínat
vzpínat	předpínat,rozpínat
vzpěčovat	zpěčovat,zpěčit
vzpřahat	vypřahat
vzrůst	Zrůst
vzájemný	zájemný
váha	váhař,Váh
váhař	váha,vahař,Váh
válka	Val,Válek,valkovat,Vala,Valina
vápeničit	vápeník,Vápeník,vápenět
vápeník	vápeničit,vápenět
vápenět	Vápeník,vápeník,vápeničit
várka	var
vát	vně,rvát,vata,Nat,oj,ovce
váza	vázat,vazný
vázat	váza
véčko	veka
víjet	dovíjet,povíjet,províjet,přivíjet,převíjet
víko	Zvíkov
víla	vila
víno	Vína,věno,vina
víra	Věra,vir
vískat	výskat
vít	větit,veto,větev
výdělkařit	výdělkář
výdělkář	výdělkařit
výměničit	výměnkář
výměnkařit	výměnkář
výměnkář	výměnkařit,výměničit
výplav	vyplavět
výr	Výrov
výskat	vískat
výt	nýt,nýt
výtvarničit	zvýtvarnit
vývoda	vejvoda,vývodit
vývodit	vývoda
vývojář	rozvojář
výzbroj	zbroj
věc	věk
věk	věc
věnec	věnečný,věno,věnčit
věnečný	věnec,věnčit
věno	víno,věnec,Vína,věnčit,věnovat
věnovat	věno
věnčit	věno,věnec,věnečný
věrovat	Věra
věta	větit,větev
větev	věta,větit,vít,Vít
větit	věta,větev,Vít,vít
věž	věžit
věžit	věž
vřed	vředovatý
vředovatý	vřed
vřít	zavřít
všednět	zevšednit
vštípit	štípit
všustět	vyšustět,zašustět,šustit
vůl	vůle
vůle	vůl,vole
vůně	Vont
vžehat	vyžehat,ožehat
wagnerián	Wagner
wahhábita	Wahháb
yorkšír	jorkšír
zaarchaisovat	zarchaisovat
zabahnout	bahno,zabahnět
zabahnět	zbahnět,zabahnout
zabejvat	bejvat
zabezpečit	zbezpečit
zableskat	bleskat
zablešit	odblešit
zablátit	rozblátit,bláto
zabookovat	přebookovat
zaboudit	bouda
zabreptnout	ubreptnout,vybreptnout
zabsolutnit	zabsolutnět,absolutní
zabsolutnět	zabsolutnit,absolutní
zabstraktnit	zabstraktnět,abstraktní
zabstraktnět	zabstraktnit,abstraktní
zabsurdnit	absurdní
zabulat	zbulat,vybulat
zabáňat	banát
zabředat	bředat,vybředat,rozbředat,zabřídat
zabřesknout	rozbřesknout
zabřezat	Březa
zabřídat	zabředat
zacelit	ucelit
zacensurovat	nacensurovat,vycensurovat,odcensurovat,censurovat,zcensurovat,docensurovat,procensurovat,přecensurovat
zachechtnout	uchechtnout,vychechtnout,zachichtnout
zachichtnout	uchichtnout,zachechtnout
zachmýřit	ochmýřit
zachramostit	uchramostit
zachroupnout	uchroupnout
zachroustnout	zachrustit,schroustnout
zachrustat	zachrustit,zachrustět
zachrustit	zachrustět,zachrustat,zachroustnout
zachrustět	zachrustit,zachrustat
zachřoupnout	uchřoupnout
zacrnknout	zacrnčet
zacrnčet	zacrnknout
zacupotat	vycupotat
zadostičinit	zadostčinit
zadostčinit	zadostičinit
zadrat	zedrat,udrat,dodrat,nadrat
zadundat	odundat,vydundat
zaeskamotovat	vyeskamotovat
zafuriantit	furiant
zageneralisovat	generalisovat,vygeneralisovat,dogeneralisovat,zgeneralisovat,rozgeneralisovat
zahlednout	zhlednout,zahlédat
zahltit	zahltnout
zahltnout	zahltit
zahlédat	zahlídat,hlédat,ohlédat,zahlednout
zahlídat	hlídat,zahlédat
zahlížet	poohlížet
zahopcovat	vyhopcovat
zahosťovat	zahošťovat
zahoupnout	houpnout
zahourat	vyhourat
zahořan	Hořan
zahošťovat	zahosťovat
zahustnout	zhustnout
zahálet	zahálčit
zahálčit	zahálet
zahášet	zhášet,uhášet
zaimprovisovat	improvisovat
zajachtařit	jachtařit,vachtař
zajekat	zajíkat,vyjekat
zajikat	zajíkat
zajíc	ujec,oj
zajíkat	zajikat,zajekat
zakademičtit	zakademičtět
zakademičtět	zakademičtit
zakančit	zakaňkat
zakatalogisovat	katalogisovat,zkatalogisovat
zakaňkat	zakančit
zaklechtat	vyklechtat
zaklekat	přiklekat,poklekat
zaklimatisovat	klimatisovat,přiklimatisovat,doklimatisovat,překlimatisovat,odklimatisovat
zaklinknout	vyklinout
zaklubnout	proklubnout
zakládat	zakládač,kládat,dokládat,vynakládat,překládat,vykládat,přikládat,donakládat,ukládat
zakládač	zakládat
zakoketnout	vykoketnout
zakolit	vykolit
zakonservovat	konservovat,zkonservovat
zakotoulet	vykotoulet,vkotoulet
zakrabit	zkrabit,krabice
zakritisovat	kritisovat,zkritisovat
zakrouhnout	zkrouhnout,okrouhnout,odkrouhnout
zakročit	nakročit,kročit,přikročit,ukročit,vykročit
zakrvavit	zakrvit,ukrvavit,okrvavit
zakrvit	zakrvavit,vykrvit,překrvit
zakráknout	krákat
zaktivisovat	aktivisovat
zaktivnit	zaktivnět
zaktivnět	zaktivnit
zaktualisovat	aktualisovat
zakudlit	vykudlit
zakuknout	vykuknout
zakusit	okusit
zakutalit	vykutalit
zakvetnout	zakvitnout
zakvitnout	vykvitnout,zakvetnout
zakřídlit	okřídlit,rozkřídlit
zalistit	odlistit,olistit
zalkalisovat	alkalisovat
zalumpačit	zlumpačit
zalykat	zalyknout
zalyknout	zalykat
zalíhat	nalíhat,vylíhat
zalíknout	políknout
zalítnout	přelítnout,nalítnout
zamachlovat	zmachlovat
zamanout	namanout,vymanout
zamezit	vymezit
zamobilisovat	mobilisovat,vymobilisovat,omobilisovat,přemobilisovat,domobilisovat,promobilisovat,demobilisovat,umobilisovat,namobilisovat,zmobilisovat,pomobilisovat,rozmobilisovat,odmobilisovat,přimobilisovat,vmobilisovat
zamodrchat	zmodrchat
zamokat	namokat
zamortisovat	amortisovat
zamounit	umounit
zamoučit	umoučit
zamrnět	umrnět
zamroukat	zamrouknout
zamrouknout	zamroukat
zamrzat	vymrzat,namrzat
zamílat	umílat
zamútit	zmútit
zaměstnat	městnat
zanalysovat	analysovat,vyanalysovat
zanešvařit	znešvařit
zanikat	onikat,vnikat,vynikat,znikat,unikat
zanítit	nítit
zaněmčit	zněmčit
zaoblit	vyoblit
zaobloučit	vyobloučit,zobloučit
zaonačit	načít,značit,zonačit
zapartykařit	zpartykařit,vypartykařit
zapchat	napchat,zapchnout
zapchnout	zapchat,upchnout,vypchnout
zapejřit	zapeřit
zapeřit	vypeřit,přepeřit,zpeřit,zapejřit
zaplynout	připlynout,plyn
zaplítat	proplítat,vyplítat,uplítat,oplítat,přeplítat,doplítat,rozplítat,připlítat,podplítat
zapolemisovat	polemisovat
zapoletět	zapolétat
zapolitisovat	zpolitisovat
zapolétat	polétat,zapolítat,zapoletět
zapolítat	zapolétat
zapomnět	pomnít
zapomínat	pozapomínat,napomínat,opomínat,připomínat
zaprecisovat	precisovat,vyprecisovat,rozprecisovat
zapráhnout	zpráhnout,prahnout
zapsychologisovat	zpsychologisovat
zapylit	opylit
zapřahat	vypřahat,napřahat,rozpřahat,přepřahat,připřahat,odpřahat,vpřahat,spřahat
zapřádat	opřádat,vypřádat,upřádat,dopřádat,rozpřádat,spřádat,vpřádat
zarchaisovat	zaarchaisovat
zaresonovat	resonovat,přeresonovat,doresonovat
zarochnout	rochnit
zarotit	vyrotit
zaruchat	zruchat
zarudat	vyrudat
zaruměnět	ruměnit,zruměnět
zarůžovatět	zrůžovatět
zasahat	sahat
zasakramentovat	sakrament
zasignalisovat	signalisovat,dosignalisovat,odsignalisovat,prosignalisovat
zasinavět	zesinavět,zsinavět
zaslat	vyslat
zaslnit	oslnit
zaslýchat	vyslýchat,doslýchat
zasmoušit	zasmušit
zasmradit	smradit
zasmušit	zasmoušit
zastabilisovat	nastabilisovat,stabilisovat,ustabilisovat,přistabilisovat,dostabilisovat
zastehnout	nastehnout,přistehnout
zastesknit	zastesknout
zastesknout	zastýsknout,ustesknout,zastesknit
zastoupit	stoupit
zastrakatět	zestrakatět
zastrukturalisovat	nastrukturalisovat,strukturalisovat,dostrukturalisovat
zastydat	zestydat,ustydat
zastýlat	nastýlat,ustýlat
zastýsknout	zastesknout,stýsknout
zastřehnout	postřehnout,ustřehnout,vystřehnout
zastřihat	nastřihat,střihat,zastříhnout,dostřihat
zastříbrnět	zestříbrnět
zastříhnout	nastříhnout,stříhnout,ustříhnout,dostříhnout,zastřihat,přestříhnout
zasvětačit	zesvětačit
zasychat	zasýchat,vysychat,zasychnout,osychat,prosychat,dosychat,rozsychat,vysýchat,sesychat
zasychnout	zasychat,zasýchat
zasympatisovat	sympatisovat,zesympatisovat
zasápnout	vysápnout,usápnout
zasýchat	zasychat,vysýchat,prosýchat,osýchat,dosýchat,zasychnout,usýchat
zatalácet	ztalácet
zatichat	utichat,ztichat
zatrpčit	ztrpčit
zatrudnit	ztrudnit
zatykat	tykat
zautomatisovat	odautomatisovat,doautomatisovat,automatisovat,přeautomatisovat,přiautomatisovat
zautorisovat	autorisovat
zauzlit	uzlit
zavadat	uvadat,závada,Závada,zvadat,ovadat
zavazet	zavazit
zavazit	zavazet
zavlahnout	zavláhnout
zavlhat	navlhat,vlhat,zvlhat,provlhat
zavláhnout	zavlahnout
zavlíknout	navlíknout,dovlíknout,odvlíknout
zavrhat	vrhat,vyvrhat,převrhat,zvrhat
zavrtit	vyvrtit,navrtit,uvrtit
zavrtošit	zvrtošit
zavulgarisovat	vulgarisovat,zvulgarisovat
zavulkanisovat	vulkanisovat,dovulkanisovat,zvulkanisovat,předvulkanisovat
zavyšívat	dovyšívat
zavčelit	převčelit
zavřít	vřít
zazvěřit	přezvěřit,zvěř
začíslit	přečíslit
začít	načít,čít,počít
začít	načít,čít,počít
začít	načít,čít,počít
zařknout	uřknout
zašedat	ušedat,zšedat
zašeřet	zešeřet,zšeřet
zašklíbat	ušklíbat,vyšklíbat,ošklíbat,pošklíbat
zaškrouknout	uškrouknout
zaškviknout	vyškviknout,zaškvěknout
zaškvičet	zaškvěčet
zaškvěknout	zaškvěčet,zaškviknout
zaškvěčet	zaškvěknout,zaškvičet
zašmourat	ušmourat
zašperovat	zašpérovat
zašporovat	ušporovat
zašpoulit	vyšpoulit,ušpoulit
zašpérovat	zašperovat
zaštilipat	zaštilipět
zaštilipět	zaštilipat
zaštkat	zaštknout
zaštknout	zaštkat
zašustět	všustět,vyšustět
zažblunknout	vyžblunknout
zažehat	ožehat
zažmoulit	užmoulit
zažrat	užrat,přežrat
zbabičkovatět	babičkovatět
zbahnět	zabahnět
zbambulatět	zbambulovatět
zbambulovatět	zbambulatět
zbanálnit	zbanálnět
zbanálnět	zbanálnit
zbezpečit	zbezpečnit,zabezpečit
zbezpečnit	zbezpečit
zblbat	zblbět
zblbit	zblbět,oblbit
zblbět	zblbit,zblbat
zbledat	vybledat,zbledět
zbledět	zbledat
zbodřet	zbodřit
zbodřit	zbodřet
zbojničit	zbojník
zbojník	zbojničit,rozbojník
zbolavit	rozbolavět
zbolestnět	rozbolestnit
zbolševisovat	bolševisovat
zboubelatět	boubelatý
zboulovat	vyboulovat
zbočit	rozbočit,vbočit
zbožštit	odbožštit
zbroj	výzbroj
zbuchtovatět	buchtovatět
zbujnit	zbujný
zbujný	zbujnit
zbulat	vybulat,zabulat
zbyrokratičtět	zbyrokratět
zbyrokratět	zbyrokratičtět
zbídnit	zbídnět
zbídnět	zbídnit
zbíhat	rozbíhat,vybíhat,obíhat
zběsit	vyběsit,oběsit
zbředit	břídit
zcelit	ucelit,docelit
zcensurovat	rozcensurovat,odcensurovat,censurovat,vycensurovat,procensurovat,docensurovat,zacensurovat
zcentralisovat	centralisovat,docentralisovat,přecentralisovat,decentralisovat
zcharakterisovat	vycharakterisovat,charakterisovat
zchládat	vychládat,ochládat
zchroumat	pochroumat
zchudobit	zchudobnět,zchudobňovat
zchudobnět	zchudobňovat,zchudobit
zchudobňovat	zchudobnět,zchudobit
zchvácet	zchvátit
zchvátit	rozchvátit,vychvátit,zchvácet,uchvátit
zchytrat	vychytrat
zchřádat	uchřádat
zcikánět	cikánit
zcitlivit	rozcitlivit,zcitlivět,rozcitlivět
zcitlivět	rozcitlivět,zcitlivit,rozcitlivit
zcivilisovat	civilisovat
zcivilnit	zcivilnět
zcivilnět	zcivilnit
zcizet	cizí
zcukernit	zcukernět,vycukernit,odcukernit
zcukernět	zcukernit,vycukernit,odcukernit
zcírkevnit	odcírkevnit
zdechat	vdechat
zdefinitisovat	zdefinitizovat,zdefinitivnit
zdefinitivnit	zdefinitizovat,zdefinitisovat
zdefinitizovat	zdefinitisovat,zdefinitivnit
zdejchnout	vydejchnout
zdemokratisovat	demokratisovat
zdemoralisovat	demoralisovat
zdesateronásobit	zdesateronásobnit
zdesateronásobnit	zdesateronásobit
zdesorganisovat	desorganisovat
zdivadelnit	oddivadelnit
zdiversifikovat	diversifikovat,dodiversifikovat
zdolat	udolat,odolat
zdomácnit	zdomácnět,udomácnit,udomácnět
zdomácnět	zdomácnit,udomácnět
zdravkat	zdrávkat
zdravý	dravý
zdravět	ozdravět
zdredovatět	dredovatět
zdrezovat	vydrezovat,drezírovat
zdrhat	drhat
zdrobnit	zdrobnět
zdrobnět	zdrobnit
združstevnit	družstevničit
zdrávkat	zdravkat
zduchovnit	zduchovnět,produchovnit
zduchovnět	zduchovnit,produchovnět
zduševnit	zduševnět,oduševnit,produševnit
zduševnět	zduševnit,oduševnit
zdvihat	nazdvihat,nadzdvihat
zdychtivět	dychtivec
zdát	dát
zdýmat	vzdýmat
zdětinštit	zdětštit
zdětštit	zdětštět,zdětinštit
zdětštět	zdětštit
zdůstojnit	zdůstojnět
zdůstojnět	zdůstojnit
zdůvěrnit	zdůvěrnět
zdůvěrnět	zdůvěrnit
zechcat	přechcat,ochcat,nachcat
zedrat	rozedrat,zadrat
zefír	zefýr
zefýr	zefír
zelektrisovat	elektrisovat
zelený	zelí,Zelenkov
zelina	zelí
zelí	zelený,Zelina,zelina
zem	zeď,um
zeměbrana	membrána
zen	zenit,nový,den
zenit	zen
zesentimentálnit	zesentimentálnět
zesentimentálnět	zesentimentálnit
zesilnit	zesilnět,násilnit
zesilnět	zesilnit
zesinavět	zsinavět,zasinavět
zeskandalisovat	skandalisovat
zeskelnit	zeskelnět
zeskelnět	zeskelnit
zesklovatět	sklovatět
zeskromnit	zeskromnět,uskromnit
zeskromnět	zeskromnit,uskromnit
zeskrovnit	zeskrovnět,uskrovnit
zeskrovnět	zeskrovnit
zeslavnostnit	zeslavnostnět
zeslavnostnět	zeslavnostnit
zesličnit	zesličnět
zesličnět	zesličnit
zeslovanštit	zeslovanštět,zeslovenštit
zeslovanštět	zeslovanštit
zeslovenštit	zeslovanštit
zesmyslnit	znesmyslňovat
zespecialisovat	přespecialisovat,specialisovat
zespolečenštit	zespolečenštět
zespolečenštět	zespolečenštit
zesprostnout	zesprostět
zesprostět	zesprostnout
zesrat	rozesrat,přesrat,přisrat
zestandardisovat	standardisovat
zesteronásobit	zesteronásobnit
zesteronásobnit	zesteronásobit
zestonásobit	zestonásobnit
zestonásobnit	zestonásobit
zestrakatět	zastrakatět
zestraničtit	zestraničtět
zestraničtět	zestraničtit
zestručnit	zestručnět
zestručnět	zestručnit
zestydat	zastydat,vystydat
zestylisovat	vestylisovat,stylisovat,vystylisovat
zestříbrnět	zastříbrnět
zestříbřet	stříbřit
zestřízlivit	střízlivý
zesubjektisovat	zesubjektivisovat
zesubjektivisovat	zesubjektisovat
zesvátečnit	zesvátečnět
zesvátečnět	zesvátečnit
zesvětačet	zesvětačit
zesvětačit	zesvětačet,zasvětačit
zesvětovět	světnice
zesvětštit	zesvětštět
zesvětštět	zesvětštit
zesymbolisovat	symbolisovat
zesympatisovat	sympatisovat,zasympatisovat
zesympatičtit	sympatie
zesyndikalisovat	syndikalismus
zesyrovatět	zesýrovatět
zesýrovatět	zesyrovatět
zet	zeť,ovce
zevropštit	zevropštět,poevropštit
zevropštět	zevropštit
zevšednit	všednět
zevšeobecnit	zevšeobecnět
zevšeobecnět	zevšeobecnit
zextenzívnit	zextenzívnět
zextenzívnět	zextenzívnit
zezvířečtit	zezvířečtět
zezvířečtět	zezvířečtit
zeď	zem
zešedat	zšedat
zešesteronásobit	zšesteronásobit
zešeřet	zšeřet,zašeřet
zešikmit	sešikmit,zešikmět
zešikmět	zešikmit
zešlehat	přišlehat
zešupinkovatět	zešupinovatět,šupinkovatět
zešupinovatět	zešupinkovatět
zešťastnět	znešťastnět
zeť	zet
zfalsifikovat	falsifikovat
zfanfrnit	zfanfrnět
zfanfrnět	zfanfrnit
zfašisovat	fašisovat
zfirnovatět	firnovatět
zfrackovatět	zfraškovatět
zfraškovatět	zfrackovatět
zgelovatět	gelovatět
zgeneralisovat	rozgeneralisovat,vygeneralisovat,generalisovat,zageneralisovat,dogeneralisovat,přegeneralisovat
zgermanisovat	germanisovat
zharmonisovat	harmonisovat
zhavranět	havran
zhedvábnět	hedvábí
zhistorisovat	historisovat
zhlednout	zahlednout
zhloupět	zhlupět,zhlupit
zhlupit	zhlupět,zhloupět,zhlupnout
zhlupnout	zhlupit,zhlupět
zhlupět	zhlupit,zhloupět,zhlupnout
zhládnout	vyhládnout,uhládnout
zhlédat	hlédat,rozhlédat,vyhlédat,ohlédat,vzhlédat,hledat,obhlédat
zhmotnit	zhmotnět
zhmotnět	zhmotnit
zhojnit	zhojnět,rozhojnit
zhojnět	zhojnit,rozhojnit
zhorečnit	zhorečnět
zhorečnět	zhorečnit
zhorčit	zhořčit,uhorčit
zhoupnout	rozhoupnout,houpnout,vyhoupnout
zhořčit	zhorčit,Zhoř
zhranatit	zhranatět
zhranatět	zhranatit
zhrbolatět	hrbolatit
zhrdinštit	zhrdinštět
zhrdinštět	zhrdinštit
zhromadnit	Hromada,hromada
zhrubit	zhrubět,ohrubovat
zhrubět	zhrubit,ohrubovat
zhránit	hranit
zhumanisovat	humanisovat
zhustnout	zahustnout
zhvězdit	vyhvězdit,ohvězdit,přehvězdit
zhybnit	zhybnět
zhybnět	zhybnit
zhášet	uhášet,zahášet
zidealisovat	idealisovat
zima	Zimák
zimprovisovat	improvisovat
zindustrialisovat	industrialisovat
zinicialisovat	rozinicialisovat,inicialisovat,doinicialisovat,odinicialisovat,nainicialisovat,přeinicialisovat
zintensivnit	zintensivnět,zintensivňovat
zintensivnět	zintensivnit,zintensivňovat
zintensivňovat	zintensivnit,zintensivnět
zintenzivnět	zintenzívnět,zintenzivňovat,zintenzívnit
zintenzivňovat	zintenzivnět,zintenzívnit
zintenzívnit	zintenzívnět,zintenzivnět,zintenzivňovat
zintenzívnět	zintenzívnit,zintenzivnět
zintimnit	zintimnět
zintimnět	zintimnit
zinventarisovat	inventarisovat
zionisovat	ionisovat,deionisovat
zitalianisovat	zitalisovat
zitalisovat	zitalianisovat
zjasnit	objasnit,projasnit
zjařit	rozjařit
zjednosměrnit	jednosměrka
zjednostranit	zjednostranět
zjednostranět	zjednostranit
zjednotvárnit	zjednotvárnět
zjednotvárnět	zjednotvárnit
zjednoznačnit	odjednoznačnit
zjemnět	příjemnit
zječmenit	ječmen
zješitnět	ješitný
zkapitalisovat	kapitalisovat
zkatalogisovat	katalogisovat,zakatalogisovat
zkatoličit	zkatoličtit
zkatoličtit	zkatoličit,pokatoličtit
zkladnit	skladnit
zklasicisovat	klasicisovat
zklasičtit	zklasičtět
zklasičtět	zklasičtit
zklihnout	uklihnout
zklihovatět	klihovatět
zkmotrovatět	kmotrovatět
zkolonisovat	kolonisovat
zkomercialisovat	komercialismus
zkomunisovat	komunismus
zkomírat	skomírat
zkondensovat	kondensovat
zkonkretisovat	konkretisovat
zkonkrétnit	zkonkrétnět,konkrétní
zkonkrétnět	zkonkrétnit,konkrétní
zkonservovat	konservovat,zakonservovat
zkonvenčnit	zkonvenčnět
zkonvenčnět	zkonvenčnit
zkonzervativnět	konzervativní,neokonzervativní
zkorkovatět	zkorovatět
zkorovatět	zkorkovatět
zkouzelnit	zkouzelnět
zkouzelnět	zkouzelnit
zkrabit	zakrabit
zkrepatět	krepatět
zkritisovat	zakritisovat,kritisovat
zkrouhnout	okrouhnout,zakrouhnout,odkrouhnout
zkrvavit	zkrvit,okrvavit,ukrvavit
zkrvit	zkrvavit,vykrvit,dokrvit,odkrvit
zkrystalisovat	vykrystalisovat,krystalisovat
zkulturnit	zkulturnět
zkulturnět	zkulturnit
zkusit	okusit
zkvítat	rozkvítat,dokvítat,odkvítat
zkárovat	nakárovat
zkáznit	vykáznit
zkřemenět	zkřemeňovat,prokřemenit,odkřemenit
zkřemeňovat	zkřemenět
zlacinit	zlacinět
zlacinět	zlacinit
zlahodnit	zlahodnět
zlahodnět	zlahodnit
zlaicisovat	laicisovat
zlakomit	zlakomět
zlakomět	zlakomit
zlakotnit	zlakotnět
zlakotnět	zlakotnit
zlatinit	zlatinštit
zlatinštit	zlatinit
zlatokop	zlatokopec
zlatokopec	zlatokop
zlatý	zlatět
zlatý	zlatět
zlatět	zlatý,zlatý
zlegalisovat	legalisovat
zlehkomyslnět	lehkomyslný
zlikvidnit	likvida
zliterárnit	zliterárnět
zliterárnět	zliterárnit
zlogičtit	zlogičtět
zlogičtět	zlogičtit
zlokalisovat	lokalisovat
zludračet	zludračit
zludračit	zludračet
zlumpačit	zalumpačit
zlyričtit	zlyričtět
zlyričtět	zlyričtit
zlíbeznit	zlíbeznět
zlíbeznět	zlíbeznit
zlínět	Zlín
zlít	zlítit,lít
zlítit	zlít,rozlítit
zlítostnět	lítostnit
zlý	podlý
zmachlovat	zamachlovat
zmahat	zmahač
zmahač	zmahat
zmalichernit	zmalichernět
zmalichernět	zmalichernit
zmalit	zmálit
zmalomocnit	zmalomocnět
zmalomocnět	zmalomocnit
zmalomyslnit	malomyslný
zmanout	vymanout,umanout,namanout
zmanýrovat	zmanýrovatět
zmanýrovatět	zmanýrovat
zmatit	zmatovatět
zmatnit	zmatnět
zmatnět	zmatnit
zmatovatět	zmatit
zmačknout	rozmáčknout,vymáčknout
zmdlet	omdlet
zmechanisovat	mechanisovat
zmelodičtit	zmelodičtět
zmelodičtět	zmelodičtit
zmetat	vymetat,metat
zmezinárodnit	zmezinárodnět,mezinárodní
zmezinárodnět	zmezinárodnit
zmezit	vymezit
zmije	Zmij
zmilosrdnit	zmilosrdnět
zmilosrdnět	zmilosrdnit
zmilostnit	zmilostnět
zmilostnět	zmilostnit
zmléčnit	zmléčnět
zmléčnět	zmléčnit
zmnohonásobit	zmnohonásobnit,mnohonásobek
zmnohonásobnit	zmnohonásobit,mnohonásobek
zmobilisovat	rozmobilisovat,umobilisovat,omobilisovat,promobilisovat,vymobilisovat,přemobilisovat,mobilisovat,domobilisovat,pomobilisovat,odmobilisovat,zamobilisovat,přimobilisovat,namobilisovat,vmobilisovat,demobilisovat
zmocnit	zmocnět
zmocnět	zmocnit
zmodernisovat	modernisovat
zmodrchat	zamodrchat
zmokat	vymokat
zmonopolisovat	monopolisovat
zmotorisovat	motorisovat
zmoučit	umoučit,pomoučit
zmozolnět	zmozolňovat
zmozolňovat	zmozolnět
zmračovat	zmráčit
zmrzat	rozmrzat,omrzat,vymrzat,umrzat,promrzat
zmrzoutět	zmrzutět
zmrzutět	zmrzoutět
zmráčit	omráčit,zmračovat
zmutýrovat	vymutýrovat
zmužštit	zmužštět
zmužštět	zmužštit
zmálit	zmalit
zmátnout	pomátnout,namátnout
zmútit	zamútit
změdlit	vymědlit
změlčet	změlčit
změlčit	změlčet,Změlík
změšťáčtit	změšťáčtět
změšťáčtět	změšťáčtit
znacisovat	odnacisovat
znamenat	znamení
znamení	znamenat
znatel	znát,značit
znaturalisovat	naturalisovat
znavit	unavit
značit	znát,zonačit,znatel,zaonačit
znecitlivit	znecitlivět
znecitlivět	znecitlivit
znedůvěřit	znedůvěřivět
znedůvěřivět	znedůvěřit
znegativnět	negativní
znehybnit	znehybnět
znehybnět	znehybnit
zneklidnit	zneklidnět
zneklidnět	zneklidnit
znemravnit	znemravnět
znemravnět	znemravnit
znepravidelnit	znepravidelnět
znepravidelnět	znepravidelnit
zneprůchodnit	zneprůchodnět
zneprůchodnět	zneprůchodnit
znepříjemnit	znepříjemnět
znepříjemnět	znepříjemnit
znepřítomnět	znepřítomňovat
znepřítomňovat	znepřítomnět
znervosnit	znervosnět,znervosňovat
znervosnět	znervosnit,znervosňovat
znervosňovat	znervosnit,znervosnět
znervóznět	nervóznit
zneschopnit	uschopnit
znesmyslňovat	zesmyslnit
znesnadit	znesnadnit
znesnadnit	znesnadit
zneutralisovat	neutralisovat
znevolnit	znevolničit
znevolničit	znevolnit
znešvařit	zanešvařit
znešťastnět	zešťastnět,nešťastník
znicotnět	znicotňovat
znicotňovat	znicotnět
znikat	onikat,vznikat,zanikat,vynikat,vnikat,unikat
zniternit	zniternět,zvniternit
zniternět	zniternit,zvniternět
znivelisovat	novelisovat
znobilisovat	nobilisovat
znoj	znojit
znojit	znoj
znormalisovat	normalisovat,pronormalisovat,donormalisovat,přenormalisovat
znovubudovat	znovuzbudovat,znovuvybudovat
znovudosadit	znovuosadit,znovuusadit
znovunabít	znovunabýt
znovunabýt	znovunabít
znovuobživit	znovuoživit
znovuosadit	znovudosadit,znovuusadit
znovuoživit	znovuobživit
znovupostavit	znovuustavit
znovupřipojit	znovuzapojit
znovuusadit	znovuosadit,znovudosadit
znovuustanovit	znovuustavit
znovuustavit	znovuustanovit,znovupostavit
znovuvybudovat	znovuzbudovat,znovubudovat
znovuzapojit	znovupřipojit
znovuzbudovat	znovuvybudovat,znovubudovat
znovuzprovoznit	zprovoznit
znádhernit	znádhernět
znádhernět	znádhernit
znáhlit	přenáhlit
znápadnět	pozápadnět
znárodnět	odnárodnit
znát	znatel,značit
znít	nit,znělka,dnít,nítit,nový,vznítit
zněkolikanásobit	zněkolikanásobnit
zněkolikanásobnit	zněkolikanásobit
znělka	znít
zněmit	zněmět
zněmčit	poněmčit,zaněmčit,Němčice
zněmět	zněmit
zněžnit	zněžnět,rozněžnět
zněžnět	zněžnit,rozněžnět
zobjektisovat	zobjektivisovat
zobjektivisovat	zobjektisovat
zobloučit	vyobloučit,zaobloučit
zobyčejnit	zobyčejnět
zobyčejnět	zobyčejnit
zobčanštit	zobčanštět
zobčanštět	zobčanštit
zocelet	docelit
zodbornit	zodbornět,zodborničtit
zodborničtit	zodborničtět,zodbornit
zodborničtět	zodborničtit
zodbornět	zodbornit
zoficiálnit	zoficiálnět
zoficiálnět	zoficiálnit
zohavit	zohavět
zohavět	zohavit
zohebnit	zohebnět
zohebnět	zohebnit
zohnit	rozohnit
zohyzdnit	zohyzdnět
zohyzdnět	zohyzdnit
zonačit	značit,zaonačit
zondat	uondat
zootechnika	technika
zopatrnět	zpatrnit
zoptimalisovat	optimalisovat
zorganisovat	reorganisovat,organisovat,zreorganisovat,přeorganisovat
zostražitět	stražit
zotavit	tavit
zoufat	doufat
zout	out,dout,půst
zouředničit	Ouředník
zouředničtit	zúředničtit
zpadesátinásobit	zpadesátinásobnit
zpadesátinásobnit	zpadesátinásobit
zpaličatět	zpaličkovatět
zpaličkovatět	zpaličatět
zparalysovat	paralysovat
zparchantit	zparchantět
zparchantět	zparchantit
zpartykařit	zapartykařit,vypartykařit
zpasivnit	zpasivnět,pasivní
zpasivnět	zpasivnit
zpateronásobit	zpateronásobnit
zpateronásobnit	zpateronásobit
zpatrnit	zopatrnět
zpersiflovat	persiflovat
zpestřet	zpestřit,pestřit
zpestřit	pestřit,zpestřet
zpevnět	pevný
zpeřit	vypeřit,opeřit,přepeřit,zapeřit
zpikantnit	zpikantnět,pikantní
zpikantnět	zpikantnit,pikantní
zpikartit	pikart
zpikhartit	pikhart
zplacatit	zplacatět,poplacat,placatý
zplacatět	zplacatit,poplacat,placatý
zplamenat	zplamenit,zplamenět
zplamenit	zplamenět,rozplamenit,zplamenat
zplamenět	zplamenit,rozplamenit,zplamenat
zplanit	vyplanit
zplastičtit	zplastičtět
zplastičtět	zplastičtit
zplavnit	plavat
zplavět	vyplavět
zplnoletit	zplnoletnit
zplnoletnit	zplnoletit
zplnomocnit	plnomocný
zplodnit	zplodnět
zplodnět	zplodnit
zploštit	oploštit,sploštit,zploštět,oploštět
zploštět	oploštět,zploštit,oploštit
zplynět	plynit
zpodobit	vypodobit,napodobit,zpodobnit,připodobit,spodobit
zpodobnit	vypodobnit,zpodobit,připodobnit
zpodstatnit	zpodstatnět,přepodstatnit
zpodstatnět	zpodstatnit,přepodstatnit
zpolarisovat	polarisovat
zpolitisovat	zapolitisovat
zpolštit	popolštit
zpoplatnit	uplatnit
zpopruhovatět	zpruhovatět
zpopularisovat	popularisovat
zpopulárnit	zpopulárnět,populární
zpopulárnět	zpopulárnit,populární
zposvátnit	zposvátnět
zposvátnět	zposvátnit
zpovrchnit	zpovrchnět
zpovrchnět	zpovrchnit
zpovšechnit	zpovšechnět,upovšechnit
zpovšechnět	zpovšechnit,upovšechnit
zpozemštět	pozemštit
zprahat	vyprahat
zpraktičtit	zpraktičtět
zpraktičtět	zpraktičtit
zpravdit	upravdit
zpravděpodobnit	pravděpodobný
zpravidelnit	zpravidelnět
zpravidelnět	zpravidelnit
zprimitisovat	zprimitivisovat
zprimitivisovat	zprimitisovat
zprimitivnit	zprimitivnět,primitivní
zprimitivnět	zprimitivnit
zprofesionalisovat	profesionalisovat
zprostit	oprostit,vyprostit,sprostit
zprostit	oprostit,vyprostit,sprostit
zprostonárodnit	zprostonárodnět
zprostonárodnět	zprostonárodnit
zprostopášnit	prostopášný
zprotivnět	zprotivňovat
zprotivňovat	zprotivnět
zprovoznit	znovuzprovoznit
zpruhovatět	zpopruhovatět
zpružnit	zpružnět
zpružnět	zpružnit
zpráchnět	práchnivý
zpráhnout	zapráhnout,prahnout
zprázdnět	uprázdnit
zprůchodnit	zprůchodnět
zprůchodnět	zprůchodnit
zprůhlednit	průhlednět
zprůmyslnit	zprůmyslnět,odprůmyslnit
zprůmyslnět	zprůmyslnit,odprůmyslnit
zprůsvitnit	průsvitnět
zprůzračnit	zprůzračnět
zprůzračnět	zprůzračnit
zpsychologisovat	zapsychologisovat
zptýlit	rozptýlit
zpuchýřkovatět	puchýřovatět
zpupkatět	zpupkovatět
zpupkovatět	zpupkatět
zpychat	zpýchat
zpátek	pátek
zpívat	zpět
zpíčit	vypíčit,zpěčit,píča
zpórovatět	pórovatět
zpýchat	zpychat
zpěknit	zpěknět
zpěknět	zpěknit
zpět	zpětit,pět,opět,supět,zpětvzít,zpívat
zpětit	zpět,zpětvzít
zpětvzít	zpětit,zpět
zpěčit	zpěčovat,zpíčit,Pěč,vzpěčovat
zpěčovat	zpěčit,vzpěčovat,Pěč
zpřehledat	zpřehlednit,přehlédat
zpřehlednit	zpřehledat
zpřesnět	přísnět
zpřídavnět	zpřídavňovat
zpřídavňovat	zpřídavnět
zpříjemnět	příjemnit
zpřírodnit	odpřírodnit
zpřístupnit	zpřístupnět
zpřístupnět	zpřístupnit
zpřítomnit	zpřítomnět
zpřítomnět	zpřítomnit
zpřízvučnit	zpřízvučnět
zpřízvučnět	zpřízvučnit
zpříšernit	zpříšernět
zpříšernět	zpříšernit
způvabnit	způvabnět
způvabnět	způvabnit
zrabiátnit	zrabiátnět
zrabiátnět	zrabiátnit
zradostnit	zradostnět,rozradostnět
zradostnět	rozradostnět,zradostnit
zrak	rak,zázrak
zrašelinět	zrašeliňovat
zrašeliňovat	zrašelinět
zrealisovat	realisovat
zrealističtit	zrealističtět
zrealističtět	zrealističtit
zrecensovat	recensovat
zremisovat	remisovat
zreorganisovat	reorganisovat,přeorganisovat,organisovat,zorganisovat
zresonovat	rozresonovat,vyresonovat,doresonovat,resonovat,odresonovat
zrevolucionisovat	revolucionisovat
zreálnit	zreálnět
zreálnět	zreálnit
zrichtovat	porichtovat
zrohatit	zrohatět
zrohatět	zrohatit
zromanisovat	zromantisovat
zromantisovat	zromanisovat
zromantičtit	zromantičtět
zromantičtět	zromantičtit
zrozkošnit	zrozkošnět
zrozkošnět	zrozkošnit
zruchat	zaruchat
zrudit	zrudnit
zrudnit	zrudit
zrujnit	zrujnovat
zrujnovat	zrujnit
zruměnět	ruměnit,zaruměnět
zruštit	poruštit
zryšavět	ryšavět
zrůžovatět	zarůžovatět
zsinavět	zesinavět,zasinavět
ztajemnit	ztajemnět
ztajemnět	ztajemnit
ztalácet	zatalácet
zteatrálnit	zteatrálnět,teatrální
zteatrálnět	zteatrálnit
ztechničtit	ztechničtět
ztechničtět	ztechničtit
ztekutit	ztekutět
ztekutět	ztekutit
ztenknout	tenký
zteplit	vyteplit,Teplice,uteplit,doteplit
zterorisovat	terorisovat
ztichat	zatichat
ztisíceronásobit	ztisíceronásobnit
ztisíceronásobnit	ztisíceronásobit
ztitěrnit	ztitěrnět
ztitěrnět	ztitěrnit
ztrojit	roztrojit
ztrojnásobit	ztrojnásobnit,trojnásobek
ztrojnásobnit	ztrojnásobit
ztrouchnět	trouchnivý
ztroudnatět	ztroudovatět
ztroudovatět	ztroudnatět
ztrpčet	ztrpčit,roztrpčit
ztrpčit	roztrpčit,ztrpčet,zatrpčit
ztrudnit	ztrudnět,zatrudnit
ztrudnět	ztrudnit
ztučnit	vytučnit
zubožet	zubožit
zubožit	zubožet
zuhelnit	zuhelnět
zuhelnět	zuhelnit
zuhličit	nauhličit
zukat	dukát
zumělečtit	zumělečtět
zumělečtět	zumělečtit
zunkat	zuňkat
zupat	supat,dupat,pat
zurbanisovat	urbanisovat
zutilisovat	utilisovat
zutrakvisovat	utrakvisovat
zuňkat	zunkat
zvadat	zavadat,ovadat,uvadat
zvalorisovat	dovalorisovat,valorisovat
zvandalisovat	vandalisovat
zvedat	nazvedat,přizvedat
zvelebnit	velebník,velebit
zveličet	veličit
zvisitovat	visitovat
zvisitýrovat	visitýrovat
zvitaminisovat	ovitaminisovat,vitaminisovat,navitaminisovat,odvitaminisovat,dovitaminisovat,přivitaminisovat,převitaminisovat
zvlhat	vlhat,provlhat,zavlhat
zvláštňovat	ozvláštnit
zvlídnit	vlídný
zvniternit	zvniternět,zniternit
zvniternět	zvniternit,zniternět
zvnitřnit	zvnitřnět
zvnitřnět	zvnitřnit
zvrhat	vyvrhat,vrhat,zavrhat,povrhat
zvrtohlavit	vrtohlavět
zvrtošit	zavrtošit
zvulgarisovat	vulgarisovat,zavulgarisovat
zvulgárnit	zvulgárnět,vulgární
zvulgárnět	zvulgárnit
zvulkanisovat	vulkanisovat,zavulkanisovat,předvulkanisovat,dovulkanisovat
zvykat	vykat,uvykat
zvážnit	zvážnět
zvážnět	zvážnit
zvýraznit	zvýraznět
zvýraznět	zvýraznit
zvýtvarnit	výtvarničit
zvýznamnit	zvýznamnět
zvýznamnět	zvýznamnit
zvěcnit	zvěcnět
zvěcnět	zvěcnit
zvědečtit	zvědečtět
zvědečtět	zvědečtit
zvědomit	uvědomit
zvěr	zvěř
zvěčnět	uvěčnit
zvěř	zvěr,zazvěřit,přezvěřit
záběl	Zábel
záhoř	záhoří,Záhor
záhoří	záhoř,Záhor
záhumenka	záhumení
záhumení	záhumenka
zájemný	vzájemný,jemný
zájezdný	přejezdný
základ	základna
základna	základ
zámečničit	Zámečník
zámišník	Zámiš
zápas	pas
záplata	záplatář
záplatář	záplata
záplet	plít,plít
zápolit	apolit
zápraž	práh
zásvětný	zásvětí,světnice
zásvětí	zásvětný
zátinek	zátka
zátka	zátinek
závada	zavadat
závoj	závojnatý
závojnatý	závoj
závorář	Závora
zázrak	zázračit,zrak
zázračit	zázrak
zázvor	Zázvora
záškodničit	záškodný
záškodný	záškodničit
zírat	vyzírat,odzírat
zíta	Zita
zívat	Zita
zóna	ozón
zúrodnit	zúrodnět
zúrodnět	zúrodnit
zúskostnit	zúzkostnit
zústavnit	ústava
zútulnět	útulnit
zúzkostnit	zúzkostnět,zúskostnit
zúzkostnět	zúzkostnit
zúředničtit	zouředničtit
zčechisovat	čechisovat
zčernět	Černín
zčerstvět	čerstvý
zčlověčit	zčlověčtit,učlověčit,člověk
zčlověčtit	zčlověčit,učlověčit
zřemeslnit	řemeslnět
zřečtit	pořečtit
zřídký	řídký
zřít	pozřít
zšedat	ušedat,zešedat,zašedat,prošedat
zšesteronásobit	zešesteronásobit
zšeřet	zešeřet,zašeřet
zživotnit	uživotnit
zživět	živit
zžáhat	žahat,žáhnout
zžásat	žasnout
Ábel	Zábel
Ázerbajdžán	Ázerbájdžán
Ázerbájdžán	Ázerbajdžán
úbor	bor
úchylka	úchylkařit
úchylkařit	úchylka
úhor	úhoř
úhoř	úhořit,úhor
úhořit	úhoř
úrok	prorok
ústava	zústavnit
ústroj	stroj
ústup	ústupkář
ústupkařit	ústupkář
ústupkář	ústupkařit,ústup
útulnit	zútulnět,útulný
útulný	útulnit
úvodníkařit	úvodníkář
úvodníkář	úvodníkařit
účel	účet
účet	účel
Čad	čadit
Čchin	Čching
Čching	Čchin
Čech	Čechov,čecháček,Čechák
Čechov	Čech,čecháček
Čechák	čecháček,Čech
Čekan	čekat
Čepela	čepel
Černo	černý,Černov,Černík
Černov	Černo,černý,Černík,Černín
Černík	černý,Černo,Černov
Černín	zčernět,Černov,Čerňan
Červenka	červený
Červík	červ
Čerňan	Černín
Čihák	čihač
Čud	čudit
Čunek	čuník
Čína	čina
čachrařit	čachrář
čachrář	čachrařit
čadit	Čad
čas	časit
časit	čas
časomíra	časoměr
časoměr	časomíra,časoměřič
časoměřič	časoměr
častit	častovat,častý
častovat	častit,častý
častý	část,častovat,častit
čechisovat	zčechisovat
čechman	čechmant
čechmant	čechman
čecháček	Čechák,Čech,Čechov
čeka	čekovat,čekat
čekat	čeka,Čekan
čekovat	čeka
čepec	čepel,čepit
čepel	Čepela,čepec,čepit
čepit	čepec,čepel
čerchman	čerchmant
čerchmant	čerchman
černý	Černo,Černík,Černov
čerstvý	zčerstvět
červ	Červík,červený
červený	Červenka,červ
česlo	číslo
čeřit	čířit
čihač	Čihák,číhat
čin	čina
čina	čin,Čína,příčina
čistý	číst
čiřit	čířit
člověk	zčlověčit
čmuchat	dočmuchat,pročmuchat,vočmuchat
čnít	čnět
čnět	čnít
čokl	čočka
čouhat	vyčouhat
čočka	čokl
črtat	načrtat
čtvrt	čtvrtník
čtvrtník	čtvrt
čtyřnásobek	čtyřnásobit
čtyřnásobit	čtyřnásobek
čudit	Čud
čuník	Čunek
čurat	očurat
čára	čáry
čáry	čára
část	častý
číhat	čihač
číslo	česlo
čísnout	pročísnout
číst	čistý
čít	načít,začít,začít,začít,počít
čířit	čiřit,čeřit
ďábel	ďábelný
ďábelný	ďábel
ňuchat	ňuchňat
ňuchňat	ňuchat
Řehák	Říhák
Řek	řeka,rek,Řečice,řečit
Řezník	řezničit
Řezáč	řezat
Řečice	řečit,Řek,řeka
Řihák	Říhák,říhat
Říha	Říhák,říhat
Říhák	Řihák,Říha,říhat,Řehák
Řím	římsa
řad	řada,pořad
řada	řad
řasa	rasa
řehol	řeholit
řeholit	řehol
řeka	Řek,Řečice,řečit
řemeslnět	zřemeslnit
řetízkář	řetěz
řetěz	řetízkář
řezat	Řezáč
řezničit	Řezník
řečit	Řečice,Řek,řeka
řincnout	řinout
řinout	řincnout
řvát	rvát
říci	řítit
řídit	řídký
řídký	zřídký,řídit
říhat	Říhák,Říha,Řihák
římsa	Řím
řítit	říci
Šak	šašek
Šalamoun	Šalomoun
Šalomoun	Šalamoun
Šamánek	šaman
Šan	Šanov,šanovat,šance,Ašanin
Šanov	Šan,šanovat
Šik	šikovný,šiknout,šikana
Šilhavý	šilhat
Šima	Šimák,Šíma,Šimon
Šimon	Šimoník,Šimůnek,Šima
Šimoník	Šimon,Šimůnek
Šimák	Šima
Šimůnek	Šimoník,Šimon
Šiša	šiška,šišatý
Šlapák	šlapat
Špachta	špachtle
Špetík	špetka,špetnout,špek
Špina	špína,Špinar,špice,špicl,špic
Špinar	Špina,špice,špína
Špora	Špůr
Špůr	Špora
Štika	etika
Štoll	štola
Štýr	štír,štěrk
Štětkař	štětkář,štětina,štět,štítit
Šust	šustit
Šuster	šustit
Švihov	švihat
Šíma	Šima
Šťavík	šťovík
šach	šachta
šachta	šach
šalina	šálit,šál,šalovat
šalovat	šalina,šál,šálit
šaman	Šamánek
šance	Šan
šanovat	Šan,Šanov
šat	šaty,šátek,šátkař
šaty	šat,šátek
šašek	Šak
šereda	šeredit
šeredit	šereda
šerka	šerý
šerm	šerý
šerý	šerm,šerka
šeřit	sešeřit
šifra	cifra
šikana	Šik,šiknout
šiknout	šikovný,Šik,šikana
šikovný	Šik,šiknout
šilhat	Šilhavý
široký	širý
širý	široký
šišatý	Šiša,šišatět
šišatět	šišatý
šiška	Šiša
škaredit	škaredý
škaredý	škaredit
škatule	škatulář
škatulář	škatule
škoda	škodovka,škůdný
škodovka	škoda
škot	škotit
škotit	škot
škrob	škrobit
škrobit	škrob
škrtat	seškrtat
škrábat	proškrabat
škudlit	škádlit
škvíra	škvířit
škvířit	škvíra
škádlit	škudlit
škůdný	škoda
šlak	šlakovat
šlakovat	šlak
šlapat	Šlapák
šlichta	šlichtař
šlichtař	šlichta
šmajchlovat	šmajchlíř
šmajchlíř	šmajchlovat
šmejdit	šmejdíř
šmejdíř	šmejdit
šmelc	šmelcovat,šmelit
šmelcovat	šmelc
šmelit	šmelc
šmírař	šmírařit,šmírovat
šmírařit	šmírař,šmírovat
šmírovat	šmírař,šmírařit
šohaj	šohajík
šohajík	šohaj
špachtle	Špachta
špek	Špetík
špendlík	špendlíkář
špendlíkář	špendlík
špetka	Špetík,špetnout
špetnout	špetka,Špetík
špic	špice,špicl,Špina
špice	špicl,špic,Špina,Špinar,špína
špicl	špice,špic,Špina,špiclovat
špiclovat	špicl
špion	špión
špitat	špitál
špitál	špitat
špión	špion
špláchat	ošpláchnout,vyšpláchnout
špína	Špina,špice,Špinar
šrot	šrotit
šrotit	šrot
štika	etika
štkát	vyštkat
štochnout	štuchnout
štola	Štoll
štrachat	vyštráchat
štuchnout	štochnout
štupovat	štustupovat
štustupovat	štupovat
štípat	štípit
štípit	vštípit,štěpit,štípat
štír	štířit,Štýr,štěrk,štěrkař
štít	štítit,štět,dštít,štětina
štítit	štít,štět,štětina,štětkář,dštít,Štětkař
štířit	štír
štěnice	štěně
štěně	štěnice
štěpařit	štěpit
štěpit	štípit,štěpařit
štěrk	štír,štěrkař,Štýr
štěrkař	štěrk,štír
štět	štít,štětina,štítit,štětkář,Štětkař
štětina	štětkář,štět,Štětkař,štítit,štít
štětkář	Štětkař,štětina,štět,štítit
šukat	ušukat
šupinkovatět	zešupinkovatět
šustit	Šust,šustnout,Šuster,všustět
šustnout	šustit
švadlenit	švadlenčit
švadlenčit	švadlenit
švihat	pošvihat,Švihov
šál	šálit,šalina,šalovat
šálit	šál,šalina,šalovat
šátek	šat,šátkař,šaty
šátkař	šátek,šat
šéf	šíf
šíf	šéf
šťouchat	pošťouchat,šťuchat
šťourat	rozšťourat
šťovík	Šťavík
šťuchat	šťouchat
ťapat	ťápat
ťupat	oťupat,poťupat,tupat
ťápat	ťapat,tápat
Ženeva	žengle
Žitný	žito,žít
Živkov	živit
Žižka	Žižkov
Žižkov	Žižka
Žítek	žít
žabec	žabit
žabit	žabec
žahat	zžáhat,žáhnout
žal	žalost,žalovník
žalost	žal,žalář,žalářit,žalovník
žalovník	žal,žalost
žalud	žaludek
žaludek	žalud
žalář	žalářit,žalost
žalářit	žalář,žalost
žasnout	zžásat
žbrblat	brblat
žduchat	žďuchat
žebrat	prožebrat
žehlit	žehlíř
žehlíř	žehlit
žena	ženovat
žengle	Ženeva
ženovat	žena
ženýrovat	žinýrovat
žeravit	žeravět
žeravět	žeravit
žert	žertva
žertva	žert
žinýrovat	ženýrovat
žito	Žitný,žít
živel	živit
živit	Živkov,živel,zživět
životadárce	životodárce
životodárce	životadárce
žokej	hokej
žrát	požrat
žvastat	žvástat
žvástat	žvastat
žáhnout	zžáhat,žahat
žár	požár,Požár
žíně	džíny
žít	žito,Žítek,Žitný
žďuchat	žduchat
