briskně	ADV
dvacetitprocentní	ADJ
dvouapůlitrovost	NOUN
dvouapůlitrový	ADJ
mikrowat	NOUN
miliwat	NOUN
oxydace	NOUN
paralizovací	ADJ
paralizovaně	ADV
paralizování	NOUN
paralizovanost	NOUN
paralizovaný	ADJ
paralizovatelně	ADV
paralizovatelnost	NOUN
paralizovatelný	ADJ
paralizovat	VERB
paralizovávací	ADJ
paralizovávaně	ADV
paralizovávání	NOUN
paralizovávanost	NOUN
paralizovávaný	ADJ
paralizovávatelně	ADV
paralizovávatelnost	NOUN
paralizovávatelný	ADJ
paralizovávat	VERB
pěnězchtivý	ADJ
půlitr	NOUN
řachtací	ADJ
řachtaně	ADV
řachtanost	NOUN
řachtaný	ADJ
řachtatelně	ADV
řachtatelnost	NOUN
řachtatelný	ADJ
řachtat	VERB
řachtávací	ADJ
řachtávaně	ADV
řachtávanost	NOUN
řachtávaný	ADJ
řachtávatelně	ADV
řachtávatelnost	NOUN
řachtávatelný	ADJ
řechtací	ADJ
řechtaně	ADV
řechtanost	NOUN
řechtaný	ADJ
řechtatelně	ADV
řechtatelnost	NOUN
řechtatelný	ADJ
řechtat	VERB
řechtávací	ADJ
řechtávaně	ADV
řechtávanost	NOUN
řechtávaný	ADJ
řechtávatelně	ADV
řechtávatelnost	NOUN
řechtávatelný	ADJ
ruměnně	ADV
ruměnnost	NOUN
ruměnný	ADJ
sasskost	NOUN
sasský	ADJ
sassky	ADV
ssání	NOUN
ssát	VERB
ssutina	NOUN
sysál	NOUN
třiapůlitrově	ADV
třiapůlitrovost	NOUN
třiapůlitrový	ADJ
věděckotechnický	ADJ
vodvýzt	VERB
vyssávaně	ADV
vyssávaný	ADJ
vyssávávanost	NOUN
vyssávávatelnost	NOUN
vývodění	NOUN
vývoděnost	NOUN
vývodit	VERB
zařachtací	ADJ
zařachtaně	ADV
zařachtanost	NOUN
zařachtaný	ADJ
zařachtatelně	ADV
zařachtatelnost	NOUN
zařachtatelný	ADJ
zařachtat	VERB
zařachtávací	ADJ
zařachtávaně	ADV
zařachtávanost	NOUN
zařachtávaný	ADJ
zařachtávatelně	ADV
zařachtávatelnost	NOUN
zařachtávatelný	ADJ
zařechtací	ADJ
zařechtaně	ADV
zařechtanost	NOUN
zařechtaný	ADJ
zařechtatelně	ADV
zařechtatelnost	NOUN
zařechtatelný	ADJ
zařechtat	VERB
zařechtávací	ADJ
zařechtávaně	ADV
zařechtávanost	NOUN
zařechtávaný	ADJ
zařechtávatelně	ADV
zařechtávatelnost	NOUN
zařechtávatelný	ADJ
každodennní	ADJ
každodennně	ADV
