aklamovat	lamovat
anualizovat	lizovat
avalovat	valovat
biopodnikat	nikat
blamovat	lamovat
chaptalizovat	lizovat
chlamstat	stat
chlastat	stat
chlemstat	stat
chlístat	stat
chramstat	stat
chroustat	stat
chřoustat	stat
chrstat	stat
chvástat	stat
chystat	stat
čnít	nít
čumět	mět
dekapovat	kapovat
deklamovat	lamovat
desensibilizovat	lizovat
dnít	nít
+dobělovat	bělovat
+dobíhat	bíhat
+dobuzovat	buzovat
dohodnout	hodnout
+domílat	mílat
+domírat	mírat
+domrazovat	mrazovat
+dopřesnit	přesnit
dostat	stat
+dostřeďovat	střeďovat
+dosychat	sychat
+dosýchat	sýchat
+dotláčet	tláčet
+dovářet	vářet
+dožebračit	žebračit
dřevoobrábět	rábět
egalizovat	lizovat
emanovat	manovat
exhalovat	halovat
fabulizovat	lizovat
galvanovat	vanovat
gratulovat	tulovat
hejčkat	čkat
hnít	nít
honosit	osit
hýčkat	čkat
inhalovat	halovat
inovovat	novovat
instalovat	stalovat
involovat	volovat
isolovat	solovat
kaučovat	učovat
klábosit	osit
klohnit	ohnit
komparovat	parovat
kopulovat	pulovat
kovoobrábět	rábět
kročit	ročit
křoustat	stat
mačkat	čkat
manažovat	nažovat
manipulovat	pulovat
+nabízet	bízet
načuhovat	čuhovat
+nadbíhat	bíhat
+nadeběhnout	běhnout
+nadlábnout	dlábnout
+nadstřešit	střešit
nakolejit	kolejit
nakročit	ročit
+nakvartýrovat	kvartýrovat
+nalepšovat	lepšovat
+namíchnout	míchnout
namítat	mítat
+namokat	mokat
+namrzat	mrzat
napomínat	pomínat
+napřahat	přahat
+naskladnit	skladnit
+nastehnout	stehnout
+nastýlat	stýlat
+natěsňovat	těsňovat
nauhličit	uhličit
+navářet	vářet
navnímat	nímat
+navolňovat	volňovat
nivelizovat	lizovat
nízkovyzařovat	zařovat
+obelstít	lstít
+obemílat	mílat
+obhlížet	hlížet
+obíhat	bíhat
obkližovat	kližovat
obkročit	ročit
+oblbit	blbit
+obmýšlet	mýšlet
+ochládat	chládat
+ochlupit	chlupit
ochomítat	mítat
ochromit	hromit
octnout	ctnout
+odbíhat	bíhat
+odblanit	blanit
+odbožštit	božštit
odbuzovat	buzovat
+odchlupit	chlupit
+odcukernit	cukernit
oddvojmocňovat	mocňovat
+odebíhat	bíhat
+odestýlat	stýlat
+odhlížet	hlížet
+odhmotnit	hmotnit
odhmyzit	hmyzit
odhušťovat	hušťovat
odkysličit	kysličit
+odlednit	lednit
+odlidnit	lidnit
+odlidštit	lidštit
+odměšovat	měšovat
+odmítat	mítat
odmlkat	mlkat
odnáboženštit	ženštit
+odnárodnit	národnit
+odnožit	nožit
odolat	dolat
+odpínat	pínat
+odplynit	plynit
odpočívat	počívat
+odpopelňovat	popelňovat
+odpřahat	přahat
odročit	ročit
odsouvnout	souvnout
+odtělesnit	tělesnit
odtrojmocňovat	mocňovat
+odtučnit	tučnit
+oduševnit	duševnit
+odvláknit	vláknit
oháknout	háknout
+ohospodařovat	hospodařovat
ohrubovat	rubovat
okusit	kusit
okysličit	kysličit
omítat	mítat
+omrzat	mrzat
onikat	nikat
opláknout	pláknout
oplavovat	plavovat
opomínat	pomínat
+opuchat	puchat
opylit	pylit
osamět	samět
ostat	stat
+ostřikovat	střikovat
ostýchat	stýchat
+osychat	sychat
+osýchat	sýchat
otápět	tápět
ovadat	vadat
oždibovat	ždibovat
+ožebračit	žebračit
ozřejmět	mět
ozvláštnit	zvláštnit
ožvykovat	žvykovat
paralizovat	lizovat
peronalizovat	lizovat
pinožit	nožit
plizovat	lizovat
pnít	nít
+pobízet	bízet
pochylovat	chylovat
+podbíhat	bíhat
+podbízet	bízet
+podeběhnout	běhnout
+podemílat	mílat
+podestýlat	stýlat
podlétávat	távat
podměřovat	měřovat
+podmílat	mílat
podnikat	nikat
podpínat	pínat
podpořit	pořit
+podsklepit	sklepit
pohodnout	hodnout
pohřbít	hřbít
poitalštit	italštit
+pojíždět	jíždět
pokatoličit	katoličit
pokatoličtit	katoličtit
pokusit	kusit
+polidštit	lidštit
polouklidnit	lidnit
polykat	lykat
pomět	mět
pomnít	nít
+pomoučnit	moučnit
poohlížet	hlížet
+popobíhat	bíhat
+popolštit	polštit
+pořečtit	řečtit
porozhlížet	hlížet
+poruštit	ruštit
+pošpanělštit	španělštit
pošpatnit	špatnit
postáčet	táčet
poštívat	štívat
postulovat	tulovat
+postýlat	stýlat
posvětštit	světštit
potatit	tatit
potěrat	těrat
povadat	vadat
póvlizovat	lizovat
pozapomínat	pomínat
pozemštit	zemštit
+poženštit	ženštit
+požidovštit	židovštit
požvykovat	žvykovat
+přebíhat	bíhat
přečíslit	číslit
přecitlivět	citlivět
přečkat	čkat
+předeběhnout	běhnout
+předebíhat	bíhat
předhlašovat	hlašovat
předpínat	pínat
předpírat	pírat
předrůstat	stat
předslovovat	lovovat
předtavovat	tavovat
+předvářet	vářet
předzavádět	vádět
překacovat	kacovat
překvašovat	kvašovat
překysličit	kysličit
+přelidnit	lidnit
+přemílat	mílat
přemítat	mítat
preparovat	parovat
+přepichovat	pichovat
přepírat	pírat
přepodstatnit	podstatnit
+přepřahat	přahat
přeřizovat	řizovat
+přerybňovat	rybňovat
+přeskladnit	skladnit
přespořit	pořit
+přestýlat	stýlat
+přesychat	sychat
+přesýchat	sýchat
prevalovat	valovat
+převářet	vářet
+přezatmívat	tmívat
přezvěřit	zvěřit
+přibíhat	bíhat
+přichlazovat	chlazovat
přidlužovat	dlužovat
přifařit	fařit
přikročit	ročit
přikukovat	kukovat
přimačkat	čkat
přimět	mět
+přimílat	mílat
+přimrzat	mrzat
připařovat	pařovat
připodobnit	podobnit
připomínat	pomínat
+připřahat	přahat
přisouvnout	souvnout
+přistehnout	stehnout
přistřelovat	střelovat
+přisychat	sychat
+přisýchat	sýchat
přitělovat	tělovat
přituhat	tuhat
přivstat	vstat
+probíhat	bíhat
+prochládat	chládat
produševnit	duševnit
proklamovat	lamovat
prokysličit	kysličit
promílat	mílat
promítat	mítat
+promrazovat	mrazovat
+promrzat	mrzat
pronikat	nikat
+proplynit	plynit
+prořeďovat	řeďovat
prosit	osit
+prosychat	sychat
+prosýchat	sýchat
protěžovat	těžovat
provázet	vázet
recidivovat	divovat
reklamovat	lamovat
renovovat	novovat
reparovat	parovat
+rozbíhat	bíhat
rozcitlivět	citlivět
rozcitlivit	citlivit
rozdírat	dírat
+rozebíhat	bíhat
+rozemílat	mílat
+rozesychat	sychat
rozesýchat	sýchat
rozevzpomínat	pomínat
rozhodnout	hodnout
+rozklápět	klápět
rozkročit	ročit
+rozmílat	mílat
+rozmítat	mítat
+rozmršťovat	mršťovat
+rozmrzat	mrzat
+rozohnit	ohnit
rozpínat	pínat
+rozpliznout	pliznout
+rozpřahat	přahat
rozprostranit	prostranit
rozpryskovat	pryskovat
rozšeřovat	šeřovat
+rozsychat	sychat
+rozsýchat	sýchat
+roztláčet	tláčet
+roztmívat	tmívat
+rozvářet	vářet
+rozvláknit	vláknit
rozvzpomínat	pomínat
rozžírat	žírat
+rozžvykovat	žvykovat
rychlonapínat	pínat
rychlonatáčet	táčet
rychloupínat	pínat
samoinstalovat	stalovat
samoobčerstvovat	čerstvovat
samoočišťovat	čišťovat
samoodbavovat	bavovat
samoodmrazovat	mrazovat
samoopylit	pylit
samootevírat	vírat
samoposilovat	silovat
samopropisovat	pisovat
samorozpínat	pínat
samorozšiřovat	šiřovat
samorozvinovat	vinovat
samoshromáždit	hromáždit
samosmršťovat	mršťovat
samostmívat	tmívat
samotitulovat	tulovat
samouzavírat	vírat
samovyměřovat	měřovat
samozatmavovat	tmavovat
samozatmívat	tmívat
samozavírat	vírat
samozesilovat	silovat
samozhasínat	hasínat
samozrychlovat	rychlovat
šantročit	ročit
schránět	chránět
sdlužovat	dlužovat
sebeaktualizovat	lizovat
sebekoučovat	učovat
sebekriminalizovat	lizovat
sebenaplňovat	plňovat
sebeobhajovat	hajovat
sebeobnažovat	nažovat
sebeobnovovat	novovat
sebeobviňovat	viňovat
sebeochlazovat	chlazovat
sebeočišťovat	čišťovat
sebeodcizovat	cizovat
sebeodkazovat	kazovat
sebeodměňovat	měňovat
sebeohlupovat	hlupovat
sebeohraničovat	hraničovat
sebeohrožovat	hrožovat
sebeomlouvat	mlouvat
sebeoplodnit	plodnit
sebeoslovovat	lovovat
sebeospravedlňovat	spravedlňovat
sebeosvobozovat	svobozovat
sebeovlivňovat	vlivňovat
sebepochybovat	hybovat
sebepodceňovat	ceňovat
sebepodvádět	vádět
sebepohlcovat	hlcovat
sebepolepšovat	lepšovat
sebepomáhat	máhat
sebepopírat	pírat
sebepopisovat	pisovat
sebeposilovat	silovat
sebeposkvrňovat	skvrňovat
sebepotlačovat	tlačovat
sebepotrestat	stat
sebepotvrzovat	tvrzovat
sebepožírat	žírat
sebepřeceňovat	ceňovat
sebepřekročit	ročit
sebepřemlouvat	mlouvat
sebepřeplňovat	plňovat
sebepřesahovat	sahovat
sebeproměňovat	měňovat
sebeprosazovat	sazovat
seberealizovat	lizovat
seberozdírat	dírat
seberozmělňovat	mělňovat
seberozmnožovat	množovat
sebeshazovat	hazovat
sebestylizovat	lizovat
sebetrestat	stat
sebeubližovat	bližovat
sebeudržovat	držovat
sebeuklidňovat	klidňovat
sebeupevňovat	pevňovat
sebeuplatnit	platnit
sebeupřesňovat	přesňovat
sebeusvědčovat	svědčovat
sebeutvářet	vářet
sebeutvrzovat	tvrzovat
sebeuvědomovat	vědomovat
sebeuzavírat	vírat
sebeuzdravovat	zdravovat
sebevychvalovat	chvalovat
sebevyjádřit	jádřit
sebevylepšovat	lepšovat
sebevyplňovat	plňovat
sebevyšetřovat	šetřovat
sebezapírat	pírat
sebezapomínat	pomínat
sebezasvěcovat	svěcovat
sebezdůvodňovat	důvodňovat
sebezesměšňovat	směšňovat
sebezkrášlovat	krášlovat
sebezlehčovat	lehčovat
sebezlepšovat	lepšovat
sebeznečišťovat	čišťovat
sebezpytovat	pytovat
sebezrazovat	razovat
sebezušlechťovat	šlechťovat
sebezvěčňovat	věčňovat
sebezvětšovat	většovat
separovat	parovat
+sestehnout	stehnout
+sesychat	sychat
+skomírat	mírat
slalomovat	lomovat
slamovat	lamovat
smět	mět
+smílat	mílat
smítat	mítat
+smrákat	mrákat
sněmovat	němovat
solubilizovat	lizovat
šoustat	stat
špízlovat	zlovat
spočívat	počívat
spoludotvářet	vářet
spolunavrhovat	vrhovat
spoluovlivňovat	vlivňovat
spolupodílet	dílet
spolupodnikat	nikat
spoluprovozovat	vozovat
spolurealizovat	lizovat
spolurozdělovat	dělovat
spolurozhodnout	hodnout
spoluschvalovat	chvalovat
spolusdílet	dílet
spoluspalovat	palovat
spoluutvářet	vářet
spoluuvádět	vádět
spoluvyhlašovat	hlašovat
spoluzabírat	bírat
spoluzahajovat	hajovat
spoluzajišťovat	jišťovat
spořit	pořit
+spřahat	přahat
sprašovat	prašovat
stanovit	novit
stěžovat	těžovat
stipulovat	pulovat
+stmívat	tmívat
střídat	řídat
šumět	mět
sžírat	žírat
tmět	mět
topořit	pořit
tvářet	vářet
+ubíhat	bíhat
+uchechtnout	chechtnout
+uchichtnout	chichtnout
učihovat	čihovat
udolat	dolat
udomácnit	domácnit
+uhádnout	hádnout
+uhášet	hášet
uhodnout	hodnout
ukřikovat	křikovat
ukročit	ročit
+umílat	mílat
+umlkat	mlkat
+umoučnit	moučnit
+umrzat	mrzat
unikat	nikat
upláknout	pláknout
uplatnit	platnit
upovědomit	vědomit
+upříjemnit	příjemnit
uprostranit	prostranit
uřknout	řknout
+uskladnit	skladnit
+usklepit	sklepit
uskřinout	skřinout
+uskrovnit	skrovnit
+usouvztažnit	souvztažnit
ustájit	stájit
ustesknout	tesknout
ustupnit	stupnit
+ustýlat	stýlat
+usýchat	sýchat
utájet	tájet
uvadat	vadat
uvěčnit	věčnit
uvědomit	vědomit
uvozovat	vozovat
uživotnit	životnit
uzřejmit	zřejmit
užvykovat	žvykovat
+vbíhat	bíhat
+vbízet	bízet
vdírat	dírat
+veběhnout	běhnout
velkopodnikat	nikat
+vhlížet	hlížet
vkročit	ročit
vmítat	mítat
vnikat	nikat
vokazovat	kazovat
vostat	stat
vpírat	pírat
vplachovat	plachovat
+vpřahat	přahat
vročit	ročit
vrtáčet	táčet
vsákat	sákat
všemurozumět	mět
všeobhospodařovat	hospodařovat
všeobsahovat	sahovat
všepřekrývat	krývat
všezachraňovat	chraňovat
všezahrnovat	hrnovat
vsouknout	souknout
vsouvnout	souvnout
+vtělesnit	tělesnit
vtírat	tírat
+vybíhat	bíhat
+vybízet	bízet
+vybledat	bledat
vybřeskovat	břeskovat
+vychechtnout	chechtnout
+vychládat	chládat
+vychloubat	chloubat
vycukernit	cukernit
+vydlábnout	dlábnout
vydrezovat	rezovat
vyfantasovat	tasovat
vyfařit	fařit
vyhajičkat	čkat
+vyháknout	háknout
vyhrubovat	rubovat
vyklidňovat	klidňovat
+vykolejit	kolejit
vykročit	ročit
vykvítnout	vítnout
+vylidnit	lidnit
vylknout	lknout
vylstít	lstít
+vymílat	mílat
vymítat	mítat
vymlácet	mlácet
vymokat	mokat
+vymrzat	mrzat
vynikat	nikat
vynímat	nímat
vyosit	osit
vyoslit	oslit
vypláknout	pláknout
+vypláznout	pláznout
vypobízet	bízet
vypočinout	počinout
vypočtovat	počtovat
vypodobnit	podobnit
vypotřebit	potřebit
vyprahat	prahat
vypráhat	práhat
+vypřahat	přahat
+vyrybnit	rybnit
vyšastat	stat
+vyskladnit	skladnit
vysouknout	souknout
vysouvnout	souvnout
vyšpánkovat	špánkovat
vyšpánovat	špánovat
vyšplachovat	plachovat
vystájit	stájit
vystrájet	strájet
+vystýlat	stýlat
+vysychat	sychat
+vysýchat	sýchat
vytmívat	tmívat
vytřípat	třípat
vytučnit	tučnit
vyvánět	vánět
+vyvářet	vářet
vyvěrat	věrat
vyviřovat	viřovat
vyvoslit	oslit
+vyždibovat	ždibovat
vyzvědat	vědat
vžírat	žírat
vzlykat	lykat
vznikat	nikat
vzpěčovat	pěčovat
vzpínat	pínat
vzplavovat	plavovat
vzpomínat	pomínat
vzpouzet	pouzet
vzpřahat	přahat
+zabíhat	bíhat
zabřídat	břídat
+zachechtnout	chechtnout
+zachichtnout	chichtnout
zachřestat	stat
zachrustat	stat
začíslit	číslit
zafantasovat	tasovat
+zahášet	hášet
+zahlížet	hlížet
+zahmyzit	hmyzit
zahořčit	hořčit
zahošťovat	hošťovat
zahoustat	stat
zakluzovat	kluzovat
zakročit	ročit
zakusit	kusit
+zakvášet	kvášet
+zalednit	lednit
+zalidnit	lidnit
zalykat	lykat
zalyknout	lyknout
zamílat	mílat
zamlkat	mlkat
zamokat	mokat
+zamoučnit	moučnit
+zamrákat	mrákat
+zamrzat	mrzat
zanedůvěřovat	věřovat
zanikat	nikat
+zaolovnit	olovnit
+zaplotit	plotit
zapomínat	pomínat
+zapřahat	přahat
zapylit	pylit
+zarakvit	rakvit
zařknout	řknout
+zaskladnit	skladnit
+zasměrnit	směrnit
zasouvnout	souvnout
+zastájit	stájit
+zastehnout	stehnout
zastesknout	tesknout
+zastropit	stropit
+zastýlat	stýlat
+zasychat	sychat
+zasýchat	sýchat
zatesnout	tesnout
zatíkat	tíkat
zatravnatět	travnatět
zauhlit	uhlit
zavadat	vadat
zavánět	vánět
+zavářet	vářet
zavazet	vazet
zavítnout	vítnout
zavíznout	víznout
zazvěřit	zvěřit
+zbíhat	bíhat
zblbit	blbit
+zbledat	bledat
zbohnit	ohnit
zbojácnět	bojácnět
zbožštit	božštit
+zchládat	chládat
zchromět	mět
zcitlivět	citlivět
zcitlivit	citlivit
zcizozemštit	zemštit
zcukernit	cukernit
zdesateronásobnit	násobnit
+zdlábnout	dlábnout
zdolat	dolat
zdomácnit	domácnit
zdostupnit	stupnit
zdrezovat	rezovat
zduševnit	duševnit
zdvojnásobnit	násobnit
zepisovat	pisovat
zesamostatnět	samostatnět
zešikmět	mět
zeskrovnit	skrovnit
zeskutečnit	skutečnit
+zesměšnit	směšnit
zesobečtět	sobečtět
zespisovnit	spisovnit
zesplatnit	platnit
zesprostět	sprostět
zesprostnout	sprostnout
zesteronásobnit	násobnit
zestonásobnit	násobnit
zestřídmět	střídmět
zestřízlivit	střízlivit
zestručnit	stručnit
zesvětštit	světštit
zevšeobecnit	obecnit
+zezákonit	zákonit
+zežebračet	žebračet
+zežebračit	žebračit
+zeživotnit	životnit
zezlobnět	zlobnět
zezpátečnit	zpátečnit
+zezřejmit	zřejmit
zezvířečtět	zvířečtět
zezvířečtit	zvířečtit
+zhášet	hášet
zhmotnit	hmotnit
zhořčit	hořčit
zhranatět	hranatět
zhromit	hromit
zhrzet	hrzet
+zhudebnit	hudebnit
zintensivňovat	intensivňovat
zintenzivňovat	intenzivňovat
zjednosměrnit	směrnit
+zkatoličit	katoličit
zkatoličtit	katoličtit
zklidnit	lidnit
zkomírat	mírat
zkrajovat	krajovat
zkřástat	stat
zkusit	kusit
zlakomět	mět
+zlidnit	lidnit
zmezinárodnět	národnět
zmezinárodnit	národnit
zmnohonásobnit	násobnit
zmokat	mokat
+zmračovat	mračovat
+zmrzat	mrzat
zmužštit	mužštit
+znárodnět	národnět
znásobnit	násobnit
znechutňovat	hutňovat
+znecitlivět	citlivět
znecitlivit	citlivit
znedůtklivět	tklivět
zneklidnit	lidnit
zněkolikanásobnit	násobnit
+znelidštit	lidštit
zněmět	mět
+zneplatnit	platnit
+zneplodnit	plodnit
znepřehlednit	přehlednit
znepříjemnět	příjemnět
znepříjemnit	příjemnit
znepřístupnit	stupnit
zneprůhlednit	lednit
znervosňovat	nervosňovat
znesmyslňovat	slňovat
znesnadnit	nesnadnit
znevýraznit	výraznit
znikat	nikat
zniternět	niternět
zniternit	niternit
znít	nít
znovuinstalovat	stalovat
znovuobnovit	novit
znovupohřbít	hřbít
znovupořizovat	řizovat
znovupřipínat	pínat
znovuustanovit	novit
znovuuvádět	vádět
znovuvysazovat	sazovat
znovuvytáčet	táčet
znovuzačínat	čínat
znovuzpřístupnit	stupnit
zobousměrnit	směrnit
zobzvláštnit	zvláštnit
zohnit	ohnit
zokrouhlit	uhlit
zopravdovět	vdovět
zpadesátinásobnit	násobnit
zpakostit	kostit
+zpapírovět	papírovět
+zparchantět	parchantět
+zparchantit	parchantit
zparnit	parnit
zpateronásobit	pateronásobit
zpateronásobnit	pateronásobnit
zpatrnit	patrnit
zpěčit	pěčit
zpěčovat	pěčovat
zpichovat	pichovat
zplatinovět	platinovět
zplavnit	plavnit
zplnoletit	plnoletit
zplnomocnit	plnomocnit
zplodnit	plodnit
zplošit	plošit
zplošnit	plošnit
+zplynět	plynět
+zplynit	plynit
+zpochybnět	pochybnět
+zpodobnit	podobnit
+zpodrobňovat	podrobňovat
+zpodstatnět	podstatnět
zpodstatnit	podstatnit
zpohášet	hášet
zpohodlnit	pohodlnit
zpolštit	polštit
zpomlkat	mlkat
zpoplatnit	poplatnit
zpopulárnit	populárnit
zposvátnit	posvátnit
zprachovatět	prachovatět
zprahat	prahat
zpřahovat	přahovat
zpraktičtět	praktičtět
zpraktičtit	praktičtit
zpráškovatět	práškovatět
zprašnět	prašnět
zprašňovat	prašňovat
zpravděpodobnit	podobnit
zprecisnit	precisnit
zpreciznit	preciznit
zpřehlednit	přehlednit
zpřesnět	přesnět
zpříjemnět	příjemnět
+zpříjemnit	příjemnit
+zprimitivnět	primitivnět
+zprimitivnit	primitivnit
zpřístupnit	stupnit
+zprkenět	prkenět
zproduktivnit	produktivnit
zprofesionálnit	profesionálnit
zprostonárodnět	prostonárodnět
zprostonárodnit	prostonárodnit
zprůhlednit	lednit
zpurpurovět	purpurovět
způvabnit	půvabnit
zrealističtit	realističtit
zreálnit	reálnit
+zřečtit	řečtit
zrelativnit	relativnit
zrentabilnit	rentabilnit
zřepovatět	řepovatět
zřímanit	římanit
+zrománštit	románštit
+zromantičtit	romantičtit
zruštit	ruštit
zrůžovatit	růžovatit
zryznout	ryznout
ztajemnit	tajemnit
ztátovatět	tátovatět
ztisíceronásobnit	násobnit
ztklivět	tklivět
ztlušťovat	lušťovat
ztopornit	topornit
ztriviálnět	triviálnět
ztrojnásobnit	násobnit
ztučnit	tučnit
ztuhat	tuhat
ztvarovět	tvarovět
ztypisovat	pisovat
+zuhelnět	uhelnět
+zuhelnit	uhelnit
zuhličit	uhličit
zúrodnět	úrodnět
zúspornit	úspornit
zvadat	vadat
zvápnět	vápnět
zvarhanovatět	varhanovatět
žvastat	stat
žvástat	stat
zvěčnět	věčnět
zvěcnit	věcnit
+zvědečtět	vědečtět
zvědečtit	vědečtit
zvědomit	vědomit
zvelebnit	velebnit
zveřejnět	veřejnět
zveřejnoprávnit	veřejnoprávnit
zvěstovat	věstovat
zvětřet	větřet
zvírat	vírat
+zvláknit	vláknit
zvniternět	niternět
zvniternit	niternit
zvodnit	vodnit
zvohavovat	ohavovat
zvostat	stat
zvovuzveřejňovat	veřejňovat
zvýraznit	výraznit
zživotnit	životnit
domnít	nít
hrubovat	rubovat
+nadměřovat	měřovat
nastírat	tírat
odnít	nít
+osamostatnět	samostatnět
+prouhelňovat	uhelňovat
samonavádět	vádět
sebepředvádět	vádět
stěrat	těrat
vceňovat	ceňovat
zavostat	stat
železoobrábět	rábět
