limitovat_V	limit_N
úvěrovat_V	úvěr_N
tunelovat_V	tunel_N
čopovat_V	čop_N
žertovat_V	žert_N
kšeftovat_V	kšeft_N
flirtovat_V	flirt_N
veršovat_V	verš_N
sponzorovat_V	sponzor_N
úkolovat_V	úkol_N
prorokovat_V	prorok_N
hákovat_V	hák_N
fixovat_V	fix_N
plakátovat_V	plakát_N
atakovat_V	atak_N
klonovat_V	klon_N
kytovat_V	kyt_N
šamponovat_V	šampon_N
čepovat_V	čep_N
sladovat_V	slad_N
stohovat_V	stoh_N
garážovat_V	garáž_N
tečovat_V	teč_N
špásovat_V	špás_N
profilovat_V	profil_N
registrovat_V	registr_N
skladovat_V	sklad_N
kompotovat_V	kompot_N
portrétovat_V	portrét_N
časovat_V	čas_N
bankrotovat_V	bankrot_N
inzultovat_V	inzult_N
plynovat_V	plyn_N
lobovat_V	lob_N
rapovat_V	rap_N
párovat_V	pár_N
luxovat_V	lux_N
cejchovat_V	cejch_N
machrovat_V	machr_N
krokovat_V	krok_N
kontaktovat_V	kontakt_N
twistovat_V	twist_N
procesovat_V	proces_N
chatovat_V	chat_N
nýtovat_V	nýt_N
formátovat_V	formát_N
šoférovat_V	šofér_N
faulovat_V	faul_N
sedimentovat_V	sediment_N
šéfovat_V	šéf_N
lemovat_V	lem_N
retušovat_V	retuš_N
gruntovat_V	grunt_N
pilotovat_V	pilot_N
hazardovat_V	hazard_N
fragmentovat_V	fragment_N
košerovat_V	košer_N
flamendrovat_V	flamendr_N
monitorovat_V	monitor_N
rázovat_V	ráz_N
skalpovat_V	skalp_N
kufrovat_V	kufr_N
prezentovat_V	prezent_N
voskovat_V	vosk_N
parazitovat_V	parazit_N
stresovat_V	stres_N
chromovat_V	chrom_N
hlasovat_V	hlas_N
kolíkovat_V	kolík_N
šmakovat_V	šmak_N
hodovat_V	hod_N
koksovat_V	koks_N
trucovat_V	truc_N
paktovat_V	pakt_N
patentovat_V	patent_N
bagrovat_V	bagr_N
holdovat_V	hold_N
protestovat_V	protest_N
faxovat_V	fax_N
švindlovat_V	švindl_N
špuntovat_V	špunt_N
pólovat_V	pól_N
pochodovat_V	pochod_N
vzdorovat_V	vzdor_N
fízlovat_V	fízl_N
orientovat_V	orient_N
lajkovat_V	lajk_N
úrokovat_V	úrok_N
krámovat_V	krám_N
respektovat_V	respekt_N
směrovat_V	směr_N
šturmovat_V	šturm_N
trampovat_V	tramp_N
titulovat_V	titul_N
šokovat_V	šok_N
stanovat_V	stan_N
brakovat_V	brak_N
roubovat_V	roub_N
bojkotovat_V	bojkot_N
rámovat_V	rám_N
krémovat_V	krém_N
olejovat_V	olej_N
blogovat_V	blog_N
tvarovat_V	tvar_N
pranýřovat_V	pranýř_N
lakovat_V	lak_N
pinglovat_V	pingl_N
bodyčekovat_V	bodyček_N
koučovat_V	kouč_N
sprintovat_V	sprint_N
kvaltovat_V	kvalt_N
šenkovat_V	šenk_N
skautovat_V	skaut_N
žalářovat_V	žalář_N
startovat_V	start_N
balíkovat_V	balík_N
plánovat_V	plán_N
tónovat_V	tón_N
manifestovat_V	manifest_N
frankovat_V	frank_N
tankovat_V	tank_N
bičovat_V	bič_N
flekovat_V	flek_N
oxidovat_V	oxid_N
pachtovat_V	pacht_N
trempovat_V	tremp_N
mordovat_V	mord_N
filtrovat_V	filtr_N
šroubovat_V	šroub_N
kšaftovat_V	kšaft_N
garantovat_V	garant_N
fofrovat_V	fofr_N
rebelovat_V	rebel_N
niklovat_V	nikl_N
štěrkovat_V	štěrk_N
kódovat_V	kód_N
ledovat_V	led_N
instrumentovat_V	instrument_N
štukovat_V	štuk_N
drnovat_V	drn_N
masakrovat_V	masakr_N
stehovat_V	steh_N
matovat_V	mat_N
pableskovat_V	pablesk_N
smečovat_V	smeč_N
rozumovat_V	rozum_N
modulovat_V	modul_N
motivovat_V	motiv_N
lisovat_V	lis_N
textovat_V	text_N
argumentovat_V	argument_N
síťovat_V	síť_N
dohadovat_V	dohad_N
cepovat_V	cep_N
rentgenovat_V	rentgen_N
papírovat_V	papír_N

kalichovitý_A	kalich_N
drakovitý_A	drak_N
vzdorovitý_A	vzdor_N
tygrovitý_A	tygr_N
keřovitý_A	keř_N
hadovitý_A	had_N
sukovitý_A	suk_N
tvarohovitý_A	tvaroh_N
kaktusovitý_A	kaktus_N
rosolovitý_A	rosol_N
trojúhelníkovitý_A	trojúhelník_N
květákovitý_A	květák_N
javorovitý_A	javor_N
hákovitý_A	hák_N
bobovitý_A	bob_N
kurovitý_A	kur_N
tyčovitý_A	tyč_N
jelenovitý_A	jelen_N
plánovitý_A	plán_N
kaprovitý_A	kapr_N
rtuťovitý_A	rtuť_N
červovitý_A	červ_N
vlkovitý_A	vlk_N
věkovitý_A	věk_N
kotoučovitý_A	kotouč_N
špekovitý_A	špek_N
zázvorovitý_A	zázvor_N
měkkýšovitý_A	měkkýš_N
drnovitý_A	drn_N
tukovitý_A	tuk_N
obrovitý_A	obr_N
kýčovitý_A	kýč_N
jabloňovitý_A	jabloň_N
žlučovitý_A	žluč_N
doutníkovitý_A	doutník_N
tchořovitý_A	tchoř_N
úhořovitý_A	úhoř_N
deštníkovitý_A	deštník_N
plžovitý_A	plž_N
pilířovitý_A	pilíř_N
hřibovitý_A	hřib_N
rázovitý_A	ráz_N
drátovitý_A	drát_N
jílovitý_A	jíl_N
duchovitý_A	duch_N
krokodýlovitý_A	krokodýl_N
věžovitý_A	věž_N
pahýlovitý_A	pahýl_N
česnekovitý_A	česnek_N
kapraďovitý_A	kapraď_N
kuželovitý_A	kužel_N
křečovitý_A	křeč_N
pavoukovitý_A	pavouk_N

Topolánková_N	Topolánek_N
Bachánková_N	Bachánek_N
Válková_N	Válek_N
Robenková_N	Robenek_N
Fašánková_N	Fašánek_N
Nečesánková_N	Nečesánek_N
Křečková_N	Křeček_N
Labounková_N	Labounek_N
Zbranková_N	Zbranek_N
Tichánková_N	Tichánek_N
Bělohlávková_N	Bělohlávek_N
Hráčková_N	Hráček_N
Paroubková_N	Paroubek_N
Babánková_N	Babánek_N
Janáčková_N	Janáček_N
Berousková_N	Berousek_N
Křivánková_N	Křivánek_N
Rejžková_N	Rejžek_N
Zbožínková_N	Zbožínek_N
Němečková_N	Němeček_N
Dolínková_N	Dolínek_N
Bělobrádková_N	Bělobrádek_N
Dolénková_N	Dolének_N
Hánková_N	Hánek_N
Bahounková_N	Bahounek_N
Malivánková_N	Malivánek_N
Svátková_N	Svátek_N
Sedláčková_N	Sedláček_N
Vízková_N	Vízek_N
Ovčáčková_N	Ovčáček_N
Šefránková_N	Šefránek_N
Habětínková_N	Habětínek_N
Rejzková_N	Rejzek_N
Balšánková_N	Balšánek_N
Roháčková_N	Roháček_N
Faltýnková_N	Faltýnek_N
Šajánková_N	Šajánek_N
Koláčková_N	Koláček_N
Kulhánková_N	Kulhánek_N
Pátková_N	Pátek_N
Mráčková_N	Mráček_N
Ječménková_N	Ječmének_N
Cejnková_N	Cejnek_N
Vondráčková_N	Vondráček_N
Rejmánková_N	Rejmánek_N
Macháčková_N	Macháček_N
Schovánková_N	Schovánek_N
Rožánková_N	Rožánek_N
Chalánková_N	Chalánek_N
Zajíčková_N	Zajíček_N
Balínková_N	Balínek_N
Trojánková_N	Trojánek_N

reklamovat_V	reklama_N
skládkovat_V	skládka_N
replikovat_V	replika_N
formovat_V	forma_N
figurovat_V	figura_N
štěpkovat_V	štěpka_N
známkovat_V	známka_N
markovat_V	marka_N
sondovat_V	sonda_N
frézovat_V	fréza_N
pokutovat_V	pokuta_N
bědovat_V	běda_N
sofistikovat_V	sofistika_N
dýhovat_V	dýha_N
normovat_V	norma_N
korunovat_V	koruna_N
gumovat_V	guma_N
nulovat_V	nula_N
pomádovat_V	pomáda_N
dávkovat_V	dávka_N
rejdovat_V	rejda_N
robotovat_V	robota_N
bačovat_V	bača_N
notovat_V	nota_N
debatovat_V	debata_N
pauzovat_V	pauza_N
zálohovat_V	záloha_N
esemeskovat_V	esemeska_N
eskortovat_V	eskorta_N
nálepkovat_V	nálepka_N
šifrovat_V	šifra_N
reprízovat_V	repríza_N
píčovat_V	píča_N
intrikovat_V	intrika_N
pózovat_V	póza_N
hubovat_V	huba_N
fakturovat_V	faktura_N
šikanovat_V	šikana_N
drogovat_V	droga_N
mřížkovat_V	mřížka_N
slabikovat_V	slabika_N
zimovat_V	zima_N
parcelovat_V	parcela_N
maskovat_V	maska_N
cenzurovat_V	cenzura_N
polohovat_V	poloha_N
mapovat_V	mapa_N
revoltovat_V	revolta_N
gilotinovat_V	gilotina_N
pastovat_V	pasta_N
tečkovat_V	tečka_N

drozdí_A	drozd_N
hadí_A	had_N
delfíní_A	delfín_N
švábí_A	šváb_N
paviání_A	pavián_N
rorýsí_A	rorýs_N
krokodýlí_A	krokodýl_N
jeřábí_A	jeřáb_N
bizoní_A	bizon_N
úhoří_A	úhoř_N
motýlí_A	motýl_N
opí_A	op_N
sokolí_A	sokol_N
orangutaní_A	orangutan_N
červí_A	červ_N
giboní_A	gibon_N
jestřábí_A	jestřáb_N
mývalí_A	mýval_N
rysí_A	rys_N
havraní_A	havran_N
sobolí_A	sobol_N
kohoutí_A	kohout_N
chrtí_A	chrt_N
dikobrazí_A	dikobraz_N
hraboší_A	hraboš_N
kapouní_A	kapoun_N
elfí_A	elf_N
mamutí_A	mamut_N
kojotí_A	kojot_N
šimpanzí_A	šimpanz_N
losí_A	los_N
olbřímí_A	olbřím_N
lachtaní_A	lachtan_N
líní_A	lín_N
tchoří_A	tchoř_N
supí_A	sup_N
krocaní_A	krocan_N
gepardí_A	gepard_N
sobí_A	sob_N
mufloní_A	muflon_N
bažantí_A	bažant_N
krabí_A	krab_N
jelení_A	jelen_N
velbloudí_A	velbloud_N
pštrosí_A	pštros_N
hmyzí_A	hmyz_N
drůbeží_A	drůbež_N
potkaní_A	potkan_N

hradit_V	hrad_N
rojit_V	roj_N
potit_V	pot_N
hrotit_V	hrot_N
čalounit_V	čaloun_N
nimrodit_V	nimrod_N
kořistit_V	kořist_N
strážit_V	stráž_N
ksichtit_V	ksicht_N
plenit_V	plen_N
stínit_V	stín_N
šumařit_V	šumař_N
pěstit_V	pěst_N
lovit_V	lov_N
hnusit_V	hnus_N
zápasit_V	zápas_N
rámusit_V	rámus_N
hrbit_V	hrb_N
soupeřit_V	soupeř_N
zubit_V	zub_N
chmelit_V	chmel_N
chumelit_V	chumel_N
kamarádit_V	kamarád_N
mamonit_V	mamon_N
blábolit_V	blábol_N
čertit_V	čert_N
močit_V	moč_N
kadeřit_V	kadeř_N
řádit_V	řád_N
šatit_V	šat_N
proudit_V	proud_N
brodit_V	brod_N
mastit_V	mast_N
štětit_V	štět_N
divit_V	div_N
kvasit_V	kvas_N
kazit_V	kaz_N
pepřit_V	pepř_N
medit_V	med_N
řetězit_V	řetěz_N
tmelit_V	tmel_N
popelit_V	popel_N
pramenit_V	pramen_N
křenit_V	křen_N
závodit_V	závod_N

Džamila_N	Džamil_N
patrona_N	patron_N
Vladislava_N	Vladislav_N
Drahoslava_N	Drahoslav_N
tragika_N	tragik_N
markýza_N	markýz_N
akta_N	akt_N
fauna_N	faun_N
Miloslava_N	Miloslav_N
Vladimíra_N	Vladimír_N
Václava_N	Václav_N
magistra_N	magistr_N
Bohuslava_N	Bohuslav_N
Romana_N	Roman_N
Valentýna_N	Valentýn_N
Věnceslava_N	Věnceslav_N
Šona_N	Šon_N
Kamila_N	Kamil_N
skripta_N	skript_N
Radana_N	Radan_N
basa_N	bas_N
Boleslava_N	Boleslav_N
Josefa_N	Josef_N
Bohumíra_N	Bohumír_N
Denisa_N	Denis_N
Dana_N	Dan_N
Ivana_N	Ivan_N
Gabriela_N	Gabriel_N
Miroslava_N	Miroslav_N
statika_N	statik_N
úpona_N	úpon_N
způsoba_N	způsob_N
leva_N	lev_N
Květoslava_N	Květoslav_N
karamela_N	karamel_N
hadra_N	hadr_N
Martina_N	Martin_N
úřada_N	úřad_N
bruneta_N	brunet_N
Stanislava_N	Stanislav_N
přednosta_N	přednost_N

dlab_N	dlabat_V
lept_N	leptat_V
vzlyk_N	vzlykat_V
trysk_N	tryskat_V
trk_N	trkat_V
frk_N	frkat_V
klokot_N	klokotat_V
šleh_N	šlehat_V
zob_N	zobat_V
cvrk_N	cvrkat_V
bod_N	bodat_V
kmit_N	kmitat_V
mňouk_N	mňoukat_V
checht_N	chechtat_V
chlast_N	chlastat_V
žvást_N	žvástat_V
dráp_N	drápat_V
chroust_N	chroustat_V
šplh_N	šplhat_V
řez_N	řezat_V
cák_N	cákat_V
plk_N	plkat_V
šprt_N	šprtat_V
drb_N	drbat_V
mžik_N	mžikat_V
tik_N	tikat_V
lok_N	lokat_V
srk_N	srkat_V
kdák_N	kdákat_V
ples_N	plesat_V
hrk_N	hrkat_V
puk_N	pukat_V
cuk_N	cukat_V
chichot_N	chichotat_V
posyp_N	posypat_V
kec_N	kecat_V

Radan_N	Radana_N
parket_N	parketa_N
Drahomír_N	Drahomíra_N
Kamil_N	Kamila_N
Stanislav_N	Stanislava_N
Dan_N	Dana_N
Anděl_N	Anděla_N
Bohumír_N	Bohumíra_N
Roman_N	Romana_N
Květoslav_N	Květoslava_N
Michael_N	Michaela_N
Bohdan_N	Bohdana_N
brunet_N	bruneta_N
Drahoslav_N	Drahoslava_N
Bohuslav_N	Bohuslava_N
Denis_N	Denisa_N
prs_N	prsa_N
Ivan_N	Ivana_N
skript_N	skripta_N
podpor_N	podpora_N
katarakt_N	katarakta_N
fuks_N	fuksa_N
bas_N	basa_N
faun_N	fauna_N
Miroslav_N	Miroslava_N
Pavlín_N	Pavlína_N
Gabriel_N	Gabriela_N
obor_N	obora_N
Valentýn_N	Valentýna_N
numizmatik_N	numizmatika_N
ouřad_N	ouřada_N
markýz_N	markýza_N

box_N	boxovat_V
truc_N	trucovat_V
beton_N	betonovat_V
flirt_N	flirtovat_V
stop_N	stopovat_V
šerm_N	šermovat_V
blog_N	blogovat_V
tunel_N	tunelovat_V
debut_N	debutovat_V
sponzor_N	sponzorovat_V
faul_N	faulovat_V
dohad_N	dohadovat_V
grunt_N	gruntovat_V
import_N	importovat_V
masakr_N	masakrovat_V
sled_N	sledovat_V
žalář_N	žalářovat_V
test_N	testovat_V
kouč_N	koučovat_V
švindl_N	švindlovat_V
akcent_N	akcentovat_V
lob_N	lobovat_V
vandr_N	vandrovat_V
rajc_N	rajcovat_V
štep_N	štepovat_V
pranýř_N	pranýřovat_V
špás_N	špásovat_V
fax_N	faxovat_V
šmak_N	šmakovat_V
koncert_N	koncertovat_V

vejrat_V	vejr_N
tikat_V	tik_N
plesat_V	ples_N
plkat_V	plk_N
vrhat_V	vrh_N
tahat_V	tah_N
drápat_V	dráp_N
hrkat_V	hrk_N
chroustat_V	chroust_N
tokat_V	tok_N
zobat_V	zob_N
hamat_V	ham_N
trestat_V	trest_N
chovat_V	chov_N
čichat_V	čich_N
hněvat_V	hněv_N
drbat_V	drb_N
hltat_V	hlt_N
šprtat_V	šprt_N
krkat_V	krk_N
vznikat_V	vznik_N
flusat_V	flus_N
škrtat_V	škrt_N
klikat_V	klik_N

pejzatý_A	pejz_N
flekatý_A	flek_N
kníratý_A	knír_N
pyskatý_A	pysk_N
šosatý_A	šos_N
nosatý_A	nos_N
hrbatý_A	hrb_N
dusíkatý_A	dusík_N
cípatý_A	cíp_N
lupenatý_A	lupen_N
plynatý_A	plyn_N
uhlíkatý_A	uhlík_N
rezatý_A	rez_N
prdelatý_A	prdel_N
vousatý_A	vous_N
rohatý_A	roh_N
sukatý_A	suk_N
ocasatý_A	ocas_N
parohatý_A	paroh_N
věžatý_A	věž_N
plešatý_A	pleš_N
copatý_A	cop_N
zubatý_A	zub_N
křemíkatý_A	křemík_N

nářeční_A	nářečí_N
pobřežní_A	pobřeží_N
úmrtní_A	úmrtí_N
podpalubní_A	podpalubí_N
zbožní_A	zboží_N
přízemní_A	přízemí_N
nádražní_A	nádraží_N
podnební_A	podnebí_N
okolní_A	okolí_N
výroční_A	výročí_N
zápěstní_A	zápěstí_N
podsvětní_A	podsvětí_N
čtvrtletní_A	čtvrtletí_N
pohlavní_A	pohlaví_N
šestispřežní_A	šestispřeží_N
nábřežní_A	nábřeží_N
průčelní_A	průčelí_N
údolní_A	údolí_N
podložní_A	podloží_N
územní_A	území_N
podkrovní_A	podkroví_N
obilní_A	obilí_N

šelest_N	šelestit_V
plaz_N	plazit_V
chod_N	chodit_V
odval_N	odvalit_V
klest_N	klestit_V
kvap_N	kvapit_V
předěl_N	předělit_V
marod_N	marodit_V
přebal_N	přebalit_V
odstav_N	odstavit_V
pud_N	pudit_V
blábol_N	blábolit_V
plen_N	plenit_V
soupeř_N	soupeřit_V
popud_N	popudit_V
hrot_N	hrotit_V
klid_N	klidit_V
kaz_N	kazit_V
škleb_N	šklebit_V
bloud_N	bloudit_V
třpyt_N	třpytit_V

knotovka_N	knot_N
hadovka_N	had_N
chmelovka_N	chmel_N
drnovka_N	drn_N
startovka_N	start_N
bobrovka_N	bobr_N
kalichovka_N	kalich_N
traťovka_N	trať_N
jedovka_N	jed_N
tendrovka_N	tendr_N
dokladovka_N	doklad_N
bambusovka_N	bambus_N
banánovka_N	banán_N
čepovka_N	čep_N
státovka_N	stát_N
aktovka_N	akt_N
mechovka_N	mech_N
medovka_N	med_N
bukovka_N	buk_N

parno_D	parný_A
drsno_D	drsný_A
trpko_D	trpký_A
draho_D	drahý_A
líto_D	lítý_A
divoko_D	divoký_A
vratko_D	vratký_A
vysokánsko_D	vysokánský_A
dlouho_D	dlouhý_A
libo_D	libý_A
malinko_D	malinký_A
jasno_D	jasný_A
milo_D	milý_A
horko_D	horký_A
těžko_D	těžký_A
širo_D	širý_A
nudno_D	nudný_A
vysokanánsko_D	vysokanánský_A
plno_D	plný_A

mrzce_D	mrzký_A
vratce_D	vratký_A
sladce_D	sladký_A
hladce_D	hladký_A
prudce_D	prudký_A
hebce_D	hebký_A
krátce_D	krátký_A
úzce_D	úzký_A
lehce_D	lehký_A
slaďoučce_D	slaďoučký_A
hořce_D	hořký_A
měkce_D	měkký_A
trpce_D	trpký_A
plytce_D	plytký_A
mělce_D	mělký_A
tence_D	tenký_A
divoce_D	divoký_A
křehce_D	křehký_A

hořko_N	hořký_A
úzko_N	úzký_A
šedo_N	šedý_A
neznámo_N	neznámý_A
zeleno_N	zelený_A
tenko_N	tenký_A
sladko_N	sladký_A
vysoko_N	vysoký_A
studeno_N	studený_A
široko_N	široký_A
mokro_N	mokrý_A
hluboko_N	hluboký_A
malinko_N	malinký_A
prázdno_N	prázdný_A
různo_N	různý_A
lehko_N	lehký_A
nedávno_N	nedávný_A
veselo_N	veselý_A

přebytečný_A	přebytek_N
sňatečný_A	sňatek_N
opačný_A	opak_N
hlučný_A	hluk_N
věčný_A	věk_N
zvučný_A	zvuk_N
zárodečný_A	zárodek_N
náročný_A	nárok_N
průtočný_A	průtok_N
nadbytečný_A	nadbytek_N
příznačný_A	příznak_N
úsečný_A	úsek_N
značný_A	znak_N
oblačný_A	oblak_N
soumračný_A	soumrak_N
zázračný_A	zázrak_N
přízvučný_A	přízvuk_N
statečný_A	statek_N

trylkovat_V	trylek_N
křečkovat_V	křeček_N
kolkovat_V	kolek_N
políčkovat_V	políček_N
paběrkovat_V	paběrek_N
zmatkovat_V	zmatek_N
řízkovat_V	řízek_N
papouškovat_V	papoušek_N
špačkovat_V	špaček_N
titulkovat_V	titulek_N
práškovat_V	prášek_N
lelkovat_V	lelek_N
koníčkovat_V	koníček_N
zinkovat_V	zinek_N
sáčkovat_V	sáček_N
kroužkovat_V	kroužek_N
háčkovat_V	háček_N

katarzní_A	katarze_N
invazní_A	invaze_N
kolizní_A	kolize_N
divizní_A	divize_N
kompresní_A	komprese_N
profesní_A	profese_N
komisní_A	komise_N
recenzní_A	recenze_N
finální_A	finále_N
majuskulní_A	majuskule_N
secesní_A	secese_N
adhezní_A	adheze_N
emisní_A	emise_N
abrazní_A	abraze_N
erozní_A	eroze_N
rešeršní_A	rešerše_N
pažní_A	paže_N

pěnit_V	pěna_N
slinit_V	slina_N
kosit_V	kosa_N
řadit_V	řada_N
lopotit_V	lopota_N
chválit_V	chvála_N
vévodit_V	vévoda_N
řasit_V	řasa_N
vinit_V	vina_N
perlit_V	perla_N
clonit_V	clona_N
měnit_V	měna_N
rosit_V	rosa_N
skvrnit_V	skvrna_N
vlnit_V	vlna_N

netopýří_A	netopýr_N
tuří_A	tur_N
kapří_A	kapr_N
vejří_A	vejr_N
komáří_A	komár_N
humří_A	humr_N
zubří_A	zubr_N
jeseteří_A	jeseter_N
ještěří_A	ještěr_N
jaguáří_A	jaguár_N
kačeří_A	kačer_N
kanáří_A	kanár_N
bobří_A	bobr_N
kocouří_A	kocour_N
tapíří_A	tapír_N

otvíračka_N	otvírač_N
nálevka_N	nálev_N
výbojka_N	výboj_N
kanafaska_N	kanafas_N
průkazka_N	průkaz_N
hostka_N	host_N
vagónka_N	vagón_N
popelka_N	popel_N
holička_N	holič_N
zapalovačka_N	zapalovač_N
Pákistánka_N	Pákistán_N
odměrka_N	odměr_N
dýmka_N	dým_N
packa_N	pac_N

pubertální_A	puberta_N
tracheální_A	trachea_N
orbitální_A	orbita_N
frontální_A	fronta_N
epochální_A	epocha_N
figurální_A	figura_N
konjunkturální_A	konjunktura_N
procedurální_A	procedura_N
bazilikální_A	bazilika_N
centrifugální_A	centrifuga_N
larvální_A	larva_N
pyramidální_A	pyramida_N
ekliptikální_A	ekliptika_N
aortální_A	aorta_N

Barbadosan_N	Barbados_N
skokan_N	skok_N
hltan_N	hlt_N
Soluňan_N	Soluň_N
Hondurasan_N	Honduras_N
Volyňan_N	Volyň_N
Palauan_N	Palau_N
Walesan_N	Wales_N
Přerovan_N	Přerov_N
Olympan_N	Olymp_N
katan_N	kat_N
Laosan_N	Laos_N
Břevnovan_N	Břevnov_N

fiktivní_A	fikce_N
prohibitivní_A	prohibice_N
presumptivní_A	presumpce_N
atraktivní_A	atrakce_N
dekorativní_A	dekorace_N
erektivní_A	erekce_N
intuitivní_A	intuice_N
meditativní_A	meditace_N
eruptivní_A	erupce_N
federativní_A	federace_N
injektivní_A	injekce_N
preventivní_A	prevence_N
inovativní_A	inovace_N

odměrný_A	odměr_N
příjemný_A	příjem_N
záběrný_A	záběr_N
rozporný_A	rozpor_N
klínopisný_A	klínopis_N
rostlinopisný_A	rostlinopis_N
odborný_A	odbor_N
průvodný_A	průvod_N
vlhkoměrný_A	vlhkoměr_N
šestistěnný_A	šestistěn_N
návratný_A	návrat_N
úchylný_A	úchyl_N
bytný_A	byt_N

kostnatý_A	kost_N
listnatý_A	list_N
rtuťnatý_A	rtuť_N
srstnatý_A	srst_N
chvostnatý_A	chvost_N
krevnatý_A	krev_N
chobotnatý_A	chobot_N
měďnatý_A	měď_N
houževnatý_A	houžev_N
lidnatý_A	lid_N
sliznatý_A	sliz_N
mozolnatý_A	mozol_N
keřnatý_A	keř_N

Čáslavsko_N	Čáslav_N
inkvizitorsko_N	inkvizitor_N
Krnovsko_N	Krnov_N
Jablunkovsko_N	Jablunkov_N
Kouřimsko_N	Kouřim_N
Kyjovsko_N	Kyjov_N
Kolínsko_N	Kolín_N
Poznaňsko_N	Poznaň_N
Vlašimsko_N	Vlašim_N
Gottwaldovsko_N	Gottwaldov_N
Berounsko_N	Beroun_N
Bruntálsko_N	Bruntál_N

Vohryzek_N	Vohryzková_N
Urválek_N	Urválková_N
Křivohlávek_N	Křivohlávková_N
Furek_N	Furková_N
Stašek_N	Stašková_N
Křivánek_N	Křivánková_N
Habětínek_N	Habětínková_N
Zadrobílek_N	Zadrobílková_N
Balínek_N	Balínková_N
Plaček_N	Plačková_N
Macek_N	Macková_N
Drnek_N	Drnková_N

Aloisie_N	Alois_N
tyranie_N	tyran_N
pederastie_N	pederast_N
personálie_N	personál_N
celiakie_N	celiak_N
anatomie_N	anatom_N
Viktorie_N	Viktor_N
demagogie_N	demagog_N
filantropie_N	filantrop_N
plebánie_N	plebán_N
rebelie_N	rebel_N
chirurgie_N	chirurg_N

pádlovat_V	pádlo_N
kormidlovat_V	kormidlo_N
věnovat_V	věno_N
sólovat_V	sólo_N
stornovat_V	storno_N
mokvat_V	mok_N
razítkovat_V	razítko_N
žebrovat_V	žebro_N
veslovat_V	veslo_N
inkasovat_V	inkaso_N
vetovat_V	veto_N
kolovat_V	kolo_N

primární_A	prim_N
folikulární_A	folikul_N
elementární_A	element_N
parlamentární_A	parlament_N
testamentární_A	testament_N
statutární_A	statut_N
protokolární_A	protokol_N
konzulární_A	konzul_N
dokumentární_A	dokument_N
modulární_A	modul_N
fragmentární_A	fragment_N

poroba_N	porobit_V
nuda_N	nudit_V
podstava_N	podstavit_V
třída_N	třídit_V
mísa_N	mísit_V
řasa_N	řasit_V
měna_N	měnit_V
švadrona_N	švadronit_V
stanova_N	stanovit_V
klopa_N	klopit_V
lahoda_N	lahodit_V

humorální_A	humor_N
hormonální_A	hormon_N
katastrální_A	katastr_N
orientální_A	orient_N
orchestrální_A	orchestr_N
celiakální_A	celiak_N
kantonální_A	kanton_N
monumentální_A	monument_N
azimutální_A	azimut_N
semestrální_A	semestr_N
momentální_A	moment_N

Odolenov_N	Odolen_N
Jáchymov_N	Jáchym_N
Josefov_N	Josef_N
Rudolfov_N	Rudolf_N
Filipov_N	Filip_N
Maximov_N	Maxim_N
Bedřichov_N	Bedřich_N
Adamov_N	Adam_N
Dětřichov_N	Dětřich_N
Ondřejov_N	Ondřej_N
Vilémov_N	Vilém_N

blatníček_N	blatník_N
šneček_N	šnek_N
lajdáček_N	lajdák_N
rohlíček_N	rohlík_N
deštníček_N	deštník_N
kamíneček_N	kamínek_N
hnědáček_N	hnědák_N
Tureček_N	Turek_N
perníček_N	perník_N
loupežníček_N	loupežník_N
roček_N	rok_N

židák_N	žid_N
gaučák_N	gauč_N
šosák_N	šos_N
gymplák_N	gympl_N
výzkumák_N	výzkum_N
Chrudimák_N	Chrudim_N
mistrák_N	mistr_N
Rusák_N	Rus_N
medák_N	med_N
úchylák_N	úchyl_N
Václavák_N	Václav_N

faldík_N	fald_N
mandelík_N	mandel_N
textík_N	text_N
kovářík_N	kovář_N
Benešík_N	Beneš_N
prdík_N	prd_N
tchořík_N	tchoř_N
rudlík_N	rudl_N
králík_N	král_N
pinglík_N	pingl_N
snobík_N	snob_N

prdelní_A	prdel_N
mentální_A	mentál_N
komunální_A	komunál_N
protokolní_A	protokol_N
důchodní_A	důchod_N
fekální_A	fekál_N
negativní_A	negativ_N
anální_A	anál_N
zájemní_A	zájem_N
morní_A	mor_N

Štěpánovice_N	Štěpán_N
krkovice_N	krk_N
sukovice_N	suk_N
Filipovice_N	Filip_N
Jakubovice_N	Jakub_N
bobrovice_N	bobr_N
Mikulášovice_N	Mikuláš_N
Vilémovice_N	Vilém_N
býkovice_N	býk_N
česnekovice_N	česnek_N

machiavelista_N	machiavelizmus_N
amerikanista_N	amerikanizmus_N
maoista_N	maoizmus_N
bergsonista_N	bergsonizmus_N
absentista_N	absentizmus_N
akméista_N	akméizmus_N
marxista_N	marxizmus_N
behaviorista_N	behaviorizmus_N
bonapartista_N	bonapartizmus_N
artista_N	artizmus_N

příštipkář_N	příštipek_N
vozíčkář_N	vozíček_N
statkář_N	statek_N
dobytkář_N	dobytek_N
pánbíčkář_N	pánbíček_N
doškář_N	došek_N
nábytkář_N	nábytek_N
vejminkář_N	vejminek_N
titulkář_N	titulek_N

teritoriální_A	teritorium_N
futurální_A	futurum_N
adverbiální_A	adverbium_N
kontinuální_A	kontinuum_N
muzeální_A	muzeum_N
spektrální_A	spektrum_N
participiální_A	participium_N
ovariální_A	ovarium_N
maximální_A	maximum_N

Charvát_N	Charvátsko_N
Břeclav_N	Břeclavsko_N
Pelhřimov_N	Pelhřimovsko_N
Hodonín_N	Hodonínsko_N
Litvínov_N	Litvínovsko_N
Čáslav_N	Čáslavsko_N
Bruntál_N	Bruntálsko_N
Třebíč_N	Třebíčsko_N
Gottwaldov_N	Gottwaldovsko_N

kyselinka_N	kyselina_N
Hanka_N	Hana_N
řepka_N	řepa_N
výpravka_N	výprava_N
Sobotka_N	Sobota_N
Jurka_N	Jura_N
štětinka_N	štětina_N
Agátka_N	Agáta_N
Věrka_N	Věra_N

Kábulan_N	Kábul_None
Šanghajan_N	Šanghaj_None
Trutnovan_N	Trutnov_None
Kodaňan_N	Kodaň_None
Tachovan_N	Tachov_None
Záhřeban_N	Záhřeb_None
Kansasan_N	Kansas_None
Havajan_N	Havaj_None
Bombajan_N	Bombaj_None

mlýnice_N	mlýn_N
hadice_N	had_N
Ratibořice_N	Ratiboř_N
Přibyslavice_N	Přibyslav_N
čápice_N	čáp_N
rysice_N	rys_N
gepardice_N	gepard_N
denice_N	den_N
hlaholice_N	hlahol_N

kafovat_V	kafe_N
rýžovat_V	rýže_N
rolovat_V	role_N
koulovat_V	koule_N
porcovat_V	porce_N
licencovat_V	licence_N
formulovat_V	formule_N
šavlovat_V	šavle_N
rašplovat_V	rašple_N

rigorózum_N	rigorózní_A
negativum_N	negativní_A
adjektivum_N	adjektivní_A
kolektivum_N	kolektivní_A
pozitivum_N	pozitivní_A
abstraktum_N	abstraktní_A
intranzitivum_N	intranzitivní_A
tranzitivum_N	tranzitivní_A

máselný_A	máslo_N
číselný_A	číslo_N
strašidelný_A	strašidlo_N
pekelný_A	peklo_N
sádelný_A	sádlo_N
prvočíselný_A	prvočíslo_N
skelný_A	sklo_N
světelný_A	světlo_N

rebel_N	rebelie_N
pederast_N	pederastie_N
Abcház_N	Abcházie_N
Viktor_N	Viktorie_N
pediatr_N	pediatrie_N
demagog_N	demagogie_N
anatom_N	anatomie_N
Gal_N	Galie_N

rumíček_N	rum_N
páníček_N	pán_N
kamarádíček_N	kamarád_N
olejíček_N	olej_N
ksichtíček_N	ksicht_N
jetelíček_N	jetel_N
přítelíček_N	přítel_N
hladíček_N	hlad_N

disko_N	disk_N
brko_N	brk_N
septeto_N	septet_N
noneto_N	nonet_N
kvinteto_N	kvintet_N
prso_N	prs_N
okteto_N	oktet_N
sako_N	sak_N

planetární_A	planeta_N
utilitární_A	utilita_N
molekulární_A	molekula_N
kometární_A	kometa_N
legendární_A	legenda_N
proprietární_A	proprieta_N
lunární_A	luna_N
placentární_A	placenta_N

zpěvník_N	zpěv_N
výletník_N	výlet_N
sokolník_N	sokol_N
prsník_N	prs_N
kadeřník_N	kadeř_N
revírník_N	revír_N
jestřábník_N	jestřáb_N
koláčník_N	koláč_N

léčebný_A	léčba_N
vazebný_A	vazba_N
bohoslužebný_A	bohoslužba_N
skladebný_A	skladba_N
prosebný_A	prosba_N
malebný_A	malba_N
hrozebný_A	hrozba_N
služebný_A	služba_N

kursovní_A	kurs_N
erbovní_A	erb_N
plukovní_A	pluk_N
duchovní_A	duch_N
festovní_A	fest_N
kultovní_A	kult_N
klubovní_A	klub_N
gruntovní_A	grunt_N

taškář_N	taška_N
jirchář_N	jircha_N
civilkář_N	civilka_N
arendář_N	arenda_N
srandičkář_N	srandička_N
podlahář_N	podlaha_N
občankář_N	občanka_N
časovkář_N	časovka_N

konsorcium_N	konsorciální_A
labium_N	labiální_A
adverbium_N	adverbiální_A
individuum_N	individuální_A
neutrum_N	neutrální_A
optimum_N	optimální_A
teritorium_N	teritoriální_A
medium_N	mediální_A

mořit_V	mor_N
vířit_V	vír_N
vejřit_V	vejr_N
sejřit_V	sejr_N
magořit_V	magor_N
frajeřit_V	frajer_N
výřit_V	výr_N
bratřit_V	bratr_N

debata_N	debatovat_V
šikana_N	šikanovat_V
gilotina_N	gilotinovat_V
spára_N	spárovat_V
pila_N	pilovat_V
decima_N	decimovat_V
eskorta_N	eskortovat_V

zájemce_N	zájem_N
sumace_N	suma_N
jotace_N	jota_N
úvodce_N	úvod_N
nástupce_N	nástup_N
návodce_N	návod_N
parcelace_N	parcela_N

kultura_N	kult_N
oponentura_N	oponent_N
komandantura_N	komandant_N
receptura_N	recept_N
docentura_N	docent_N
prefektura_N	prefekt_N
textura_N	text_N

okvětí_N	okvětní_A
příručí_N	příruční_A
úmrtí_N	úmrtní_A
ústředí_N	ústřední_A
území_N	územní_A
obilí_N	obilní_A
doživotí_N	doživotní_A

úsečka_N	úsek_N
dyslektička_N	dyslektik_N
Masaryčka_N	Masaryk_N
maniačka_N	maniak_N
přesmyčka_N	přesmyk_N
zvučka_N	zvuk_N
česnečka_N	česnek_N

lučební_A	lučba_N
hradební_A	hradba_N
vazební_A	vazba_N
plavební_A	plavba_N
těžební_A	těžba_N
svatební_A	svatba_N
dražební_A	dražba_N

vervní_A	verva_N
aritní_A	arita_N
trávní_A	tráva_N
fakturní_A	faktura_N
subretní_A	subreta_N
stodolní_A	stodola_N
zásobní_A	zásoba_N

lyrika_N	lyra_N
rusistika_N	rusista_N
metodika_N	metoda_N
artistika_N	artista_N
germanistika_N	germanista_N
nordistika_N	nordista_N
slavistika_N	slavista_N

váhat_V	váha_N
črtat_V	črta_N
budovat_V	budova_N
sochat_V	socha_N
tlapat_V	tlapa_N
pýchat_V	pýcha_N
čárat_V	čára_N

začáteční_A	začátek_N
boční_A	bok_N
sváteční_A	svátek_N
půlroční_A	půlrok_N
potoční_A	potok_N
pupeční_A	pupek_N
žaludeční_A	žaludek_N

skočit_V	skok_N
tlačit_V	tlak_N
zračit_V	zrak_N
otročit_V	otrok_N
sočit_V	sok_N
léčit_V	lék_N
mračit_V	mrak_N

propanol_N	propan_N
hrbol_N	hrb_N
butanol_N	butan_N
oktanol_N	oktan_N
etanol_N	etan_N
pentanol_N	pentan_N
metanol_N	metan_N

Bhútánec_N	Bhútán_N
Jakubec_N	Jakub_N
Dunajec_N	Dunaj_N
Adamec_N	Adam_N
hadec_N	had_N
Salvadorec_N	Salvador_N
Martinec_N	Martin_N

kořeníčko_N	koření_N
péčko_N	pé_N
déčko_N	dé_N
pitíčko_N	pití_N
roštíčko_N	roští_N
listíčko_N	listí_N
céčko_N	cé_N

črta_N	črtat_V
duma_N	dumat_V
střída_N	střídat_V
říje_N	říjet_V
slinta_N	slintat_V
hoře_N	hořet_V
tříska_N	třískat_V

kaprař_N	kapr_N
bičař_N	bič_N
prsař_N	prs_N
kiksař_N	kiks_N
medař_N	med_N
pecař_N	pec_N
pstruhař_N	pstruh_N

osmačka_N	osmák_N
kamioňačka_N	kamioňák_N
sprosťačka_N	sprosťák_N
pijačka_N	piják_N
kádrovačka_N	kádrovák_N
Kladeňačka_N	Kladeňák_N
kozačka_N	kozák_N

závětní_A	závěť_N
hutní_A	huť_N
pouštní_A	poušť_N
pečetní_A	pečeť_N
pamětní_A	paměť_N
řitní_A	řiť_N
obětní_A	oběť_N

hřebenář_N	hřeben_N
česnekář_N	česnek_N
bufetář_N	bufet_N
kaktusář_N	kaktus_N
instrumentář_N	instrument_N
knoflíkář_N	knoflík_N

konzulát_N	konzul_N
magistrát_N	magistr_N
kalifát_N	kalif_N
protektorát_N	protektor_N
seniorát_N	senior_N
protestát_N	protest_N

štuleček_N	štulec_N
krmeleček_N	krmelec_N
vdoveček_N	vdovec_N
Zajíček_N	Zajíc_N
novorozeneček_N	novorozenec_N
uječek_N	ujec_N

habrovec_N	habr_N
pepřovec_N	pepř_N
drátovec_N	drát_N
rákosovec_N	rákos_N
býkovec_N	býk_N
Přemyslovec_N	Přemysl_N

židovna_N	žid_N
Maximovna_N	Maxim_N
Přemyslovna_N	Přemysl_N
štěrkovna_N	štěrk_N
serverovna_N	server_N
klubovna_N	klub_N

sdělný_A	sdělit_V
platný_A	platit_V
štěpný_A	štěpit_V
příčný_A	příčit_V
mluvný_A	mluvit_V
povolný_A	povolit_V

burzovní_A	burza_N
kasovní_A	kasa_N
poštovní_A	pošta_N
kastovní_A	kasta_N
srandovní_A	sranda_N
menzovní_A	menza_N

prokurista_N	prokura_N
citerista_N	citera_N
fujarista_N	fujara_N
gambista_N	gamba_N
katastrofista_N	katastrofa_N
aférista_N	aféra_N

příkře_D	příkrý_A
pestře_D	pestrý_A
jaře_D	jarý_A
chrabře_D	chrabrý_A
dobře_D	dobrý_A
bystře_D	bystrý_A

antagonizovat_V	antagonismus_N
automatizovat_V	automatismus_N
magnetizovat_V	magnetismus_N
bohemizovat_V	bohemismus_N
aktivizovat_V	aktivismus_N
byrokratizovat_V	byrokratismus_N

observatorní_A	observatoř_N
veterinární_A	veterinář_N
laboratorní_A	laboratoř_N
seminární_A	seminář_N
humanitární_A	humanitář_N
konzervatorní_A	konzervatoř_N

mourek_N	mour_N
krumpáček_N	krumpáč_N
šípek_N	šíp_N
Lounek_N	Loun_N
Arnoštek_N	Arnošt_N
Abrahámek_N	Abrahám_N

tvarohovina_N	tvaroh_N
chujovina_N	chuj_N
šusťákovina_N	šusťák_N
bukovina_N	buk_N
plášťovina_N	plášť_N
ptákovina_N	pták_N

ojnice_N	oj_N
chmelnice_N	chmel_N
hampejznice_N	hampejz_N
úvodnice_N	úvod_N
chobotnice_N	chobot_N
dopisnice_N	dopis_N

vřídelní_A	vřídlo_N
kormidelní_A	kormidlo_N
zřídelní_A	zřídlo_N
hrdelní_A	hrdlo_N
divadelní_A	divadlo_N
sídelní_A	sídlo_N

Ančincová_N	Ančinec_N
Vavřincová_N	Vavřinec_N
Klipcová_N	Klipec_N
Hadrbolcová_N	Hadrbolec_N
Zdichyncová_N	Zdichynec_N
Skurovcová_N	Skurovec_N

huťmistr_N	huť_N
strojmistr_N	stroj_N
cukrmistr_N	cukr_N
garážmistr_N	garáž_N
sbormistr_N	sbor_N
traťmistr_N	trať_N

savčí_A	savec_N
nosorožčí_A	nosorožec_N
samčí_A	samec_N
kančí_A	kanec_N
umrlčí_A	umrlec_N
sumčí_A	sumec_N

došek_N	doch_N
padoušek_N	padouch_N
smíšek_N	smích_N
úspěšek_N	úspěch_N
hrášek_N	hrách_N

absint_N	absintizmus_N
alkohol_N	alkoholizmus_N
amatér_N	amatérizmus_N
barbar_N	barbarizmus_N
kanibal_N	kanibalizmus_N

krámy_N	krám_N
anály_N	anál_N
hadry_N	hadr_N
Děčany_N	Děčan_N
Slovany_N	Slovan_N

štafl_N	štafle_N
financ_N	finance_N
pikl_N	pikle_N
reflex_N	reflexe_N
peníz_N	peníze_N

ječet_V	jek_N
pučet_V	puk_N
hrčet_V	hrk_N
zvučet_V	zvuk_N
ryčet_V	ryk_N

socializovat_V	sociální_A
medializovat_V	mediální_A
banalizovat_V	banální_A
aktualizovat_V	aktuální_A
materializovat_V	materiální_A

jeskyňka_N	jeskyně_N
kuchyňka_N	kuchyně_N
bachyňka_N	bachyně_N
hospodyňka_N	hospodyně_N
žákyňka_N	žákyně_N

džihádismus_N	džihád_N
chvostismus_N	chvost_N
fetišismus_N	fetiš_N
pozitivismus_N	pozitiv_N
somnambulismus_N	somnambul_N

mecháček_N	mech_N
chlupáček_N	chlup_N
rojáček_N	roj_N
špekáček_N	špek_N
pecháček_N	pech_N

lososárna_N	losos_N
tvarohárna_N	tvaroh_N
fízlárna_N	fízl_N
panelárna_N	panel_N
lehárna_N	leh_N

stranička_N	strana_N
rýmička_N	rýma_N
Evička_N	Eva_N
basička_N	basa_N
podkovička_N	podkova_N

archaizmus_N	archaický_A
erotizmus_N	erotický_A
eklektizmus_N	eklektický_A
synkretizmus_N	synkretický_A
romantizmus_N	romantický_A

hlukoměr_N	hluk_N
tukoměr_N	tuk_N
cukroměr_N	cukr_N
tlakoměr_N	tlak_N
krokoměr_N	krok_N

edukace_N	edukativní_A
atrakce_N	atraktivní_A
relace_N	relativní_A
intuice_N	intuitivní_A
konstituce_N	konstitutivní_A

stovečka_N	stovka_N
vrátečka_N	vrátka_N
aktovečka_N	aktovka_N
otýpečka_N	otýpka_N
kořalečka_N	kořalka_N

trýznit_V	trýzeň_N
žíznit_V	žízeň_N
rožnit_V	rožeň_N
básnit_V	báseň_N
tísnit_V	tíseň_N

stánek_N	stan_N
stojánek_N	stojan_N
hafánek_N	hafan_N
Zemánek_N	Zeman_N
Pražánek_N	Pražan_N

peprný_A	pepřit_V
pitvorný_A	pitvořit_V
šetrný_A	šetřit_V
marný_A	mařit_V
norný_A	nořit_V

žitovka_N	žito_N
masovka_N	maso_N
bradavka_N	brada_N
torpédovka_N	torpédo_N
kilovka_N	kilo_N

charitativní_A	charita_N
figurativní_A	figura_N
fakultativní_A	fakulta_N
autoritativní_A	autorita_N
taxativní_A	taxa_N

dluhopis_N	dluh_N
tiskopis_N	tisk_N
živočichopis_N	živočich_N
nerostopis_N	nerost_N
lékopis_N	lék_N

postřehnout_V	postřeh_N
koštnout_V	košt_N
šmrncnout_V	šmrnc_N
svitnout_V	svit_N
lesknout_V	lesk_N

metyl_N	metan_N
propyl_N	propan_N
butyl_N	butan_N
etyl_N	etan_N
pentyl_N	pentan_N

Vltavan_N	Vltava_N
Šumavan_N	Šumava_N
Kambodžan_N	Kambodža_N
Kazin_N	Kazi_N
Litvan_N	Litva_N

kulíšek_N	kulich_N
Jindříšek_N	Jindřich_N
ženíšek_N	ženich_N
živočíšek_N	živočich_N
mníšek_N	mnich_N

připuštění_N	připustit_V
dopuštění_N	dopustit_V
propuštění_N	propustit_V
rozpuštění_N	rozpustit_V
puštění_N	pustit_V

sorabista_N	sorabistika_N
apologeta_N	apologetika_N
germanista_N	germanistika_N
religionista_N	religionistika_N
afrikanista_N	afrikanistika_N

Kolumbijec_N	Kolumbie_N
Núbijec_N	Núbie_N
Galicijec_N	Galicie_N
Zambijec_N	Zambie_N
Namibijec_N	Namibie_N

exotika_N	exot_N
andělika_N	anděl_N
grafika_N	graf_N
fotonika_N	foton_N
symbolika_N	symbol_N

ústupný_A	ústupek_N
smutný_A	smutek_N
výsledný_A	výsledek_N
náramný_A	náramek_N
pořádný_A	pořádek_N

typizovat_V	typ_N
kolektivizovat_V	kolektiv_N
stylizovat_V	styl_N
katalogizovat_V	katalog_N
terorizovat_V	teror_N

kloboučník_N	klobouk_N
baráčník_N	barák_N
pátečník_N	pátek_N
zámečník_N	zámek_N
tabáčník_N	tabák_N

Timořan_N	Timor_N
Zaiřan_N	Zair_N
Madagaskařan_N	Madagaskar_N
Singapuřan_N	Singapur_N
Salvadořan_N	Salvador_N

baleťák_N	balet_N
byťák_N	byt_N
smrťák_N	smrt_N
čtvrťák_N	čtvrt_N
rafťák_N	raft_N

družit_V	druh_N
loužit_V	louh_N
tržit_V	trh_N
dlužit_V	dluh_N
soustružit_V	soustruh_N

plachtař_N	plachta_N
známkař_N	známka_N
tyčkař_N	tyčka_N
zprávař_N	zpráva_N
svíčkař_N	svíčka_N

štvavý_A	štvát_V
řvavý_A	řvát_V
žravý_A	žrát_V
spavý_A	spát_V
savý_A	sát_V

bokem_D	bok_N
obratem_D	obrat_N
dílem_D	díl_N
středem_D	střed_N
krokem_D	krok_N

sob_N	sobí_A
kojot_N	kojotí_A
krokodýl_N	krokodýlí_A
šimpanz_N	šimpanzí_A
holub_N	holubí_A

heslovitý_A	heslo_N
železovitý_A	železo_N
šídlovitý_A	šídlo_N
máslovitý_A	máslo_N

kvintet_N	kvinteto_N
nonet_N	noneto_N
oktet_N	okteto_N
septet_N	septeto_N

bohoslovec_N	bohosloví_N
utrpenec_N	utrpení_N
Záporožec_N	Záporoží_N
Polabec_N	Polabí_N

prosný_A	proso_N
žitný_A	žito_N
masný_A	maso_N
slovný_A	slovo_N

svor_N	svorka_N
Nor_N	Norka_N
záliv_N	zálivka_N
dým_N	dýmka_N

hlohyně_N	hloh_N
obryně_N	obr_N
sokyně_N	sok_N
žákyně_N	žák_N

asistence_N	asistovat_V
preference_N	preferovat_V
urgence_N	urgovat_V
existence_N	existovat_V

Žofka_N	Žofie_N
baterka_N	baterie_N
Natálka_N	Natálie_N
Lucka_N	Lucie_N

zlatohlavý_A	zlatohlav_N
ozimý_A	ozim_N
jaký_A	jak_N
pravěký_A	pravěk_N

přejezd_N	přejet_V
rozjezd_N	rozjet_V
nadjezd_N	nadjet_V
objezd_N	objet_V

gambler_N	gambling_N
busker_N	busking_N
curler_N	curling_N
spinner_N	spinning_N

nárok_N	náročný_A
hluk_N	hlučný_A
statek_N	statečný_A
opak_N	opačný_A

směneční_A	směnka_N
památeční_A	památka_N
kořaleční_A	kořalka_N
lebeční_A	lebka_N

recidiva_N	recidivista_N
kariéra_N	kariérista_N
komuna_N	komunista_N
droga_N	drogista_N

kompozit_N	kompozice_N
sekret_N	sekrece_N
ambit_N	ambice_N
recept_N	recepce_N

tvoreček_N	tvor_N
filmeček_N	film_N
výreček_N	výr_N
byteček_N	byt_N

synonymní_A	synonymum_N
pejorativní_A	pejorativum_N
adjektivní_A	adjektivum_N
substantivní_A	substantivum_N

močovod_N	moč_N
zvukovod_N	zvuk_N
chámovod_N	chám_N
kouřovod_N	kouř_N

plán_N	plánování_N
gril_N	grilování_N
respekt_N	respektování_N
stream_N	streamování_N

manifest_N	manifestace_N
port_N	portace_N
pastor_N	pastorace_N
konzum_N	konzumace_N

odpadky_N	odpad_N
tesilky_N	tesil_N
nůžky_N	nůž_N
golfky_N	golf_N

Srba_N	Srbová_N
Macka_N	Macková_N
Valenta_N	Valentová_N
Pěknica_N	Pěknicová_N

plivanec_N	plivat_V
kopanec_N	kopat_V
dlabanec_N	dlabat_V
cákanec_N	cákat_V

odpolední_A	odpoledne_N
dopolední_A	dopoledne_N
zmijí_A	zmije_N
polední_A	poledne_N

zubačka_N	zub_N
prdelačka_N	prdel_N
chocholačka_N	chochol_N
skotačka_N	skot_N

tvarůžek_N	tvaroh_N
parůžek_N	paroh_N
růžek_N	roh_N
batůžek_N	batoh_N

kosterní_A	kostra_N
veseloherní_A	veselohra_N
bederní_A	bedra_N
činoherní_A	činohra_N

kořalinka_N	kořalka_N
průdušinka_N	průduška_N
matinka_N	matka_N
žežulinka_N	žežulka_N

robotárna_N	robota_N
svobodárna_N	svoboda_N
bagetárna_N	bageta_N
paštikárna_N	paštika_N

kužel_N	kuželník_N
církev_N	církevník_N
nájezd_N	nájezdník_N
klenot_N	klenotník_N

komediální_A	komedie_N
bakteriální_A	bakterie_N
bestiální_A	bestie_N
kategoriální_A	kategorie_N

ordinariát_N	ordinář_N
sekretariát_N	sekretář_N
proletariát_N	proletář_N
primariát_N	primář_N

clonný_A	clona_N
trefný_A	trefa_N
protivný_A	protiva_N
notný_A	nota_N

snášenlivý_A	snášet_V
mlčenlivý_A	mlčet_V
úpěnlivý_A	úpět_V
zdrženlivý_A	zdržet_V

paprskovitý_A	paprsek_N
lilkovitý_A	lilek_N
ježkovitý_A	ježek_N
frackovitý_A	fracek_N

tenčit_V	tenký_A
měkčit_V	měkký_A
křehčit_V	křehký_A
vlhčit_V	vlhký_A

šperkovnice_N	šperk_N
dýmovnice_N	dým_N
hákovnice_N	hák_N
šachovnice_N	šach_N

Březnicko_N	Březnice_N
Litoměřicko_N	Litoměřice_N
Hejnicko_N	Hejnice_N
Pardubicko_N	Pardubice_N

morčecí_A	morče_N
štěněcí_A	štěně_N
hříběcí_A	hříbě_N
hraběcí_A	hrabě_N

efekt_N	efektivní_A
abort_N	abortivní_A
subjekt_N	subjektivní_A
progres_N	progresivní_A

prospektor_N	prospekt_N
falzifikátor_N	falzifikát_N
auditor_N	audit_N
faktor_N	fakt_N

Guatemalec_N	Guatemala_N
houbec_N	houba_N
zvěřinec_N	zvěřina_N
představec_N	představa_N

montovat_V	montáž_N
blamovat_V	blamáž_N
arbitrovat_V	arbitráž_N
sabotovat_V	sabotáž_N

rebelant_N	rebel_N
azylant_N	azyl_N
duelant_N	duel_N
ministrant_N	ministr_N

podpořit_V	podpora_N
kmotřit_V	kmotra_N
jiskřit_V	jiskra_N
sířit_V	síra_N

pilotáž_N	pilot_N
betonáž_N	beton_N
metráž_N	metr_N
gramáž_N	gram_N

Antonín_N	Antonie_N
Gruzín_N	Gruzie_N
Terezín_N	Terezie_N
Žofín_N	Žofie_N

Liberecko_N	Liberec_N
Třinecko_N	Třinec_N
Žatecko_N	Žatec_N
Prusko_N	Prus_N

kapitalizmus_N	kapitalista_N
materializmus_N	materialista_N
buddhizmus_N	buddhista_N
bonapartizmus_N	bonapartista_N

korbílek_N	korbel_N
manžílek_N	manžel_N
popílek_N	popel_N
kužílek_N	kužel_N

hatit_V	hať_N
plstit_V	plsť_N
pečetit_V	pečeť_N
drtit_V	drť_N

nehodovka_N	nehoda_N
bábovka_N	bába_N
láčkovka_N	láčka_N
dýhovka_N	dýha_N

rumiště_N	rum_N
pohřebiště_N	pohřeb_N
zápasiště_N	zápas_N
týniště_N	týn_N

Pompejan_N	Pompeje_N
Chilan_N	Chile_N
Zimbabwan_N	Zimbabwe_N

hlasitý_A	hlas_N
zákonitý_A	zákon_N
trnitý_A	trn_N

arizovat_V	arizace_N
bolševizovat_V	bolševizace_N
diftongizovat_V	diftongizace_N

orlí_A	orel_N
syslí_A	sysel_N
oslí_A	osel_N

kanalizovat_V	kanál_N
signalizovat_V	signál_N
paušalizovat_V	paušál_N

černá_N	černý_A
dobrá_N	dobrý_A
vysoká_N	vysoký_A

tvarohovatět_V	tvaroh_N
cukrovatět_V	cukr_N
fotrovatět_V	fotr_N

nitěný_A	nit_N
drátěný_A	drát_N
kostěný_A	kost_N

jízdné_N	jízda_N
výbavné_N	výbava_N
výchovné_N	výchova_N

krám_N	krámy_N
Loun_N	Louny_N
Vlach_N	Vlachy_N

výsměšný_A	výsměch_N
rušný_A	ruch_N
vzdušný_A	vzduch_N

čočička_N	čočka_N
žežulička_N	žežulka_N
Doubravička_N	Doubravka_N

chocholouš_N	chochol_N
cukrouš_N	cukr_N
vlkouš_N	vlk_N

pelíšek_N	pelech_N
plíšek_N	plech_N
oříšek_N	ořech_N

potomní_A	potom_D
zatímní_A	zatím_D
tamní_A	tam_D

tulipánovník_N	tulipán_N
gruntovník_N	grunt_N
cukrovník_N	cukr_N

páčit_V	páka_N
ručit_V	ruka_N
válčit_V	válka_N

vápencovitý_A	vápenec_N
válcovitý_A	válec_N
kopcovitý_A	kopec_N

Pavlík_N	Pavel_N
kablík_N	kabel_N
Karlík_N	Karel_N

bordýlek_N	bordel_N
hotýlek_N	hotel_N
věrtýlek_N	věrtel_N

zásobiště_N	zásoba_N
kotviště_N	kotva_N
kolbiště_N	kolba_N

jedinečný_A	jedinec_N
čtverečný_A	čtverec_N
měsíčný_A	měsíc_N

benignita_N	benigní_A
modernita_N	moderní_A
malignita_N	maligní_A

toxicita_N	toxický_A
autenticita_N	autentický_A
etnicita_N	etnický_A

bučina_N	buk_N
klučina_N	kluk_N
smrčina_N	smrk_N

sykat_V	syčet_V
mekat_V	mečet_V
frkat_V	frčet_V

gumovník_N	guma_N
myrhovník_N	myrha_N
mandarinkovník_N	mandarinka_N

tuberkul_N	tuberkulóza_N
vir_N	viróza_N
parazit_N	parazitóza_N

Sedlčany_N	Sedlčansko_N
Rokycany_N	Rokycansko_N
Klatovy_N	Klatovsko_N

čip_N	čipovka_N
akt_N	aktovka_N
banán_N	banánovka_N

bradavice_N	brada_N
nohavice_N	noha_N
bukvice_N	buk_N

kabina_N	kabinet_N
klarina_N	klarinet_N
kvarta_N	kvartet_N

vlčice_N	vlk_N
dračice_N	drak_N
račice_N	rak_N

máslař_N	máslo_N
mankař_N	manko_N
hovnař_N	hovno_N

archivistika_N	archiv_N
stylistika_N	styl_N
charakteristika_N	charakter_N

desátka_N	desátek_N
Radka_N	Radek_N
Františka_N	František_N

sok_N	sokyně_N
rek_N	rekyně_N
žák_N	žákyně_N

harmonovat_V	harmonie_N
atrofovat_V	atrofie_N
amnestovat_V	amnestie_N

toužit_V	touha_N
snažit_V	snaha_N
mlžit_V	mlha_N

muzejní_A	muzeum_N
jubilejní_A	jubileum_N
stipendijní_A	stipendium_N

památečný_A	památka_N
směnečný_A	směnka_N
podmínečný_A	podmínka_N

hnízdit_V	hnízdo_N
čelit_V	čelo_N
zrcadlit_V	zrcadlo_N

potom_D	potomní_A
zatím_D	zatímní_A
dosavad_D	dosavadní_A

vršit_V	vrch_N
rušit_V	ruch_N
strašit_V	strach_N

perový_A	pero_N
dnavý_A	dna_N
zimavý_A	zima_N

pilovitý_A	pila_N
cesmínovitý_A	cesmína_N
houbovitý_A	houba_N

Maledivec_N	Maledivy_N
Filipínec_N	Filipíny_N
Bahamec_N	Bahamy_N

špejlit_V	špejle_N
prasit_V	prase_N
randit_V	rande_N

prérijní_A	prérie_N
unijní_A	unie_N
galerijní_A	galerie_N

koncentrovat_V	koncentrák_N
buzerovat_V	buzerák_N
vekslovat_V	vekslák_N

spermie_N	sperma_N
satrapie_N	satrapa_N
partie_N	parta_N

mrzačit_V	mrzák_N
sedlačit_V	sedlák_N
pytlačit_V	pytlák_N

akrobacie_N	akrobat_N
akácie_N	akát_N
idiocie_N	idiot_N

bystřit_V	bystrý_A
modřit_V	modrý_A
mokřit_V	mokrý_A

obcovat_V	obec_N
válcovat_V	válec_N
poslancovat_V	poslanec_N

ožrala_N	ožralý_A
uhelna_N	uhelný_A
ruda_N	rudý_A

koincidovat_V	koincidence_N
evidovat_V	evidence_N
preferovat_V	preference_N

matice_N	matka_N
kytice_N	kytka_N
trojice_N	trojka_N

plůdek_N	plod_N
schůdek_N	schod_N
obchůdek_N	obchod_N

existencionální_A	existence_N
extenzionální_A	extenze_N
funkcionální_A	funkce_N

Košičan_N	Košice_N
Krasličan_N	Kraslice_N
Hraničan_N	Hranice_N

veslo_N	veslovat_V
věno_N	věnovat_V
pádlo_N	pádlovat_V

abstinovat_V	abstinent_N
dirigovat_V	dirigent_N
oponovat_V	oponent_N

syn_N	synáček_N
Mach_N	Macháček_N
špek_N	špekáček_N

kapitulant_N	kapitulovat_V
komandant_N	komandovat_V
fakturant_N	fakturovat_V

milostivý_A	milost_N
hněvivý_A	hněv_N
červotočivý_A	červotoč_N

Durynk_N	Durynsko_N
Šumperk_N	Šumpersko_N
Šternberk_N	Šternbersko_N

mocnit_V	moc_N
běsnit_V	běs_N
řečnit_V	řeč_N

morna_N	mor_N
kůlna_N	kůl_N
výhledna_N	výhled_N

autentizovat_V	autentický_A
dynamizovat_V	dynamický_A
ironizovat_V	ironický_A

Liberec_N	Liberecko_N
Prus_N	Prusko_N
Třinec_N	Třinecko_N

asimilát_N	asimilace_N
sublimát_N	sublimace_N
elaborát_N	elaborace_N

okenička_N	okenice_N
radlička_N	radlice_N
vichřička_N	vichřice_N

cop_N	copánek_N
Topol_N	Topolánek_N
Šafr_N	Šafránek_N

šéfovský_A	šéf_N
obrovský_A	obr_N
hofmistrovský_A	hofmistr_N

restituovat_V	restituce_N
substituovat_V	substituce_N
distribuovat_V	distribuce_N

hloubkoměr_N	hloubka_N
křivkoměr_N	křivka_N
srážkoměr_N	srážka_N

avantgardistický_A	avantgardizmus_N
entuziastický_A	entuziazmus_N
bonapartistický_A	bonapartizmus_N

Honzák_N	Honza_N
Opavák_N	Opava_N
Litvák_N	Litva_N

léčebna_N	léčba_N
lučebna_N	lučba_N
platebna_N	platba_N

Leningraďan_N	Leningrad_None
Petrohraďan_N	Petrohrad_None
Stalingraďan_N	Stalingrad_None

retušér_N	retuš_N
voltižér_N	voltiž_N
startér_N	start_N

ocásek_N	ocas_N
rozhlásek_N	rozhlas_N
klásek_N	klas_N

patice_N	pata_N
Ostravice_N	Ostrava_N
cévice_N	céva_N

meteorit_N	meteor_N
molybdenit_N	molybden_N
chromit_N	chrom_N

spoleh_N	spolehnout_V
brejk_N	brejknout_V
mok_N	moknout_V

křemenáč_N	křemen_N
nanukáč_N	nanuk_N
kruháč_N	kruh_N

analfabet_N	analfabetismus_N
bráhman_N	bráhmanismus_N
aktiv_N	aktivismus_N

pouze_D	pouhý_A
sáhodlouze_D	sáhodlouhý_A
stroze_D	strohý_A

neandertálec_N	neandertálský_A
masarykovec_N	masarykovský_A
darwinovec_N	darwinovský_A

cize_D	cizí_A
ryze_D	ryzí_A
svěže_D	svěží_A

normál_N	norma_N
portál_N	porta_N
placentál_N	placenta_N

adaptovat_V	adaptér_N
žonglovat_V	žonglér_N
mixovat_V	mixér_N

ježek_N	ježit_V
zvonek_N	zvonit_V
působek_N	působit_V

Ostrava_N	Ostravsko_N
Jihlava_N	Jihlavsko_N
Toskána_N	Toskánsko_N

kolidovat_V	kolize_N
abradovat_V	abraze_N
erodovat_V	eroze_N

bos_N	bosý_A
chrom_N	chromý_A
nov_N	nový_A

zpětný_A	zpět_D
opětný_A	opět_D
včasný_A	včas_D

koleso_N	kolo_N
těleso_N	tělo_N
sloveso_N	slovo_N

rezavý_A	rez_N
popelavý_A	popel_N
kadeřavý_A	kadeř_N

Goldin_N	Golda_N
Hanin_N	Hana_N
Dorotin_N	Dorota_N

desetitisíce_N	desetitisíc_N
veřeje_N	veřej_N
regrese_N	regres_N

náměstkyně_N	náměstek_N
svědkyně_N	svědek_N
pastorkyně_N	pastorek_N

operatér_N	operace_N
restauratér_N	restaurace_N
absentér_N	absence_N

brek_N	brečet_V
ryk_N	ryčet_V
jek_N	ječet_V

borkyně_N	borec_N
učenkyně_N	učenec_N
zoufalkyně_N	zoufalec_N

smrádek_N	smrad_N
hádek_N	had_N
hrádek_N	hrad_N

oběžný_A	oběh_N
vztažný_A	vztah_N
dlužný_A	dluh_N

Berouňan_N	Beroun_None
Miláňan_N	Milán_None
Bostoňan_N	Boston_None

prameniště_N	pramenit_V
složiště_N	složit_V
seřadiště_N	seřadit_V

tygrovaný_A	tygr_N
talentovaný_A	talent_N

doktrinární_A	doktrína_N
disciplinární_A	disciplína_N

leucinóza_N	leucin_N
mimóza_N	mim_N

kotevní_A	kotva_N
bitevní_A	bitva_N

vyžla_N	vyžle_N
Maria_N	Marie_N

seník_N	seno_N
plemeník_N	plemeno_N

skif_N	skifařka_N
skeet_N	skeetařka_N

mandelinka_N	mandel_N
bezinka_N	bez_N

Turkmenistán_N	Turkmen_N
Uzbekistán_N	Uzbek_N

softball_N	softbal_N
špicl_N	špic_N

drobné_N	drobný_A
šampaňské_N	šampaňský_A

politizovat_V	politika_N
polemizovat_V	polemika_N

Hronková_N	Hronová_N
Bartoňková_N	Bartoňová_N

proužek_N	pruh_N
pstroužek_N	pstruh_N

rakůvka_N	rak_N
lemůvka_N	lem_N

ondy_D	onde_D
všudy_D	všude_D

nedělička_N	neděle_N
grešlička_N	grešle_N

frkot_N	frčet_V
brekot_N	brečet_V

endemit_N	endemický_A
dynamit_N	dynamický_A

hrb_N	hrbatý_A
pejz_N	pejzatý_A

tábořiště_N	tábor_N
orchestřiště_N	orchestr_N

orientalista_N	orient_N
instrumentalista_N	instrument_N

kolem_D	kolo_N
právem_D	právo_N

měsíčník_N	měsíc_N
střevíčník_N	střevíc_N

angora_N	angorizmus_N
avantgarda_N	avantgardizmus_N

humoreska_N	humor_N
hosteska_N	host_N

katedrála_N	katedra_N
normála_N	norma_N

laní_A	laň_N
vorvaní_A	vorvaň_N

obilný_A	obilí_N
zelný_A	zelí_N

Bohumila_N	Bohumil_NC
Vlastimila_N	Vlastimil_NC

volař_N	vůl_N
stolař_N	stůl_N

modrooký_A	modrý_A
šikmooký_A	šikmý_A

hovor_N	hovořit_V
mor_N	mořit_V

materialismus_N	materiál_N
kapitalismus_N	kapitál_N

babylon_N	babylónský_A
faraon_N	faraónský_A

odvážka_N	odvážet_V
frčka_N	frčet_V

srp_N	srpen_N
hřeb_N	hřeben_N

bručák_N	bručet_V
fičák_N	fičet_V

pátek_N	páteční_A
pupek_N	pupeční_A

bublanina_N	bublat_V
rubanina_N	rubat_V

vápenný_A	vápno_N
prkenný_A	prkno_N

rozsoška_N	rozsocha_N
cíška_N	cícha_N

Miloň_N	Miloš_N
Dobříň_N	Dobříš_N

mečet_V	mekat_V
syčet_V	sykat_V

exponovat_V	expozice_N
disponovat_V	dispozice_N

krematorium_N	kremace_N
sanatorium_N	sanace_N

trámoví_N	trám_N
sloupoví_N	sloup_N

pediatrička_N	pediatrie_N
Žofička_N	Žofie_N

mrkvovitý_A	mrkev_N
tykvovitý_A	tykev_N

Rwanďan_N	Rwanda_N
Grenaďan_N	Grenada_N

dezertér_N	dezertovat_V
žonglér_N	žonglovat_V

trojka_N	trojice_N
dvojka_N	dvojice_N

mobilizovat_V	mobilní_A
sterilizovat_V	sterilní_A

dveřej_N	dveře_N
partaj_N	parta_N

pozdě_D	pozdní_A
zvláště_D	zvláštní_A

utilizovat_V	utilita_N
kriminalizovat_V	kriminalita_N

sluchadlo_N	sluch_N
sukadlo_N	suk_N

ospalek_N	ospalý_A
prvek_N	prvý_A

viničný_A	vinice_N
hořčičný_A	hořčice_N

Zdenek_N	Zdeněk_N
Věnek_N	Věněk_N

japanoložka_N	japanologie_NC
gerontoložka_N	gerontologie_NC

Vorel_N	Vorlová_N
Havel_N	Havlová_N

dřepět_V	dřep_N
šumět_V	šum_N

prokuratura_N	prokurátor_N
diktatura_N	diktátor_N

veveruška_N	veverka_N
Jituška_N	Jitka_N

konvice_N	konev_N
pánvice_N	pánev_N

Písečan_N	Písek_None
Norimberčan_N	Norimberk_None

opičit_V	opice_N
líčit_V	líce_N

provinciál_N	provincie_N
koloniál_N	kolonie_N

dávačka_N	dávat_V
skartovačka_N	skartovat_V

dvoutýdeník_N	dvoutýdenní_A
čtrnáctideník_N	čtrnáctidenní_A

kurevník_N	kurva_N
vrstevník_N	vrstva_N

židovština_N	žid_N
šturmovština_N	šturm_N

slizký_D	sliz_N
břitký_D	břit_N

bouře_N	bouřit_V
batole_N	batolit_V

systematika_N	systém_N
problematika_N	problém_N

zřivý_A	zřít_V
chtivý_A	chtít_V

oratorium_N	oratoř_N
kalendárium_N	kalendář_N

noveleta_N	novela_N
opereta_N	opera_N

blažit_V	blahý_A
množit_V	mnohý_A

Kiribaťan_N	Kiribati_N
Haiťan_N	Haiti_N

žárovčička_N	žárovka_N
zkumavčička_N	zkumavka_N

laciný_A	lacino_D
lítý_A	líto_D

labutí_A	labuť_N
sviští_A	svišť_N

exponent_N	expozice_N
komponent_N	kompozice_N

makovka_N	makový_A
sněhovka_N	sněhový_A

taktak_D	tak_D
užuž_D	už_D

Žatečan_N	Žatec_N
Chlumečan_N	Chlumec_N

crack_N	cracker_N
sken_N	skener_N

Uzbek_N	Uzbekistán_N
Turkmen_N	Turkmenistán_N

oligarchie_N	oligarcha_NC
monarchie_N	monarcha_NC

jubileum_N	jubilejní_A
muzeum_N	muzejní_A

pásmo_N	pás_N
kouřmo_N	kouř_N

absoluce_N	absolvovat_V
perzekuce_N	perzekvovat_V

loutkařit_V	loutka_N
chatařit_V	chata_N

stigmatizovat_V	stigma_N
klimatizovat_V	klima_N

chaos_N	chaotický_A
démos_N	démotický_A

prsten_N	prst_N
duben_N	dub_N

popravce_N	poprava_N
úpravce_N	úprava_N

Jakoubek_N	Jakub_N
doubek_N	dub_N

komunikativní_A	komunikační_A
konstruktivní_A	konstrukční_A

Titan_N	Titán_N
pan_N	pán_N

pastelkovné_N	pastelka_N
fackovné_N	facka_N

hlasivka_N	hlas_N
bičivka_N	bič_N

skladné_N	sklad_N
dovozné_N	dovoz_N

Bavorák_N	Bavorsko_N
Tyrolák_N	Tyrolsko_N

trojčátko_N	trojče_N
varlátko_N	varle_N

kriminálník_N	kriminální_A
stolník_N	stolní_A

izolacionismus_N	izolace_N
abolicionismus_N	abolice_N

pirožek_N	piroh_N
výtažek_N	výtah_N

člunkovitý_A	člun_N
drátkovitý_A	drát_N

šrot_N	šrotovné_N
start_N	startovné_N

Františkov_N	František_N
Vítkov_N	Vítek_N

vidlice_N	vidle_N
židlice_N	židle_N

ježovka_N	ježek_N
výsledovka_N	výsledek_N

myrha_N	myrhovník_N
skořápka_N	skořápkovník_N

okultismus_N	okultní_A
absolutismus_N	absolutní_A

holenní_A	holeň_N
jesenní_A	jeseň_N

konzul_N	konzulát_N
šampion_N	šampionát_N

ubrousek_N	ubrus_N
brousek_N	brus_N

pilatka_N	pila_N
střechatka_N	střecha_N

Syrakusan_N	Syrakusy_None
Théban_N	Théby_None

principál_N	princip_N
instrumentál_N	instrument_N

pivní_A	pivo_N
místní_A	místo_N

Malawijec_N	Malawi_N
Fidžijec_N	Fidži_N

deprivant_N	deprivace_N
habilitant_N	habilitace_N

kulometčík_N	kulomet_N
Jakubčík_N	Jakub_N

zůstání_N	zůstat_V
budování_N	budovat_V

Nasadilová_N	Nasadil_N
Šafářová_N	Šafář_N

důmysl_N	domyslet_V
průmysl_N	promyslet_V

Kartáginec_N	Kartágo_N
prosinec_N	proso_N

třes_N	třást_V
otřes_N	otřást_V

rádius_N	rádiový_A
eukalyptus_N	eukalyptový_A

pružina_N	pružný_A
rovina_N	rovný_A

Lahovičky_N	Lahovice_N
kombinačky_N	kombinace_N

višínka_N	višeň_N
holínka_N	holeň_N

subjektivní_A	subjekt_N
atributivní_A	atribut_N

koncesionář_N	koncese_N
vizionář_N	vize_N

asepse_N	aseptický_A
synopse_N	synoptický_A

klíčit_V	klíček_N
ježit_V	ježek_N

troubel_N	trouba_N
kozel_N	koza_N

rošovat_V	rošáda_N
marinovat_V	marináda_N

hasnice_N	hasit_V
střelnice_N	střelit_V

služčin_A	služka_N
matčin_A	matka_N

Ondříčková_N	Ondřej_N
Blažíčková_N	Blažej_N

hloží_N	hloh_N
paroží_N	paroh_N

Stalingrad_N	Stalin_N
Leningrad_N	Lenin_N

alt_N	altistka_N
skeleton_N	skeletonistka_N

křivárna_N	křivý_A
levárna_N	levý_A

zhůvěřilec_N	zhůvěřilý_A
psanec_N	psaný_A

kačírek_N	kačer_N
frajírek_N	frajer_N

varhanní_A	varhany_N
rorátní_A	roráty_N

kategorizovat_V	kategorie_N
harmonizovat_V	harmonie_N

pivovárek_N	pivovar_N
Kašpárek_N	Kašpar_N

dlážka_N	dlaha_N
podlážka_N	podlaha_N

posuv_N	posuvný_A
splav_N	splavný_A

lazar_N	lazaret_N
menu_N	menuet_N

oratorní_A	oratorium_N
sanatorní_A	sanatorium_N

dogma_N	dogmatický_A
astma_N	astmatický_A

pankreatický_A	pankreas_N
herpetický_A	herpes_N

pytlovat_V	pytel_N
datlovat_V	datel_N

Bavořan_N	Bavorsko_N
Štýřan_N	Štýrsko_N

neurotický_A	neuróza_N
aterosklerotický_A	ateroskleróza_N

podélný_A	podél_R
vstřícný_A	vstříc_R

satrapa_N	satrapie_N
sperma_N	spermie_N

Bis_N	Bisová_N
Jor_N	Jorová_N

ablativ_N	ablace_N
kolektiv_N	kolekce_N

firemní_A	firma_N
noremní_A	norma_N

Pardubičák_N	Pardubice_N
slepičák_N	slepice_N

Eva_N	Evička_N
huba_N	hubička_N

drátkovat_V	drát_N
vtipkovat_V	vtip_N

Jablonecko_N	Jablonec_None
Tunisko_N	Tunis_None

brontosauří_A	brontosaurus_N
dinosauří_A	dinosaurus_N

snowboarďák_N	snowboard_N
prďák_N	prd_N

žalářní_N	žalář_N
vrchní_N	vrch_N

datovat_V	datum_N
publikovat_V	publikum_N

sabotáž_N	sabotovat_V
montáž_N	montovat_V

mědit_V	měď_N
pídit_V	píď_N

autor_N	autorita_N
major_N	majorita_N

poslice_N	posel_N
ďáblice_N	ďábel_N

borka_N	borec_N
Hispánka_N	Hispánec_N

vlastenkyně_N	vlast_N
dorostenkyně_N	dorost_N

Ghaňan_N	Ghana_N
Botswaňan_N	Botswana_N

federální_A	federace_N
inaugurální_A	inaugurace_N

jistojistý_A	jistý_A
pouhopouhý_A	pouhý_A

cukřík_N	cukr_N
svetřík_N	svetr_N

estetička_N	estetika_N
energetička_N	energetika_N

tělnatět_V	tělnatý_A
dřevnatět_V	dřevnatý_A

putýnka_N	putna_N
lokýnka_N	lokna_N

amerikanizovat_V	amerikanizmus_N
anglikanizovat_V	anglikanizmus_N

márnice_N	máry_N
vrhcábnice_N	vrhcáby_N

korálnatec_N	korál_N
hrotnatec_N	hrot_N

curium_N	curie_N
harmonium_N	harmonie_N

lokál_N	lokalizovat_V
intelektuál_N	intelektualizovat_V

gól_N	gólman_NC
kamera_N	kameraman_NC

soustíčko_N	sousto_N
tělíčko_N	tělo_N

podlažní_A	podlaha_N
záložní_A	záloha_N

kašovitý_A	kaše_N
čepicovitý_A	čepice_N

Tošov_N	Tošovská_N
Náhlov_N	Náhlovská_N

zimnice_N	zima_N
trávnice_N	tráva_N

sportoviště_N	sport_N
štěrkoviště_N	štěrk_N

pašalík_N	paša_N
špiclík_N	špic_N

živůtek_N	život_N
chobůtek_N	chobot_N

svačina_N	svačit_V
rozvalina_N	rozvalit_V

dualismus_N	duel_N
naturalismus_N	naturel_N

toustovač_N	toust_N
sendvičovač_N	sendvič_N

adopce_N	adoptovat_V
dezerce_N	dezertovat_V

nodulární_A	nodule_N
partikulární_A	partikule_N

věžný_N	věž_N
hrázný_N	hráz_N

botanizovat_V	botanik_N
dramatizovat_V	dramatik_N

sérový_A	sérum_N
vakuový_A	vakuum_N

snad_D	snadný_A
vstříc_D	vstřícný_A

presumovat_V	presumpce_N
subsumovat_V	subsumpce_N

družina_N	druh_N
batožina_N	batoh_N

snůpek_N	snop_N
cůpek_N	cop_N

kádr_N	kádrovák_N
šroub_N	šroubovák_N

Falklanďan_N	Falklandy_N
Kapverďan_N	Kapverdy_N

federace_N	federální_A
mediace_N	mediální_A

kalich_N	kališník_N
ořech_N	ořešník_N

snowboarding_N	snowboard_N
rafting_N	raft_N

šroubení_N	šroub_N
sklepení_N	sklep_N

věřitelkyně_N	věřitel_N
poselkyně_N	posel_N

prcek_N	prcat_V
klouzek_N	klouzat_V

Kule_N	Kulová_N
Kratochvíle_N	Kratochvílová_N

Jiřák_N	Jiří_N
nádražák_N	nádraží_N

purpura_N	purpurový_A
vejražka_N	vejražkový_A

jezernatý_A	jezero_N
pernatý_A	pero_N

octárna_N	ocet_N
účtárna_N	účet_N

fík_N	fíkovna_N
sněm_N	sněmovna_N

krevel_N	krev_N
obratel_N	obrat_N

kartáčovat_V	kartáček_N
plátovat_V	plátek_N

jednorázovka_N	jednorázový_AC
osmiletka_N	osmiletý_AC

maturiťák_N	maturita_N
cesťák_N	cesta_N

prezence_N	prezent_N
garance_N	garant_N

bukva_N	buk_N
břitva_N	břit_N

duchařit_V	duch_N
melouchařit_V	melouch_N

trafikant_N	trafika_N
hydrant_N	hydra_N

princátko_N	princ_N
sluchátko_N	sluch_N

řezivo_N	řezat_V
mazivo_N	mazat_V

křečík_N	křeček_N
klacík_N	klacek_N

kališník_N	kalich_N
ořešník_N	ořech_N

hutník_N	huť_N
pamětník_N	paměť_N

Agáta_N	Agátka_N
kupa_N	kupka_N

malíř_N	malovat_V
verbíř_N	verbovat_V

Šafařík_N	Šafář_N
rybařík_N	rybář_N

opozičník_N	opozice_N
finančník_N	finance_N

parlament_N	parlamentární_A
arbitr_N	arbitrární_A

cenina_N	cena_N
husina_N	husa_N

negativ_N	negativní_A
primitiv_N	primitivní_A

žirafečka_N	žirafa_N
uzdečka_N	uzda_N

bakterie_N	bakteriální_A
bestie_N	bestiální_A

revize_N	revidovat_V
abraze_N	abradovat_V

Jugoslávie_N	Jugoslávka_N
Žofie_N	Žofka_N

darwinismus_N	darwinovský_A
hitlerismus_N	hitlerovský_A

vyjížďka_N	vyjet_V
projížďka_N	projet_V

fyzika_N	fyzický_A
ezoterika_N	ezoterický_A

praváctví_N	pravák_N
leváctví_N	levák_N

rostlinopis_N	rostlina_N
chorobopis_N	choroba_N

pastorace_N	pastor_N
orchestrace_N	orchestr_N

hřbitůvek_N	hřbitov_N
ostrůvek_N	ostrov_N

bradýř_N	brada_N
baštýř_N	bašta_N

šavlenka_N	šavle_N
kudlanka_N	kudla_N

taškařit_V	taškář_N
hokynařit_V	hokynář_N

bubínek_N	buben_N
křemínek_N	křemen_N

roštěnec_N	roštěnka_N
kosatec_N	kosatka_N

rosenka_N	rosa_N
děvenka_N	děva_N

lesk_N	lesklý_A
nezvyk_N	nezvyklý_A

violoncellista_N	violoncello_N
libretista_N	libreto_N

loupat_V	loupit_V
lapat_V	lapit_V

rušno_D	ruch_N
vzdušno_D	vzduch_N

Karlíček_N	Karel_N
Pavlíček_N	Pavel_N

východo_A	východ_N
západo_A	západ_N

plavky_N	plavat_V
šponovky_N	šponovat_V

sklivec_N	sklo_N
železivec_N	železo_N

ego_N	egoista_N
advent_N	adventista_N

platonismus_N	platonský_A
semitismus_N	semitský_A

boubelatý_A	boubelka_N
placatý_A	placka_N

křemičitý_A	křemík_N
uhličitý_A	uhlík_N

kladivoun_N	kladivo_N
okoun_N	oko_N

čtyřnásobek_N	čtyřnásobný_C
devítinásobek_N	devítinásobný_C

zhouba_N	zhubit_V
chlouba_N	chlubit_V

labutěnka_N	labuť_N
pláštěnka_N	plášť_N

žebř_N	žebřík_N
Tesař_N	Tesařík_N

tanker_N	tank_N
skener_N	sken_N

vápnit_V	vápník_N
špendlit_V	špendlík_N

klaun_N	klaunerie_N
žandarm_N	žandarmerie_N

nártoun_N	nárt_N
plešoun_N	pleš_N

normalizátor_N	normalizace_N
arizátor_N	arizace_N

voděnka_N	voda_N
podkověnka_N	podkova_N

havírna_N	havíř_N
malírna_N	malíř_N

Bedřiška_N	Bedřich_N
Jindřiška_N	Jindřich_N

katedra_N	katedrální_A
epocha_N	epochální_A

racionalismus_N	racionalita_N
konformismus_N	konformita_N

legenda_N	legendární_A
kometa_N	kometární_A

úschovní_A	úschovna_N
kuní_A	kuna_N

jednoduše_D	jednoduchý_A
hluše_D	hluchý_A

investovat_V	investor_N
reflektovat_V	reflektor_N

Odry_N	Odra_N
primátorky_N	primátorka_N

horizontála_N	horizont_N
magistrála_N	magistr_N

žlutice_N	žlutý_A
hrubice_N	hrubý_A

narcisizmus_N	narcis_N
klubizmus_N	klub_N

pralesnička_N	prales_N
soudnička_N	soud_N

deštivý_A	déšť_N

Jára_N	Jaroslav_N

imperializmus_N	impérium_N

připevnit_V	pevný_A

omilostnit_V	milost_N

džínsy_N	džínovina_N

culík_N	culit_V

subtilní_A	křehký_A

prorežimní_A	režim_N

pikat_V	pikola_N

digestoř_N	gesce_N

rýsovat_V	rys_N

prvenství_N	první_C

desaterý_A	desatero_N

otop_N	topit_V

kafe_N	káva_N

chraptit_V	chrapot_N

mydlina_N	mýdlo_N

dříví_N	dřevo_N

žďářit_V	Žďár_N

předbíhat_V	běhat_V

Tetín_N	teta_N

vřeckovýtrusný_A	vřecko_N

trošku_D	trochu_None

odkládat_V	odložit_V

ryzí_A	ryze_D

koníčkář_N	kůň_N

Jiřka_N	Jiřina_N

lada_N	Ladová_N

konkubinát_N	konkubína_N

dojit_V	doják_N

řež_N	řezat_V

subjektivismus_N	subjekt_N

makovec_N	mák_N

penzionovat_V	penzijní_A

vůkol_D	kolo_N

propisovačka_N	psát_V

energetika_N	energie_N

mičuda_N	míč_N

nadoraz_D	doraz_N

stříbronosný_A	stříbro_N

Foglar_N	foglarovka_N

anulovat_V	nula_N

Slánsko_N	Slaný_None

vlahý_A	vláha_N

astmatik_N	astma_N

klisna_N	klusat_V

příštipek_N	příštipkář_N

viladům_N	vila_N

nadsamec_N	samec_N

dernisáž_N	derniéra_N

vysokanánský_A	vysokánský_A

Pohár_N	pohár_N

šestiválec_N	válec_N

vyuhlit_V	uhlí_N

našlapovat_V	šlapat_V

redakce_N	redigovat_V

obroučka_N	obruč_N

exprezident_N	prezident_N

kroj_N	krájet_V

filharmonie_N	harmonie_N

mrňavý_A	mrně_N

oslnit_V	slunce_N

řezat_V	dřevořezba_NC

toulouský_A	Toulouse_N

hukot_N	houkat_V

jankovatět_V	Janek_None

Kafka_N	kavka_N

havíř_N	Havířov_N

břich_N	břichomluvec_N

broskvoň_N	broskev_N

Držkov_N	držka_N

sekeromlat_N	sekera_N

upozornit_V	pozor_N

chytrý_A	vychytralý_A

oktan_N	oktáva_N

Břevnov_N	břevno_N

pomekávat_V	mekat_V

kolohnát_N	kolo_N

opičárna_N	opice_N

zpovzdálí_D	opodál_D

podsvinče_N	svině_N

panička_N	paní_N

napotom_D	potom_D

přešlapovat_V	šlapat_V

starost_N	starat_V

chef_N	starý_A

špalíček_N	špalek_N

podhoubí_N	houba_N

zrní_N	zrno_N

jobovka_N	Job_None

prosťáček_N	prostý_A

kulovnice_N	kule_N

pouto_N	pnout_V

galvanovna_N	galvanický_A

brzičko_D	brzy_D

Habrůvka_N	habr_N

pyj_N	pysk_N

konkurence_N	konkurenceschopný_AC

dementi_N	demence_N

pachuť_N	chuť_N

nenadálý_A	znenadání_D

zpřísnit_V	přísný_A

Podřipsko_N	Říp_N

aróma_N	aromatický_A

zcela_D	celý_A

strojvůdce_N	stroj_N

zotavit_V	týt_V

venek_N	venku_D

sklípek_N	sklep_N

kulatý_A	koulet_V

soustrojí_N	stroj_N

pejsánek_N	pes_N

styk_N	stýkat_V

obětiště_N	obětovat_V

Blažek_N	Blažej_N

cukina_N	cuketa_N

průser_N	srát_V

velký_A	velikost_N

regiment_N	rychtář_N

jednovaječný_A	vejce_N

kapénka_N	kapka_N

námořní_A	moře_N

zanártní_A	nárt_N

sprosťárna_N	sprostý_A

moře_N	mořeplavkyně_N

sesun_N	sunout_V

výdech_N	dech_N

obětovat_V	oběť_N

Pátek_N	pátek_N

pečivárna_N	péct_V

schraňovat_V	schránka_N

nůžtičky_N	nůžky_N

vestoje_D	stojící_A

souzvuk_N	zvuk_N

hmota_N	homole_N

tlustý_A	tloušťka_N

sítnice_N	síť_N

cédéčko_N	dvojcédéčko_N

uran_N	Uran_None

nuzák_N	nouze_N

hrůza_N	hrozit_V

zapříčinit_V	příčina_N

Ambrozková_N	Ambrožová_N

univerzální_A	univerzitní_A

judo_N	džudo_N

administrativa_N	administrátor_N

Británie_N	Brit_N

násep_N	sypat_V

chřest_N	chroustat_V

anekumena_N	ekumena_N

exkláva_N	enkláva_N

příklep_N	překlep_N

Barma_N	Barmánec_N

pěší_N	pěšky_D

reedice_N	edice_N

smažit_V	smazat_V

Vřesovice_N	vřes_N

spočívat_V	odpočívat_V

podsudí_N	sudí_N

divotvůrce_N	div_N

Sladký_N	sladký_A

zástěra_N	zastřít_V

cache_A	geocaching_NC

prézentní_A	prezent_N

neustálý_A	stálý_A

Aga_N	Agáta_N

záhrobí_N	hrob_N

dokumentarista_N	dokumentární_A

zprava_D	pravý_A

břicho_N	břichomluvec_N

špehýrka_N	špehovat_V

Petronila_N	Petr_N

nádvoří_N	dvůr_N

ropušák_N	ropucha_N

pětikilo_N	kilo_N

Nohavica_N	nohavice_N

odklon_N	klonit_V

matematika_N	zmatematizovat_V

výlev_N	vylít_V

postrach_N	strach_N

náměstek_N	místo_N

pětidenní_A	pět_C

břit_N	břitva_N

veltruský_A	Veltrusy_None

Světluška_N	Světlana_N

Vojtěch_N	voj_N

Sibiř_N	sibiřský_A

zvuk_N	přízvuk_N

plynout_V	plyn_N

vdech_N	dech_N

mešní_A	mše_N

génius_N	geniální_A

bicista_N	bít_V

koldokola_D	dokola_D

taxon_N	taxonomie_NC

náměstí_N	město_N

drakonický_A	drak_N

podkroví_N	krov_N

bezdomovec_N	domov_N

kočkodan_N	kočka_N

výlučný_A	výluka_N

zelený_A	zeleň_N

amnestie_N	amnestovat_V

obnovit_V	nový_A

průdušnice_N	průduškový_A

Moldavsko_N	moldavský_A

černoprdeláč_N	černoprdelník_N

zletilý_A	léto_N

vyštvat_V	štvát_V

instituce_N	institucionální_A

křoví_N	keř_N

bezohledný_A	ohled_N

pojmosloví_N	pojem_N

úbočí_N	bok_N

tatér_N	tetovat_V

opočlověk_N	člověk_N

galánečka_N	gala_N

koncipient_N	koncept_N

vojtěška_N	Vojtěch_N

mošťovadlo_N	mošt_N

příští_A	napříště_D

doleva_D	levý_A

pře_N	přít_V

nanuk_N	nanukáč_N

schwarzenberský_A	Schwarzenberg_None

kolegáček_N	kolega_N

verbuňk_N	verbovat_V

výstřih_N	stříhat_V

desátek_N	desetinný_A

brusinka_N	brousit_V

Vyšehrad_N	vyšehradský_A

sněhule_N	sníh_N

bidélko_N	bidlo_N

lexikální_A	lexikologie_NC

optimální_A	optimalizovat_V

stádce_N	stádo_N

úhyn_N	hynout_V

pohotový_A	hotový_A

Děvín_N	děva_N

Iroameričan_N	Američan_N

ředit_V	řídký_A

včelmistr_N	včela_N

univerzita_N	univerzální_A

nehet_N	nehýtek_N

Mrázková_N	mráz_N

caudillo_N	caudillizmus_N

žerzej_N	Jersey_N

úsek_N	sekat_V

Souček_N	Suk_N

žebračenka_N	žebrat_V

vejce_N	vaječina_N

Zálabí_N	Labe_N

zakrojit_V	krájet_V

první_A	prvý_A

návětrný_A	větrný_A

kvantum_N	kvantitativní_A

Newyorčan_N	newyorský_AC

městys_N	město_N

Moravěnka_N	moravský_A

naostro_D	ostrý_A

kolomaz_N	kolo_N

palermský_A	Palermo_N

hebký_A	zhebnout_V

kráva_N	kravín_N

centralizovat_V	centrum_N

blešárna_N	blecha_N

okostice_N	kost_N

povýšit_V	vysoký_A

rytmus_N	zrytmizovat_V

potud_D	odtud_D

Hellas_N	helénský_A

Tom_N	Tomáš_N

Mikoláš_N	Mikuláš_N

břevno_N	Břevnov_N

dvoukolejný_A	jednokolejný_A

mrákota_N	mrak_N

Dubina_N	dub_N

smutno_D	smutek_N

podnadpis_N	nadpis_N

předvolba_N	volba_N

vnikat_V	vznikat_V

botulin_N	botulizmus_N

podezřelý_A	podezírat_V

vteřina_N	úterý_N

záprseň_N	prs_N

křivdit_V	křivit_V

měděný_A	měď_N

díl_N	oddíl_N

Jakš_N	Jakeš_N

Klatovsko_N	Klatovy_N

mizérie_N	mizerný_A

posvátný_A	svatý_A

týpek_N	typ_N

nabízet_V	nabídka_N

brýle_N	beryl_N

poutat_V	pouto_N

lýkožrout_N	lýko_N

průtah_N	tah_N

grenadýr_N	granát_N

máma_N	matka_N

aseptický_A	sepse_N

nešvar_N	švarný_A

libido_N	líbit_V

týkat_V	dotknout_V

bzučet_V	bzukot_N

vyčíslit_V	číslo_N

maskérna_N	maska_N

třeskutý_A	třesk_N

osnova_N	snovat_V

umístit_V	místo_N

příjmení_N	jméno_N

havel_N	Havel_N

Eurasie_N	Asie_N

znázornit_V	názor_N

škubánek_N	škubat_V

tolik_D	tak_None

papacha_N	papaláš_N

upozadit_V	pozadí_N

pětice_N	pět_C

úhrada_N	uhradit_V

business_N	byznysmen_N

náhončí_N	nahnat_V

azyl_N	azylant_N

správný_A	spravit_V

matěj_N	Matěj_N

maximalizovat_V	maximálně_D

povzdech_N	vzdech_N

hektometrovník_N	kilometrovník_N

praporečník_N	prapor_N

pohyblivý_A	pohybovat_V

pokání_N	kát_V

broskev_N	broskvoň_N

vaz_N	vázat_V

hluchoněmý_A	hluchý_A

zálusk_N	louskat_V

Virgiňan_N	Virginie_None

bělokorý_A	kůra_N

Kryštof_N	Kryštůfek_N

ježibaba_N	baba_N

žluna_N	žlutý_A

Valašsko_N	Valach_N

Středa_N	středa_N

žůžo_A	žůžový_A

choromyslný_A	choroba_N

komandýrovka_N	komandant_N

Květa_N	Květoslava_N

ruina_N	zruinovat_V

nesnáz_N	snad_None

letovisko_N	léto_N

octomilka_N	ocet_N

bohém_N	bohemistika_N

Vilemína_N	Vilém_N

lexém_N	lexikologie_NC

slavit_V	oslavenkyně_N

rozestlat_V	stlát_V

úděl_N	udělit_V

paryba_N	ryba_N

dolů_D	dolní_A

Hanýžka_N	Hana_N

přednožit_V	noha_N

odkal_N	kal_N

souchotiny_N	suchý_A

zpovzdáli_D	opodál_D

příšeří_N	příšera_N

Chile_N	Chilan_N

Blažíček_N	Blažej_N

zpyšnět_V	zpychnout_V

letos_D	léto_N

konipas_N	kůň_N

cappuccino_N	kapučíno_N

dozvuk_N	zvuk_N

Vsacko_N	vsacký_A

Dobřichov_N	Dobříš_N

Danuše_N	Dana_N

pohrdat_V	hrdý_A

vánice_N	vát_V

Pivrnec_N	Pivrncová_N

květovaný_A	květina_N

čtvrt_N	čtvrť_N

Jaruš_N	Jaroslav_N

sexus_N	sexy_A

granátomet_N	granát_N

flota_N	flotila_N

blivno_D	blít_V

čertě_N	čert_N

plato_N	plaťák_N

podgraf_N	graf_N

rozpačitý_A	rozpaky_N

můra_N	motýl_N

pámbíček_N	pánbůh_N

stračena_N	straka_N

suchar_N	suchý_A

klas_N	klát_V

píčovina_N	píča_N

firmware_N	software_N

zkřesťanit_V	křesťan_N

příkrasa_N	krása_N

dupačky_N	dupat_V

poválečný_A	válečný_A

centilitr_N	litr_N

dunit_N	dunění_N

prvoinstanční_A	instance_N

editovat_V	editorial_N

Francouz_N	Francie_N

výstřední_A	střed_N

Sommer_N	Somrová_N

župa_N	župan_N

Králíky_N	králík_N

Kopecký_N	kopec_N

lučebnina_N	lučba_N

krajinomalba_N	krajina_N

čnít_V	čnělka_N

Voršila_N	Uršula_N

historie_N	story_N

policie_N	policejní_A

paterý_A	pět_V

existencializmus_N	existovat_V

kachel_N	kakabus_N

vrubozobý_A	vrub_N

podkožní_A	kožní_A

děsit_V	žasnout_V

estét_N	estetický_A

Katka_N	Kateřina_N

křemík_N	křemen_N

zápatí_N	pata_N

matematizace_N	zmatematizovat_V

osminohý_A	noha_N

Vorlíčková_N	Vorlová_N

Frankfurt_N	Frankfort_N

vlna_N	vlnitý_A

zpřesnit_V	přesný_A

storuký_A	sto_C

lakota_N	lakomý_A

propylalkohol_N	alkohol_N

pejskař_N	pejsek_N

pečeť_N	pečetit_V

slonbidlo_N	bidlo_N

Mallorčan_N	Mallorca_None

rekondice_N	kondice_N

Marouš_N	Marius_N

záležitost_N	záležet_V

leháro_N	ležet_V

zout_V	obuv_N

Vratislav_N	vratislavský_A

kočkopes_N	kočka_N

francký_A	Franky_N

zadlouho_D	dlouho_D

ambasáda_N	ambasador_N

flanda_N	flanďák_N

Brzeg_N	břežský_A

Marseillanka_N	Marseille_N

Jagello_N	jagellonský_A

slina_N	slintat_V

okusit_V	zkusit_V

rotor_N	rotace_N

ovocnář_N	ovoce_N

revolta_N	revoluce_N

chumel_N	chumelenice_N

explikovat_V	explicitní_A

úžit_V	úzký_A

spermabanka_N	sperma_N

zábor_N	zabrat_V

Elena_N	Helena_N

hruď_N	hrudník_N

folio_N	fólie_N

prtě_N	prťák_N

vymycovat_V	vymýtit_V

spermobanka_N	sperma_N

misál_N	mše_N

kokain_N	koka_N

nahluchlý_A	hluchý_A

pokřesťanštit_V	křesťan_N

zdravý_A	zdravit_V

motolice_N	motýl_N

ugrofinistika_N	ugrofinský_A

mladistvý_A	mladý_A

pěvec_N	zpěv_N

pohrobek_N	hrob_N

fízl_N	profízlovaný_A

komunismus_N	komunizmus_N

kmitočet_N	kmitat_V

poduška_N	ucho_N

fosfát_N	fosfor_N

prvotisk_N	tisk_N

pohár_N	Pohár_N

šalamoun_N	Šalamoun_N

Kyril_N	Cyril_N

svrab_N	svrbět_V

podezření_N	podezírat_V

Pája_N	Pavel_N

skulina_N	skýtat_V

Alena_N	Alan_N

sazenice_N	sázet_V

Krakonoš_N	Krkonoše_N

předkládat_V	předloha_N

hektolitr_N	litr_N

podloubí_N	loubí_N

zdůraznit_V	důraz_N

saponát_N	saponin_N

bek_N	bekhend_N

šprcka_N	prcat_V

nenasytný_A	sytý_A

kapučíno_N	cappuccino_N

okap_N	kapat_V

Brněnsko_N	Brno_N

Maďar_N	maďarizace_N

posada_N	sadit_V

tatar_N	Tatar_N

kazaština_N	Kazachstán_N

inervovat_V	nerv_N

bourat_V	bouřit_V

dávnověk_N	věk_N

bájo_A	báječný_A

lokace_N	lokalita_N

paralympionik_N	paralympiáda_N

vymykat_V	mykat_V

Šedivý_N	šedivý_A

samaritán_N	Samaritán_N

odskok_N	skok_N

akce_N	reakce_N

Kostomlaty_N	kost_N

plachetka_N	plachta_N

plesnivý_A	plíseň_N

pětinohý_A	noha_N

akrobat_N	akrobacie_N

funkcionalismus_N	funkce_N

maska_N	maškarní_A

pomoří_N	moře_N

honební_A	hon_N

štukatér_N	štuk_N

výsun_N	sun_N

rozlet_N	let_N

Předjordánsko_N	Jordánsko_None

pochlebovat_V	chléb_N

býk_N	kráva_N

Vrchlabí_N	Labe_N

masopust_N	maso_N

střik_N	stříkat_V

finta_N	fingovat_V

zavirovat_V	virus_N

lněný_A	len_N

paroh_N	roh_N

park_N	parkoviště_N

hmyz_N	hemžit_V

zadarmo_D	darmo_None

strniště_N	trn_N

audit_N	auditor_N

dudák_N	dudy_N

sídlištní_A	sídliště_N

zřetel_N	zřít_V

Etiopie_N	etiopský_A

šipka_N	šíp_N

raketa_N	raketoplán_N

cukernatý_A	cukr_N

pododdělení_N	oddělení_N

Fanouš_N	František_N

výsost_N	vysoko_D

potrava_N	trávit_V

skot_N	Skotsko_N

privilegovat_V	privilegium_N

balotina_N	balotáž_N

láma_N	dalajláma_N

gangster_N	gang_N

dopink_N	dopovat_V

krasotinka_N	krása_N

hezký_A	hodit_V

chechot_N	chechtat_V

lombard_N	Lombardie_None

pohroma_N	pogrom_N

proradný_A	radit_V

plavit_V	plout_V

Alexandrie_N	alexandrinizmus_N

sečkat_V	čekat_V

podletí_N	letní_A

protetika_N	protéza_N

mrcha_N	zmršit_V

vepří_A	vepřín_N

ujařmit_V	jařmo_N

nutkat_V	nutit_V

Moskvič_N	Moskva_N

almuženka_N	almužna_N

měštka_N	měšťan_N

otěhotnět_V	těhule_N

existenciální_A	existencialismus_N

otazník_N	otázka_N

cukrkandl_N	cukr_N

manšestráky_N	manšestr_N

manganistan_N	mangan_N

podržtaška_N	taška_N

makáč_N	makat_V

Hercegovec_N	Hercegovina_N

chatrný_A	chátrat_V

norek_N	nořit_V

zálet_N	let_N

mlhavo_D	mlha_N

kiribatský_A	Kiribati_N

dveře_N	dvířka_N

sklít_V	sklo_N

pohromadě_D	hromada_N

pětikačka_N	kačka_N

chvíle_N	dochvilnost_N

symbiont_N	symbióza_N

dvířka_N	dveře_N

stydět_V	stud_N

čtvrtobrat_N	čtvrt_C

imperialismus_N	impérium_N

mim_N	pantomima_N

omítat_V	mést_V

racionální_A	zracionalizovat_V

očurávat_V	čurat_V

gentleman_N	džentlmenský_A

tříhrotý_A	hrot_N

mnohomanželný_A	manžel_N

přímluva_N	přímluvkyně_N

povětšině_D	většina_N

plameňák_N	plamen_N

váčkovitý_A	vačkový_A

vidět_V	vize_N

plácek_N	plac_N

úkradmo_D	kradmo_D

nečas_N	počasí_N

derniéra_N	dernisáž_N

pupen_N	pupek_N

zátop_N	zatopit_V

lecjak_D	leckdy_D

kompozice_N	komponenta_N

dumlat_V	dudlík_N

nadsadit_V	nadsázka_N

skartovat_V	skartovačka_N

přečistý_A	čistý_A

nazelenalý_A	zelený_A

podtřída_N	třída_N

kartón_N	karta_N

panáčkovat_V	panák_N

kamenář_N	kámen_N

cizokrajný_A	cizí_A

sulaweský_A	Sulawesi_N

výpas_N	pást_V

proaktivní_A	aktivní_A

kalhoty_N	kalhotky_N

Benátky_N	benátský_A

perlit_N	perla_N

Florenťan_N	Florencie_None

courat_V	courák_N

Mělničan_N	Mělník_None

deci_N	decák_N

ukrutný_A	krutý_A

bezešvý_A	šev_N

provazolezec_N	lezec_N

naznat_V	doznat_V

podtitul_N	titul_N

přechytrý_A	chytrý_A

Bohouš_N	Bohumír_N

zkřesťanštit_V	křesťan_N

kačer_N	kachna_N

letokruh_N	léto_N

Českolipsko_N	českolipský_AC

žebírko_N	žebro_N

posměváček_N	posměvač_N

krákat_V	kra_N

čírtě_N	čert_N

vrstva_N	vrstevnice_N

liščátko_N	liška_N

smáčknout_V	mačkat_V

mesiánský_A	mesiáš_N

štěrkopísek_N	písek_N

kloktat_V	klokočí_N

Kája_N	Karel_N

Karibik_N	karibský_A

třískat_V	třeskutě_D

ozonosféra_N	ozón_N

steh_N	přistehovat_V

výprask_N	vypráskat_V

učiliště_N	učit_V

bretoňský_A	Bretaň_N

toliko_D	netoliko_D

nesmysl_N	smysl_N

skalice_N	skála_N

subakutní_A	akutní_A

podplamatý_A	plamatý_A

zákal_N	kal_N

měch_N	měchuřinka_N

abatyše_N	opat_N

máknout_V	makat_V

dolar_N	tolar_N

zhruba_D	zhrubnout_V

lógr_N	lágr_N

jednohlavý_A	hlava_N

paranoik_N	paranoia_N

Luboš_N	Lubor_N

chuďas_N	chudý_N

krmit_V	krmelec_N

intubace_N	tuba_N

kopinatý_A	kopí_N

kotouč_N	kotoul_N

nedostižný_A	stihnout_V

tepenný_A	tepna_N

bezdětný_A	dítě_N

partitura_N	part_N

exšéfredaktor_N	šéfredaktor_NC

čiperný_A	čepýřit_V

zrno_N	zrní_N

včas_D	čas_N

kladélko_N	klást_V

pojízdný_A	jezdit_V

prodchnout_V	nadchnout_V

masox_N	maso_N

úterek_N	úterý_N

sáňkař_N	sáňky_N

Karolína_N	Karel_N

apendektomie_N	apendix_N

nést_V	přínos_N

třísměnný_A	směna_N

operand_N	operace_N

oplodí_N	plod_N

komín_N	kominík_N

celebeský_A	Celebes_N

Patricie_N	Patrik_N

devítiocasý_A	ocas_N

nebe_N	nebesa_N

Renáta_N	Renata_N

vybržďovat_V	brzda_N

leitmotiv_N	motiv_N

hruška_N	hrušeň_N

šikula_N	šikovný_A

Ondrášková_N	Ondřej_N

ochudit_V	chudý_A

kurevský_A	kurva_N

zacpat_V	cpát_V

taťka_N	táta_N

Újezdec_N	újezd_N

Evža_N	Evžen_N

dihydrát_N	hydrát_N

záhada_N	hádat_V

bazální_A	báze_N

ordinérní_A	ordinace_N

Čertovka_N	čert_N

Servác_N	Pankrác_N

nestranný_A	strana_N

hospodyně_N	hospodář_N

shareware_N	software_N

protlak_N	tlačit_V

zdravověda_N	věda_N

apendicitida_N	apendix_N

žitniště_N	žito_N

šizuňk_N	šidit_V

Vítkovec_N	Vítek_N

diftongizace_N	diftong_N

skrutinium_N	skrutátor_N

buržoa_N	buržoazie_N

pihovatý_A	piha_N

Poděbradsko_N	poděbradský_A

nepomucký_A	Nepomuk_N

Hnězdno_N	hnězdenský_A

Emanuel_N	Ema_N

nacpat_V	cpát_V

chýlit_V	náchylnost_N

obývat_V	být_V

handl_N	handlíř_N

dívat_V	div_N

uher_N	úhoř_N

vulkán_N	vulkanický_A

kořalenka_N	kořalka_N

kamarádšoft_N	kamarád_N

alpa_N	Alpy_N

exmistr_N	mistr_N

zdůli_D	důle_N

získat_V	zisk_N

Vydra_N	vydra_N

hrách_N	hrášek_N

posluchárna_N	poslouchat_V

Franta_N	František_N

postýlka_N	postel_N

procento_N	promile_N

praštit_V	prak_N

Vlastislav_N	vlast_N

sója_N	sojový_A

kníže_N	kněz_N

pech_N	pechfógl_N

šampaňský_A	Champagne_N

heydrichiáda_N	Heydrichův_A

důvtip_N	vtip_N

smolař_N	smůla_N

častuška_N	častý_A

dětičky_N	dítě_N

Radvanice_N	Radovan_N

hotel_N	hostel_N

peskovat_V	psota_N

Lukava_N	Lukavská_N

sirý_A	sirotek_N

přečin_N	čin_N

tadyhle_D	tady_D

klihovitý_A	kližka_N

cajk_N	vercajk_N

pozdit_V	pozdě_None

podnájemce_N	nájemný_A

nažloutlý_A	zažloutlý_A

Kulaťák_N	kulatý_A

kuropění_N	pění_N

zaspat_V	spát_V

pokusit_V	zkusit_V

kvadratický_A	kvadrát_N

leník_N	léno_N

knížectví_N	kníže_N

počest_N	čest_N

ložní_A	ležet_V

bezbožný_A	zbožný_A

pětiboj_N	pět_C

bezpříkladný_A	příklad_N

marodit_V	marod_A

rozvážný_A	vážit_V

Valášek_N	Valach_N

posed_N	sed_N

roztomilůstka_N	roztomilý_A

živák_N	živý_A

stehenní_A	stehno_N

žrec_N	zřít_V

exmanžel_N	manžel_N

Mikuš_N	Mikuláš_N

fanoušek_N	fanynka_N

korat_V	kůra_N

danit_V	daň_N

ohlávka_N	hlava_N

portýr_N	porta_N

Večeřa_N	večeře_N

Liberijec_N	Libérie_N

zkvalitnit_V	kvalita_N

vepsat_V	psát_V

překrucovat_V	překroutit_V

týdně_D	týden_N

poprsí_N	prs_N

průšvih_N	švihnout_V

kasírovat_V	kasa_N

louh_N	louže_N

podpaží_N	paže_N

domácí_A	dům_N

hélium_N	heliosféra_NC

Tibet_N	tibetský_A

jakkoliv_D	jak_N

tucha_N	tušit_V

funus_N	funebrák_N

kyborg_N	kybernetika_NC

pyrotechnička_N	pyrotechnika_NC

vykostit_V	kostička_N

vezdejší_A	zdejší_A

svorkovnice_N	svorka_N

rachejtle_N	raketa_N

obytný_A	bytný_N

jaterní_A	játra_N

Průša_N	Prus_N

Krkonoše_N	krk_N

štamprle_N	stoupa_N

amazonka_N	Amazonka_N

sylabus_N	sylaba_N

rentiér_N	renta_N

petrklíč_N	Petr_N

veveří_A	veverka_N

rozvodí_N	voda_N

Benátsko_N	Benátky_None

pokyn_N	kynout_V

obnášet_V	obnosit_V

Hajaja_N	hajat_V

uštvat_V	štvát_V

Bělohlav_N	Bělohlávek_N

kopec_N	kopcovitý_A

vyřídilka_N	vyřídit_V

bráhmana_N	bráhmanismus_N

dorota_N	Dorota_N

podprogram_N	program_N

jednospřeží_N	spřežení_N

algoritmizovat_V	algoritmus_N

motel_N	hotel_N

Lexa_N	Alexandr_N

čumět_V	očumovat_V

Slavičín_N	slavík_N

Zdenko_N	Zdeněk_N

rovnítko_N	rovnat_V

sítotisk_N	tisk_N

skupina_N	kupa_N

kus_N	zákusek_N

Jezeří_A	jezero_N

Doubrava_N	doubrava_N

třetihory_N	čtvrtohory_N

ukáznit_V	kázeň_N

Malý_N	malý_A

Jetřich_N	Dětřich_N

mumie_N	mumifikovat_VC

hřát_V	hořet_V

čůrat_V	čurák_N

mahárádža_N	rádža_N

vyžrat_V	žrát_V

Jihokorejec_N	Korejec_N

nerozum_N	rozum_N

výplod_N	plod_N

puťák_N	putovat_V

Anka_N	Anna_N

osmičelý_A	osmium_N

Oktavián_N	Oktávie_N

Zdenda_N	Zdeněk_N

udeřit_V	úder_N

motýlokvětý_A	motýl_N

strom_N	strmět_V

hlína_N	hliník_N

vrtošivý_A	vrtoch_N

třínohý_A	noha_N

Liboslav_N	Libuše_N

chlív_N	chlév_N

Eden_N	eden_N

dvanáctiválec_N	válec_N

velimský_A	Velim_N

čenstochovský_A	Čenstochová_N

imunosuprese_N	imunosupresivum_NC

litomyšlský_A	Litomyšl_N

bezesný_A	sen_N

učební_A	učit_V

vystlat_V	stlát_V

vzájemný_A	navzájem_D

zkumavka_N	zkoumat_V

pašerák_N	pašovat_V

Vinohrady_N	vinohrad_NC

podčlověk_N	člověk_N

předčíslí_N	číslo_N

lusk_N	louskat_V

kademnatý_A	kadmium_N

Lom_N	lom_N

plovárna_N	plavat_V

melanéský_A	Melanésie_N

váznout_V	vězet_V

měsíčky_N	měsíc_N

role_N	rolník_N

napřesrok_D	rok_N

zádrhel_N	zadrhnout_V

ližina_N	líha_N

ufon_N	ufoun_N

echolokátor_N	echo_N

drhnout_V	zdrhnout_V

nákolenka_N	koleno_N

stárkyně_N	starý_A

sežvýkat_V	žvýkat_V

panamský_A	Panama_N

naznak_D	znak_N

vbodat_V	bodat_V

jednooký_A	oko_N

aprobace_N	prubíř_N

penýsek_N	penis_N

šťastlivý_A	štěstí_N

market_N	hypermarket_NC

velín_N	velet_V

Kozák_N	kozák_N

navrch_D	vrchol_N

Mára_N	Marius_N

Klínovec_N	klín_N

strčit_V	trčet_V

dvanáctihlavý_A	hlava_N

Střelák_N	střílet_V

meruňka_N	meruna_N

coververze_N	verze_N

siřičitý_A	síra_N

Jedov_N	jedový_A

tukuprostý_A	tuk_N

Dobřív_N	Dobříš_N

harfeník_N	harfa_N

Bologna_N	boloňský_A

Šeda_N	šedý_A

Sibyla_N	sibylský_A

přátelit_V	přítel_N

bezprostřední_A	prostřednictví_N

decák_N	deci_N

kádinka_N	káď_N

kalkulačka_N	kalkulátor_N

kamioňák_N	kamión_N

boule_N	bulka_N

modřín_N	modrý_A

Bedřich_N	Bedřiška_N

málo_D	malý_A

Růžena_N	růže_N

ironie_N	zironizovat_V

rozhlas_N	hlas_N

pohříchu_D	hřích_N

pleteň_N	plést_V

topinka_N	toust_N

ranní_A	ráno_N

nemocenské_N	nemoc_N

kluziště_N	klouzat_V

Zbavitel_N	zbavit_V

myslet_V	mysl_N

panožka_N	noha_N

zesamostatnit_V	samostatný_AC

zavíjet_V	vít_V

obnažit_V	nahý_A

tlapa_N	lopata_N

písemnictví_N	psát_V

neckyáda_N	necky_N

majáles_N	máj_N

překop_N	kopat_V

brdo_N	brdečko_N

původ_N	původkyně_N

předzpěv_N	zpěv_N

Gróňan_N	Grónsko_None

zapažit_V	paže_N

modř_N	modrý_A

Plíva_N	plíva_N

achilovka_N	Achilles_N

spět_V	pět_V

skrojit_V	krájet_V

finance_N	financování_N

kyv_N	kývat_V

urea_N	urinace_N

napotřetí_D	napoprvé_D

jarmarečník_N	jarmark_N

rýžoviště_N	rýže_N

psychika_N	psychóza_N

systém_N	systematický_A

Petrohrad_N	Petr_N

Liv_N	Livonsko_N

Bureš_N	Babiš_N

stvůra_N	tvořit_V

stůl_N	stolička_N

dožrat_V	žrát_V

naskrz_D	skrz_R

Alžír_N	Alžířan_N

Cařihrad_N	car_N

čpavek_N	čpět_V

poslovanštit_V	Slovan_N

Liboslava_N	Libuše_N

entusiasmus_N	entuziasmus_N

povrch_N	vrch_N

schrána_N	chráněný_A

smečka_N	smyčka_N

pnout_V	píď_N

nářečí_N	říct_V

dosud_D	dosavadní_A

diák_N	diapozitiv_NC

meduňka_N	med_N

mrskat_V	mrštit_V

očař_N	oko_N

polosladký_D	sladký_A

polom_N	lom_N

loutka_N	loutkařit_V

výročí_N	rok_N

zužitkovat_V	užitek_N

nadlehčit_V	lehký_A

ves_N	víska_N

síto_N	síť_N

primáš_N	prim_N

upřesnit_V	přesný_A

ozonizace_N	ozón_N

adoptovat_V	adopce_N

absolutno_N	absolutní_A

Kytka_N	Markéta_N

rozbíhat_V	běhat_V

proutkař_N	prut_N

patriarchální_A	patriarcha_NC

pětiseťák_N	set_N

fiflena_N	Fifinka_N

naboso_D	bosý_A

leninský_A	Lenin_N

zvětšovák_N	zvětšit_V

zatrávnit_V	trávník_N

jasnovidec_N	jasný_A

vulgární_A	vulgarismus_N

vzorkovník_N	vzorník_N

hnedle_D	hned_D

nadváha_N	váha_N

nožíř_N	nůž_N

nahnědlý_A	hnědý_A

důsledek_N	sled_N

zbrojit_V	brojit_V

Povolží_N	Volha_N

hádat_V	odhad_N

odluka_N	odlučné_N

fracek_N	fraška_N

laureát_N	bakalář_N

zohyžďovat_V	zohyzdění_N

úlek_N	polekat_V

majstr_N	majstrštyk_N

dietetika_N	dieta_N

urbanizovat_V	Urban_N

přepsat_V	psát_V

hrabivý_A	hrabat_V

palebný_A	pálit_V

odbočit_V	bok_N

Hřebeny_N	hřeben_N

obléhat_V	ležet_V

expertiza_N	expert_N

Nataša_N	Natálie_N

sestrovrah_N	vrah_N

penězovod_N	peníz_N

pozemek_N	pozemský_AC

pustošit_V	spoušť_N

prostoj_N	postoj_N

nadmnožina_N	množina_N

přesmoc_D	přes_R

taras_N	zatarasit_V

důra_N	Dorota_N

kmitoměr_N	kmitat_V

šok_N	šokující_A

ropušník_N	ropucha_N

svině_N	sviňák_N

podhlavník_N	hlava_N

vratiplachta_N	plachta_N

smraďoch_N	smrad_N

direktor_N	rychtář_N

zlehčit_V	lehký_A

postel_N	stlát_V

náustek_N	ústa_N

zájmeno_N	jméno_N

Brandenburk_N	brandenburský_A

pytlovitý_A	pytel_N

webový_A	web_N

Gót_N	gotický_A

oranžáda_N	oranžový_A

špetka_N	štěpka_N

demonetizace_N	démonizovat_V

Kakáč_N	kakat_V

medijní_A	mediální_A

ožralství_N	ožralý_A

Zdeno_N	Zdeněk_N

bardáma_N	dáma_N

kurýr_N	kurs_N

topinkovač_N	topinka_N

předestřít_V	předstírat_V

ukájet_V	kojit_V

předvečer_N	večer_N

hnědel_N	hnědý_A

slunovrat_N	slunce_N

pětinedělní_A	pět_C

soutisk_N	tisk_N

dovnitř_D	uvnitř_D

Panama_N	panamský_A

kapánek_D	kapka_N

Germán_N	zgermanizovat_V

vojančina_N	voják_N

píle_N	pilně_D

šum_N	šumět_V

jižan_N	jih_N

admirál_N	viceadmirálka_N

relaxovat_V	laxní_A

žluč_N	žlutý_A

zelovka_N	zelí_N

Florencie_N	florentský_A

nitro_N	uvnitř_None

vkládat_V	klást_V

Střelice_N	střílet_V

jančit_V	Janek_None

Angloameričan_N	Američan_N

plavovlasý_A	plavý_A

hrom_N	hřmět_V

Bělehrad_N	hrad_N

hrabství_N	hrabě_N

Chám_N	chám_N

Ekvádor_N	ekvádorský_A

sprostý_A	prostý_A

paklíč_N	klíč_N

bagatela_N	pakatel_N

Rosice_N	Rosický_N

tyranida_N	tyran_N

šedověk_N	věk_N

nadživotní_A	životní_A

Judita_N	Jitka_N

úkol_N	klát_V

rusalka_N	rusý_A

nákupčí_N	nákup_N

uvíznout_V	vězet_V

upřímný_A	přímý_A

rizoto_N	rýže_N

překlep_N	klepat_V

bohumilý_A	bůh_N

nekřesťan_N	křesťan_N

rozruch_N	ruch_N

planetoid_N	planeta_N

Říp_N	Podřipsko_N

výjimka_N	vyjmout_V

čtrnáctidenní_A	denní_A

pohostinský_A	pohoštění_N

naráz_D	razit_V

mělký_A	mělce_D

absorpce_N	absorbovat_V

hrdlička_N	hrdlo_N

letopočet_N	léto_N

chlorid_N	chlór_N

dramaturgie_N	dramatik_N

komorník_N	komora_N

abilympiáda_N	olympiáda_N

papír_N	hajzlpapír_N

žůžový_A	žůžo_A

Čihák_N	číhat_V

miserere_V	mizerný_A

revmatoidní_A	revmatismus_N

bezpochyby_D	pochyba_N

pětadvacetník_N	pětadvacítka_N

vzít_V	jímat_V

berní_A	berně_N

nálev_N	nalít_V

promenáda_N	promenoár_N

uchvátit_V	chvat_N

plátěný_A	plátno_N

prémie_N	primát_N

odznak_N	znak_N

asketik_N	asketismus_N

hotelnictví_N	hotel_N

Polabí_N	Labe_N

korumpovat_V	korupce_N

Plzeňák_N	Plzeň_None

maser_N	laser_N

čtvrtlán_N	lán_N

mazel_N	mazlit_V

Týn_N	týn_N

zavrženíhodný_A	hodný_A

zádušný_A	záducha_N

Lhota_N	lhůta_N

obout_V	obuv_N

Jablunka_N	jablko_N

mazat_V	majznout_V

chorý_A	choroboplodný_A

binovačka_N	šlehačka_N

dvousměnný_A	směna_N

schematický_A	schéma_N

klečmo_D	klečet_V

vedoucí_N	vedení_N

maturita_N	maturovat_V

lest_N	bezelstný_A

podběrák_N	sběračka_N

bus_N	omnibus_N

zestátnit_V	stát_N

gala_N	galantní_A

mudžáhid_N	džihád_N

hydratovat_V	hydrát_N

úd_N	dít_V

dvoudenní_A	denní_A

olomoucin_N	Olomouc_None

ozonizátor_N	ozón_N

Oravan_N	oravský_A

sporý_A	spořit_V

leckdy_D	lecjak_D

předvaha_N	váha_N

babybox_N	box_N

bezedný_A	dno_N

štědrovnice_N	štědrý_A

zážeh_N	žeh_N

žebřina_N	žebřík_N

náprstek_N	prst_N

externí_A	exteriér_N

chlebař_N	chléb_N

vrub_N	roubit_V

uršulinský_A	Uršula_N

vřídek_N	vřed_N

mudrc_N	moudrý_A

pokovit_V	kov_N

prasečit_V	prase_N

lež_N	lhát_V

zástěna_N	stěna_N

stopnout_V	stopky_N

etanal_N	etan_N

omáčka_N	máčet_V

islám_N	islamista_N

frýdecký_A	Frýdek_N

pyl_N	opylovač_N

měšťák_N	město_N

zalétat_V	letět_V

lobbizmus_N	lobby_N

pianissimo_N	piano_N

laločnatý_A	lalok_N

pospolu_D	spolu_D

svítek_N	vít_V

jehelní_A	jehla_N

orchestrion_N	orchestr_N

nejistota_N	jistý_A

Vacek_N	Václav_N

seskvioxid_N	oxid_N

advekce_N	konvekce_N

ráčit_V	říct_V

jogín_N	jóga_N

parfumerie_N	parfém_N

krvavý_A	krev_N

pocestný_N	cesta_N

sestřenec_N	sestra_N

předvánoční_A	adventní_A

zmrd_N	mrdat_V

kaňour_N	kanit_V

láteřit_V	látro_N

rozjasnit_V	jasně_D

radovat_V	radost_N

vztek_N	vztekloun_N

náhrobní_A	hrob_N

ebola_N	Ebola_N

ostroh_N	strohý_A

příchozí_A	přijít_V

scanovat_V	sken_N

kněz_N	velekněz_NC

nadčlověk_N	člověk_N

přemostit_V	most_N

kůžař_N	kůže_N

bolet_V	bolestný_A

náslech_N	slech_N

přát_V	přejícnost_N

okop_N	kopat_V

zrnkovatý_A	zrnko_N

krátký_A	zkratka_N

svodidlo_N	svést_V

poletucha_N	letucha_N

vesmír_N	všehomír_NC

zastlat_V	stlát_V

Atlantův_A	Atlas_N

kurativa_N	kúra_N

neteř_N	synovec_N

seznat_V	doznat_V

Liběna_N	libý_A

Foltýn_N	Faltýnek_N

bohatýr_N	bohatý_A

záraz_N	razit_V

křísit_V	křest_N

komsomolec_N	Komsomol_N

jmenovat_V	jméno_N

Filípková_N	Filipová_N

snídáníčko_N	snídaně_N

předpažit_V	paže_N

berylium_N	beryl_N

stárka_N	starý_A

presenilní_A	senilní_A

výkyv_N	kývat_V

speciál_N	specialista_N

vkleče_D	klečet_V

kolo_N	soukolí_N

válenda_N	válet_V

byznys_N	byznysmen_N

Schein_N	Scheinpflugová_N

alpinka_N	alpinský_A

Adámek_N	Adam_N

lahváč_N	láhev_N

subdodávka_N	dodávka_N

nádraží_N	dráha_N

lobby_N	lobbovat_V

podúředník_N	úředník_N

bulvarizovat_V	bulvár_N

paranoidní_A	paranoia_N

nástavba_N	stavba_N

připravit_V	příprava_N

prdelolezec_N	prdel_N

Kasal_N	kasat_V

mladý_A	mládežnický_A

smola_N	sesmolit_V

plamen_N	planout_V

křídlo_N	okřídlený_A

rak_N	Rak_N

mobil_N	mobilizace_N

odveta_N	odvětit_V

hláskosloví_N	hlas_N

rytmizace_N	zrytmizovat_V

kulobrok_N	kule_N

věkoucí_A	věk_N

obsažný_A	obsahovat_V

fólie_N	folio_N

baptisterium_N	baptismus_N

součást_N	část_N

žluťounký_A	žlutý_A

pracka_N	práce_N

žaloba_N	žalovat_V

péče_N	pečovatelství_N

bezvýjimečný_A	výjimečný_A

zavčas_D	včas_D

šustit_V	šusťák_N

patvar_N	tvar_N

povodeň_N	voda_N

surový_A	syrový_A

podšívka_N	podšitý_A

výuka_N	vyučit_V

kaňka_N	kanit_V

zocelit_V	ocel_N

Lazar_N	lazaret_N

zatravnit_V	tráva_N

povíc_D	vícero_N

význačný_A	značný_A

Tlustý_N	tlustý_A

vylhat_V	lhát_V

chlorečnan_N	chlór_N

záhlubník_N	zahloubení_N

vercajk_N	cajk_N

zteč_N	ztékat_V

půlden_N	poledne_N

patriarchát_N	patriarcha_NC

letohrad_N	léto_N

uzlina_N	uzel_N

konzervativec_N	konzervativní_A

Chalabala_N	halabala_D

bengál_N	Bengálsko_N

podbízet_V	nabízet_V

vepsí_D	psí_N

niterný_A	nitro_N

nastolit_V	stůl_N

znechutit_V	chuť_N

Adamus_N	Adam_N

dopravář_N	dopravit_V

úchop_N	uchopit_V

měkota_N	měkký_A

pometlo_N	pomást_V

Lubek_N	Lubor_N

femininum_N	feminismus_N

světlý_A	svítit_V

len_N	lněný_A

kladka_N	kláda_N

kraťas_N	krátký_A

Sarajevan_N	Sarajevo_N

piják_N	pít_V

nadhlavník_N	hlava_N

bordelmamá_N	bordel_N

gubernium_N	gubernátor_N

zalhat_V	lhát_V

Vojtek_N	Vojtěch_N

Mario_N	Marius_N

bokorys_N	rys_N

bránit_V	obranný_A

domina_N	domino_N

pijavý_A	pít_V

huňatý_A	houně_N

ohbí_N	ohebnost_N

termín_N	terminál_N

přísedící_N	sedící_A

bezbolestný_A	bolest_N

předtucha_N	tušit_V

perverzní_A	verze_N

kůzle_N	koza_N

mrzout_N	mrzet_V

svědek_N	přesvědčit_V

kupříkladu_D	příklad_N

Fin_N	Finův_A

radiace_N	rádium_N

Bárta_N	Bartoloměj_N

vydra_N	voda_N

spínat_V	pnout_V

dekoratér_N	dekorativní_A

sval_N	valit_V

stinný_A	stín_N

vlevo_D	levý_A

tvarožník_N	tvaroh_N

auditorium_N	audience_N

Punkva_N	koniklec_N

trnkobraní_N	brát_V

uspávanka_N	spát_V

motovidlo_N	vidle_N

Adolfina_N	Adolf_N

gajdoš_N	gajdy_N

cukrobaron_N	cukr_N

bezpečí_N	zabezpečení_N

Královec_N	král_N

pankáč_N	punk_N

fakt_N	faktum_N

bezplatný_A	platit_V

Užhorod_N	Uh_N

osmifinále_N	finále_N

nadledvina_N	ledvina_N

kálet_V	kal_N

chlév_N	chlív_N

moudrý_A	mudrc_N

pečivo_N	péct_V

burza_N	burzovní_A

Havířov_N	havíř_N

úpatí_N	pata_N

skalisko_N	skála_N

Brunšvik_N	Brunšvicko_N

navýšit_V	vysoký_A

kanafas_N	kanava_N

filipojakubský_A	Filip_N

okounět_V	oko_N

odškodnit_V	škoda_N

zdobit_V	doba_N

příslib_N	slíbit_V

mokrý_A	mok_N

zticha_D	ticho_N

žíně_N	žinčice_N

říci_V	řeč_N

zával_N	zavalit_V

nakolik_D	natolik_D

depka_N	deptat_V

kudy_D	tudy_D

kolibří_A	kolibřík_N

havěť_N	ohavný_A

tombak_N	tumpachový_A

formalín_N	formaldehyd_N

prosvětlit_V	světlo_N

proletarizace_N	zproletarizovat_V

Gotha_N	gothajský_A

nadlesní_N	les_N

spřežení_N	zapřažený_A

konstantinopolský_A	metropole_N

hromovat_V	hřmět_V

nakrojit_V	krájet_V

sedat_V	sedět_V

zákrok_N	krok_N

bezdůvodný_A	důvod_N

klučisko_N	kluk_N

uštědřit_V	štědrý_A

poklop_N	klopit_V

balotáž_N	balotina_N

Kryštůfek_N	Kryštof_N

dudat_V	dudy_N

kadidelnice_N	kadidlo_N

mít_V	majetný_A

lornět_N	lorňon_N

mozkomíšní_A	mozek_N

arianismus_N	ariánský_A

saně_N	sáňkařka_N

bezstarostný_A	starost_N

apriorní_A	apriorizmus_N

mořeplavec_N	moře_N

Spořilov_N	spořit_V

odtah_N	tah_N

vhled_N	vzhled_N

Hus_N	husita_N

poklep_N	překlep_N

nátělník_N	tělo_N

odstranit_V	strana_N

spekulativní_A	spekulovat_V

seběhnout_V	běžet_V

napopáté_D	napoprvé_D

zední_A	zeď_N

diecéze_N	arcidiecéze_NC

školomet_N	škola_N

porybný_A	ryba_N

hájovna_N	hájit_V

nezdvořák_N	nezdvořilý_A

podkritický_A	kritický_A

příznivý_A	přízeň_N

instalatér_N	instalovat_V

podatelna_N	podat_V

oranž_N	oranžáda_N

opat_N	abatyše_N

prča_N	prdel_N

budoucně_D	budoucí_A

změť_N	mást_V

bazilišek_N	Vasil_N

tlachat_V	potlach_N

znevýhodnit_V	výhoda_N

kartaginský_A	Kartágo_N

upřít_V	přít_V

podtext_N	text_N

kurátor_N	kúra_N

záběh_N	běh_N

vízum_N	vize_N

hořet_V	horký_A

mozkovna_N	mozek_N

přístroj_N	stroj_N

jehelník_N	jehla_N

Lučan_N	lucký_A

spřež_N	spřahat_V

plačící_A	plačka_N

kravař_N	kráva_N

sedmihlavý_A	hlava_N

nanteský_A	Nantes_N

mání_N	mít_V

zajda_N	zajíc_N

almaatský_A	Alma-Ata_N

literární_A	literatura_N

zvěř_N	zvíře_N

draselný_A	draslík_N

mrť_N	mřít_V

trojánský_A	Trója_None

verbum_N	verva_N

řásnit_V	řasit_V

smrtonosný_A	smrt_N

hoďka_N	hodina_N

Hitler_N	hitlerčík_N

srub_N	roubit_V

řeřavý_A	hořet_V

písčina_N	písek_N

kašlat_V	kašel_N

drsnokřídlec_N	drsný_A

dovča_N	dovolená_N

nádavek_N	nadávka_N

Čenstochová_N	čenstochovský_A

úskok_N	skok_N

Tomek_N	Tomáš_N

akcept_N	akceptovatelný_A

obouvidový_A	vid_N

řetízek_N	řetěz_N

diškrece_N	diskrétní_A

patisk_N	tisk_N

datle_N	datlovník_N

odmykat_V	mykat_V

kredenc_N	kredencká_N

starostenský_A	starosta_N

propříště_D	příští_A

Manila_N	manilský_A

čapí_A	čáp_N

napadrť_D	padrť_N

noha_N	nohavice_N

Wales_N	velšský_A

eskadra_N	flotila_N

pajasan_N	jasan_N

ozvuk_N	zvuk_N

píce_N	pícnina_N

nepodnikatel_N	podnikatel_N

přízvuk_N	zvuk_N

Dalmácie_N	dalmatský_A

kormoutit_V	rmoutit_V

farmaceut_N	farmacie_N

smrtelný_A	smrt_N

emitent_N	emise_N

zvolnit_V	volný_A

hospitalizovat_V	špitál_N

občerstvit_V	čerstvý_A

jednotýdenní_A	týden_N

oficiální_A	zoficializovat_V

eferentní_A	elativ_N

žluva_N	žlutý_A

švejkovat_V	Švejk_N

rytmika_N	rytmus_N

Džibuti_N	Džibutsko_N

krutihlav_N	krutý_A

míle_N	milník_N

novic_N	noviciát_N

ohm_N	ohmmetr_NC

stupnice_N	stupeň_N

rabiát_N	raubíř_N

nástropní_A	strop_N

pláštěnec_N	plášť_N

šálek_N	podšálek_N

sypek_N	vysypat_V

vycpat_V	cpát_V

kotangens_N	tangens_N

píseň_N	zpívat_V

souboj_N	boj_N

kuba_N	Jakub_N

kámoš_N	kamarád_N

chlebodárný_A	chlebodárce_N

státnička_N	státní_A

Svátek_N	svátek_N

roznožit_V	noha_N

Irkutsk_N	irkutský_A

aristotelizmus_N	Aristoteles_N

štědrovka_N	štědrý_A

popeleční_A	popel_N

kuplet_N	kuplíř_N

mlátit_V	mlat_N

Ebola_N	ebola_N

zábal_N	zabalený_A

Karlín_N	Karel_N

bezpartijní_A	partaj_N

etymologizovat_V	etymologie_NC

statut_N	status_N

Modra_N	modrý_A

vykuk_N	koukat_V

cvokatět_V	cvok_N

sávský_A	Sáva_N

tepláčky_N	tepláky_N

hmoždíř_N	hmoždit_V

novum_N	nový_A

hem_N	hemoglobin_N

kukaččí_A	kukačka_N

skriptorium_N	skripta_N

rozhrada_N	hrad_N

vhánět_V	honit_V

klenout_V	klepat_V

svoboda_N	osvobodit_V

hrachoviště_N	hrách_N

Babylóňan_N	Babylónie_N

zcvoknout_V	cvok_N

vynachválit_V	chválit_V

Sázavan_N	Sázava_None

osvěžit_V	svěží_A

jubilant_N	jubilejní_A

realita_N	reálný_A

černopláštník_N	plášť_N

marsovský_A	Mars_None

bezobratlý_A	obratlovec_N

obestřít_V	prostřít_V

zázemí_N	země_N

přelétat_V	letět_V

plemeno_N	plemeník_N

odpovědní_A	odpovídat_V

kruh_N	kružítko_N

debil_N	imbecil_N

kapradí_N	kapraď_N

udit_V	vadnout_V

povětroň_N	vítr_N

bytelný_A	být_V

nažrat_V	žrát_V

Machač_N	Macháček_N

výpis_N	psát_V

Světlana_N	světlo_N

bezduchý_A	duše_N

ocílka_N	ocel_N

alegorizace_N	alegorie_N

postit_V	půst_N

upsat_V	psát_V

spousta_N	spustit_V

galvanizovna_N	galvanický_A

umetat_V	mést_V

větvit_V	větev_N

ukrajovat_V	ukrojit_V

nadpažbí_N	pažba_N

Zlata_N	zlato_N

půlkilo_N	kilo_N

okoličnatý_A	okolík_N

amerikanistika_N	amerikanizmus_N

mezek_N	mula_N

lichtenštejnský_A	Lichtenštejnsko_N

bezdětek_N	dítě_N

dvoujazyčný_A	jazyk_N

denotace_N	denotát_N

faerský_A	faerština_N

orlíče_N	orel_N

Alexa_N	Alexandra_N

vertikála_N	vertikální_A

připažit_V	paže_N

dipól_N	pól_N

dvoják_N	dvojka_N

šplouchat_V	spláchnout_V

dýchánek_N	dýchání_N

bělit_V	bílý_A

dohněda_D	hnědý_A

styren_N	polystyren_NC

věsit_V	viset_V

snídaňový_A	snídaně_N

ovar_N	vařit_V

laxativum_N	laxní_A

přetlak_N	tlak_N

skřítek_N	skřet_N

lihovar_N	líh_N

hoňka_N	honit_V

spřežka_N	spřahování_N

prajský_A	Prajzsko_N

forma_N	reforma_N

výstřel_N	střílet_V

slivoň_N	slíva_N

Mráček_N	mráček_N

břichomluvec_N	břicho_N

Luděk_N	Ludvík_N

jizlivý_A	jízlivost_N

psychóza_N	psychický_A

příslovečný_A	příslovce_N

kult_N	kultura_N

pekáč_N	péct_V

slušný_A	slušet_V

Bělohlavý_N	Bělohlávek_N

ledovatý_A	led_N

duše_N	duch_N

rabi_N	rabínský_A

dlanička_N	dlaň_N

soudržný_A	držet_V

jupiterský_A	Jupiter_N

trpělivý_A	trpět_V

zlatistý_A	zlatý_N

podebrat_V	brát_V

šavle_N	šavlozubý_A

mázdra_N	mázdřivka_N

kralevic_N	král_N

haur_N	havíř_N

nárys_N	rys_N

kodér_N	kód_N

obrat_V	brát_V

bergenský_A	Bergen_N

Narcis_N	narcis_N

duchovný_A	duch_N

kolona_N	kolonizovat_V

Neděla_N	neděle_N

Kristián_N	Křišťan_N

exteriér_N	externí_A

tarasnice_N	zatarasit_V

kořalník_N	kořalka_N

popadat_V	padat_V

zhltnout_V	hlt_N

Havlíčková_N	Havel_N

tržnice_N	trh_N

choulostivý_A	choulit_V

kostkovaný_A	kostka_N

sírovodík_N	síra_N

napravo_D	pravý_A

Malta_N	maltský_A

poetizace_N	zpoetizovat_V

zcizit_V	cizí_A

spánek_N	spát_V

vodouch_N	voda_N

strnad_N	vystrnadit_V

stalinista_N	Stalin_N

loňský_A	vloni_D

pěnobeton_N	beton_N

trs_N	trsátko_N

kostrč_N	kostrbatý_A

rozvodnit_V	voda_N

pára_N	pařit_V

vzrůst_N	růst_N

fukar_N	foukat_V

flek_N	cucflek_N

vtok_N	průtok_N

soukmenovec_N	kmen_N

avitaminóza_N	vitamín_N

zdolat_V	odolat_V

meteorický_A	meteor_N

glykémie_N	glukóza_N

vabank_N	bank_N

nalehko_D	lehko_None

náústek_N	ústa_N

žehlit_V	žhnout_V

vetchozraký_A	zrak_N

cholerik_N	cholera_N

klokotat_V	klokočí_N

čarový_A	čára_N

pěchovat_V	pěšky_D

půlkruh_N	kruh_N

usměrnit_V	směr_N

zesirupovatět_V	sirup_N

okupovat_V	pookupační_A

pozpátku_D	zpět_D

kapitanát_N	kapitán_N

skrznaskrz_D	skrz_R

přebor_N	brát_V

bezvětří_N	vítr_N

pablesk_N	blesk_N

lunapark_N	park_N

rozhořčit_V	hořký_A

unožit_V	noha_N

domnělý_A	domněnka_N

vilnit_V	vilný_A

bohorovný_A	bůh_N

Perseidy_N	Perseus_N

tvaroh_N	tvar_N

tepénka_N	tepna_N

vlajkonoš_N	vlajka_N

gang_N	gangster_N

tlučhuba_N	huba_N

kation_N	ion_N

koncentrák_N	koncentráčník_N

Kostěj_N	kost_N

oněmět_V	němý_A

seprat_V	prát_V

reflektor_N	reflexe_N

obehnat_V	hnát_V

kradí_D	kradmo_D

Rakovník_N	rak_N

lokýtek_N	loket_N

pitoma_N	pitomec_N

Don_N	donský_A

mongoloidní_A	mongol_N

tkáň_N	tkát_V

Florenčan_N	Florencie_None

heligón_N	heligonka_N

provázek_N	provaz_N

beatbox_N	box_N

zlidovět_V	lid_N

šikmina_N	šikmý_A

vlastňák_N	vlastní_A

oficína_N	oficiálně_D

senáž_N	seno_N

hořejší_A	pohoří_N

Perseus_N	Perseidy_N

Julie_N	Julius_N

Kužel_N	kužel_N

vulkanický_A	vulkán_N

nákres_N	kreslit_V

hraboš_N	hrabat_V

odúmrť_N	úmrtí_N

černava_N	černý_A

ponětí_N	odnětí_N

zaječice_N	zajíc_N

erotično_N	erotika_N

oslabit_V	slabý_A

výluka_N	vyloučit_V

diskrece_N	diskrétní_A

frňous_N	frňák_N

Managua_N	managujský_A

hnida_N	hnidopich_N

záhumenek_N	humno_N

dvouhrbý_A	hrb_N

raníčko_N	ráno_N

úder_N	udeřit_V

filosofovat_V	filosofický_A

pětistý_A	pět_C

nepřítel_N	nepřátelství_N

Vašík_N	Václav_N

slavík_N	sláva_N

zákys_N	kyselý_A

člověkohodina_N	hodina_N

vězet_V	uvěznit_V

šmírák_N	šmírovat_V

Vnuk_N	vnuk_N

dokola_D	kolo_N

odstín_N	stín_N

dofoukat_V	foukat_V

tulit_V	přítulný_A

závozník_N	zavézt_V

Slaný_N	Slánsko_N

bezděčný_A	bezděky_D

sekera_N	sekat_V

šejchát_N	šejk_N

vyfukovat_V	výfuk_N

naturismus_N	naturel_N

klavichord_N	klavír_N

kornatý_A	kůra_N

podbřišek_N	břicho_N

všudypřítomný_A	všude_D

vždyzelený_A	vždy_D

dešťoměr_N	déšť_N

elektrika_N	elektrárna_N

zlatoústý_A	zlatý_N

kachna_N	kačena_N

nacionalismus_N	nácek_N

zapřažení_N	zapřažený_A

tloušťka_N	tlustý_A

doubí_N	dub_N

pozér_N	póza_N

vřít_V	var_N

impotence_N	potentát_N

kopretina_N	kopr_N

rozmístit_V	místo_N

zásuvka_N	sunout_V

skalistý_A	skála_N

poddůstojník_N	důstojník_N

Juliana_N	Julie_N

svodka_N	svést_V

povléknout_V	povlak_N

františkán_N	František_N

decimální_A	decimovat_V

Vavřín_N	Vavřinec_N

úval_N	uvalit_V

Sevastopol_N	metropole_N

poševní_A	pochva_N

bát_V	běs_N

trucovitý_A	trucovat_V

zubatá_N	zub_N

umrtvit_V	mrtvý_A

Naděžda_N	Naďa_N

zvířetník_N	zvíře_N

účaří_N	čára_N

Maximovič_N	Maxim_N

soustava_N	stav_N

opodstatnit_V	podstatně_D

vysvobodit_V	svoboda_N

pepř_N	pepřenka_N

Růžička_N	růžička_N

podporučík_N	poručík_N

Husův_A	Hus_N

nora_N	nořit_V

čerpat_V	střep_N

zapovídat_V	povídat_V

ultimativní_A	ultimátum_N

Echó_N	echo_N

osrdečník_N	srdce_N

ústřední_A	střed_N

Matuška_N	Matoušek_N

srotit_V	rota_N

břichopásek_N	břicho_N

obzírat_V	zírat_V

zánět_N	zanítit_V

podvýbor_N	výbor_N

hlodák_N	hlodat_V

můstek_N	most_N

půle_N	půl_C

Liberečan_N	Liberec_None

klícka_N	klec_N

Jedovnice_N	jedový_A

tropy_N	tropický_A

podražit_V	drahý_A

flanďák_N	flanda_N

hartusit_V	harašit_V

prázdný_A	prázdniny_N

veganství_N	veganský_A

činovník_N	činit_V

pokolení_N	koleno_N

paralympiáda_N	olympiáda_N

hněď_N	hnědý_A

kostižer_N	kost_N

Panonie_N	panonský_A

vsacký_A	Vsacko_None

smolit_V	smůla_N

adiabata_N	adiabatický_A

duál_N	duel_N

enzymatický_A	enzym_N

půlstoletí_N	století_N

onemocnět_V	nemoc_N

Dubí_N	dub_N

želatina_N	želé_N

hana_N	hanět_V

synovražda_N	vražda_N

abstrakcionista_N	abstrakcionismus_N

vokativ_N	voucher_N

agenda_N	agilní_A

káče_N	kachna_N

píďalka_N	píď_N

portfolio_N	portfej_N

biskup_N	arcibiskup_NC

utiskovat_V	tisknout_V

Koděra_N	Choděra_N

držební_A	držet_V

uskutečnit_V	skutečný_A

záď_N	zezadu_D

relikviář_N	relikvie_N

odklidit_V	klidit_V

rozradostnit_V	radost_N

věhlas_N	hlas_N

dlanitý_A	dlaň_N

vzlet_N	let_N

zapomínat_V	paměť_N

proděkan_N	děkan_N

purkrabí_N	purkmistr_N

poštvat_V	štvát_V

Švestka_N	švestka_N

Dobříč_N	Dobříš_N

tuberkulin_N	tuberkulóza_N

bublifuk_N	bublina_N

Lucie_N	Lucinka_N

lůžko_N	ležet_V

muška_N	moucha_N

pararula_N	rula_N

předobře_D	dobře_D

hovězí_N	hovado_N

psota_N	pes_N

jednooký_D	oko_N

bojácný_A	bát_V

tloušť_N	tlustý_A

bezhlavý_A	hlava_N

država_N	držet_V

rabbi_N	rabínský_A

tělo_N	tělnatý_A

cache_N	geocaching_NC

pacht_N	propachtovatel_N

dutý_A	dout_V

parakotoul_N	kotoul_N

sklovina_N	sklo_N

kláda_N	klát_V

rozjímat_V	jímat_V

butadien_N	butan_N

vlakvedoucí_N	vedoucí_N

škvarek_N	škvára_N

Ostrov_N	ostrov_N

večeřadlo_N	večeře_N

fet_N	feťák_N

úmoří_N	moře_N

hoša_N	hoch_N

absťák_N	abstinence_N

archaikum_N	archaický_A

vozataj_N	vozit_V

Tlustec_N	tlustý_A

oktaván_N	oktáva_N

hnojiště_N	hnůj_N

ojínit_V	jíní_N

pověžný_N	věž_N

zasrat_V	srát_V

vpona_N	spona_N

zočit_V	oko_N

lišaj_N	lišej_N

Kazimír_N	kazit_V

čistopis_N	psát_V

desetinásobný_A	násobit_V

blogosféra_N	blog_N

klídek_N	klid_N

dožádat_A	žádat_V

Filipcová_N	Filipová_N

Radhošť_N	Radegast_N

netáhlo_N	táhlo_N

žralok_N	žrát_V

usychat_V	suchý_A

pokradmu_D	kradmo_D

softbal_N	softball_N

bonboniéra_N	bonbón_N

bezmozek_N	mozek_N

útržek_N	utrhat_V

přepestrý_A	pestrý_A

ztělesnit_V	tělo_N

ohnisko_N	oheň_N

přizdisráč_N	sráč_N

torontský_A	Toronto_N

krvák_N	krev_N

poskvrnit_V	skvrna_N

jsoucno_N	jsoucí_A

pást_V	pastvina_N

dláto_N	dlabat_V

Boris_N	Bořek_N

rozkrok_N	krok_N

bolehlav_N	bolet_V

zakrátko_D	nakrátko_D

vokalíza_N	vokál_N

inventura_N	inventář_N

vychcat_V	chcát_V

pentahydrát_N	hydrát_N

zištný_A	zisk_N

zámoří_N	moře_N

benzaldehyd_N	aldehyd_N

dužnatý_A	dužina_N

nárůst_N	růst_N

cval_N	cválat_V

nadrotmistr_N	rotmistr_N

důtka_N	potkat_V

Kokeš_N	kokeš_N

babočka_N	oko_N

průpověď_N	průpovídka_N

Havana_N	havanský_A

Dita_N	Edita_N

obrok_N	napřesrok_D

nátlak_N	tlak_N

nahlas_D	hlas_N

triatlet_N	triatlonista_N

Luba_N	Lubor_N

znání_N	znát_V

chcíplotina_N	chcípnout_V

zesnout_V	sen_N

ústrk_N	strčit_V

favorizovat_V	favorit_N

kuželosečka_N	kužel_N

vlaštovičník_N	vlaštovka_N

zanikat_V	zánik_N

zkusmo_D	vyzkoušet_V

vid_N	vídat_V

mlha_N	mlhavo_D

šestinohý_A	noha_N

těžní_A	těžit_V

Lopar_N	Laponsko_N

jednoslabičný_A	slabičný_A

srágora_N	srát_V

Skopje_N	skopský_A

připomínat_V	paměť_N

nivelizace_N	znivelizovat_V

pohorka_N	hora_N

Oblík_N	oblý_A

lžičák_N	lžíce_N

skřípat_V	přefiknout_V

Juda_N	judaismus_N

souměstí_N	město_N

Blažejovice_N	blažený_A

nazlátlý_A	zlatý_N

melta_N	mlít_V

předběh_N	běh_N

vadnout_V	zvadnout_V

pařeniště_N	pařit_V

odvirovat_V	virus_N

pohoří_N	hora_N

opravdovský_A	pravda_N

marod_A	marodit_V

fašoun_N	fašismus_N

výmysl_N	vymyslet_V

odcizit_V	cizí_A

vinárna_N	víno_N

abrahámoviny_N	Abrahám_N

Byzantinec_N	Byzanc_N

solitér_N	sólista_N

sestra_N	sestřenice_N

povídálek_N	povídat_V

podstavec_N	podstavit_V

starosta_N	starý_A

představení_N	představenstvo_N

obtěžkat_V	těžký_A

lesostep_N	step_N

agens_N	agent_N

krajka_N	krájet_V

mordýř_N	mord_N

padesátikoruna_N	koruna_N

entuziasmus_N	entusiasmus_N

kamínek_N	kámen_N

doktrinář_N	doktrína_N

náfuka_N	nafukovací_A

podomní_A	dům_N

zátah_N	táhnout_V

jedubaba_N	baba_N

předseda_N	předsednictvo_N

bělat_V	bílý_A

úl_N	ulice_N

nymfomanka_N	nymfomanie_NC

drén_N	drenáž_N

sršní_A	sršeň_N

wikipedista_N	Wikipedie_NC

překrásný_A	krásný_A

mandolinista_N	mandolína_N

šafář_N	Šafář_N

bonita_N	bon_N

mayovka_N	May_N

punkevní_A	Punkva_N

smrticí_A	smrt_N

krajáč_N	krájet_V

Jindrák_N	Jindřich_N

syreček_N	sýr_N

kanonikát_N	kanovník_N

pomůcka_N	pomoc_N

tratit_V	potrat_N

brzký_A	brzy_D

Vašek_N	Václav_N

mlíčňák_N	mléko_N

mamá_N	matka_N

Korea_N	korejština_N

obklad_N	klást_V

straka_N	Straka_N

dynamika_N	dynamo_N

nůše_N	snůška_N

hrst_N	přehršel_N

Stalin_N	stalinistka_N

dohromady_D	hromada_N

Naďa_N	Naděžda_N

Vavřinec_N	vavřín_N

lahvice_N	láhev_N

ráj_N	rajský_A

příčel_N	příčit_V

oplotit_V	plot_N

betonárka_N	beton_N

Kelčan_N	kelčský_A

apokalypsa_N	apokalyptický_A

prvolezectví_N	prvolezkyně_N

Vojta_N	Vojtěch_N

hektarový_A	tříhektarový_AC

řečiště_N	řeka_N

žlutočervený_A	červený_A

ihned_D	hodit_V

funerální_A	funebrák_N

moskyt_N	moskytiéra_N

zlatohlav_N	zlato_N

radikál_N	zradikalizovat_V

brána_N	slavobrána_NC

nynorsk_N	norština_N

vléci_V	vlečka_N

Kelt_N	keltský_A

amorální_A	amoralizmus_N

čtverný_A	čtveřice_N

zataženo_D	zatáhnout_V

Karlštejn_N	Karel_N

hrdlořez_N	hrdlo_N

Londýn_N	Londýňan_N

detekovat_V	detektor_N

jednohrbý_A	hrb_N

kredencká_N	kredenc_N

Vavřík_N	Vavřinec_N

hereze_N	heretik_N

esoterik_N	esoterický_A

vrása_N	řasit_V

silničář_N	silnice_N

odhoz_N	hodit_V

mach_N	machna_N

oplzlý_A	plazit_V

trakářek_N	trakař_N

Máňa_N	Marie_N

žebrat_V	škemrat_V

dostřel_N	střílet_V

standarta_N	standardní_A

skála_N	záskalí_N

chuj_N	chujovina_N

zalesnit_V	les_N

strakapoud_N	straka_N

daleký_A	dálka_N

frnknout_V	frčet_V

chalkopyrit_N	pyrit_N

kolemjdoucí_N	kolem_R

pohltit_V	hltat_V

kněžic_N	kníže_N

cucat_V	cucflek_N

fugato_N	fuga_N

pohádka_N	hádat_V

klín_N	klát_V

pletař_N	plést_V

ometat_V	mést_V

vlásenka_N	vlas_N

Mari_N	Marius_N

číselka_N	číslo_N

tržiště_N	trh_N

protéza_N	protetický_A

bečet_V	bé_N

odpočívat_V	odpočinek_N

výpal_N	výpalné_N

topit_V	teplý_A

kapřivec_N	kapr_N

poklekat_V	klekat_V

úhoř_N	uher_N

rozkrojit_V	krájet_V

podúčet_N	účet_N

řev_N	řvát_V

milený_A	milý_A

rozmyšlení_N	rozmyslet_V

organizovat_V	orgán_N

nonius_N	nóna_N

tesklivý_A	stesk_N

peršan_N	Persie_N

Starorakušan_N	Rakušan_N

krušec_N	krušení_N

abdominální_A	abdomen_N

modální_A	modus_N

poštovné_N	poštovní_A

varhánky_N	varhany_N

gymnazista_N	gymnázium_N

kecálista_N	kecat_V

stírat_V	třít_V

fortepiano_D	piano_N

vyslat_V	odeslání_N

zchytra_D	chytrý_A

padovana_N	Padova_N

zbožíznalství_N	zboží_N

syrovátka_N	sýr_N

předrevoluční_A	revoluční_A

jarka_N	jaro_N

příst_V	přadlena_N

pokukovat_V	koukat_V

prospat_V	spát_V

návěs_N	navěsit_V

dudy_N	dudák_N

koedukace_N	edukace_N

opiát_N	opium_N

Marseillaisa_N	Marseille_N

dodejka_N	dodat_V

pištět_V	pisk_N

katolicizmus_N	katolictví_N

iniciativa_N	iniciovat_V

medvědobijka_N	medvěd_N

plachta_N	plachetnice_N

zajisté_D	jistý_A

dvoustovka_N	stovka_N

hupsnout_V	hup_None

kancelista_N	kancelář_N

předmostí_N	most_N

řad_N	řádek_N

zub_N	bezzubý_A

měkko_N	měkce_D

naoko_D	oko_N

sexualizace_N	sexualizovat_V

sinusoida_N	sinus_N

Porýní_N	Rýn_N

showbyznys_N	show_N

převoz_N	převážet_V

kremace_N	krematorium_N

vykrojit_V	krájet_V

jednosměnný_A	směna_N

katalýza_N	katalyzátor_N

prasečkář_N	prase_N

klopit_V	klepat_V

ohýbadlo_N	ohybník_N

Chod_N	chodský_A

calaiský_A	Calais_N

foglarovka_N	Foglar_N

Vaněk_N	Václav_N

vývojnice_N	vývojka_N

kojit_V	kojná_N

Bechyňsko_N	Bechyně_N

předjaří_N	zjara_D

dyslektik_N	dyslexie_N

býlí_N	bylina_N

univerziáda_N	univerzita_N

zčistajasna_D	čistit_V

Mělník_N	mělnický_A

obilnictví_N	obilí_N

Kostelec_N	kostel_N

kocovina_N	kocour_N

hádě_N	had_N

markrabě_N	marka_N

intubovat_V	tuba_N

ignorovat_V	ignorance_N

legitimní_A	legitimace_N

kánoe_N	kanoista_N

podčárník_N	čára_N

unáhlit_V	náhlý_A

nevolno_D	nevole_N

Hroznatín_N	hrozen_N

třináctka_N	čtrnáctka_N

větvoví_N	větev_N

žalozpěv_N	žal_N

zajíšit_V	jíška_N

bubník_N	buben_N

doslovný_A	slovo_N

poplach_N	plašit_V

hřeben_N	hřbet_N

kašel_N	kašlat_V

roztírat_V	třít_V

zlobit_V	zlo_N

krtonožka_N	krtek_N

poučný_A	poučovat_V

upír_N	vampýr_N

heretik_N	hereze_N

druhdy_D	nikdy_D

prvoligový_A	ligový_A

tutoriál_N	tutor_N

drahocenný_A	cenný_A

králikárna_N	králík_N

kutálet_V	kotoul_N

fóršus_N	šos_N

rozkulačit_V	kulak_N

například_D	příklad_N

dokořán_D	kořen_N

mediální_A	médium_N

gordonsetr_N	setr_N

tuna_N	tonáž_N

bludiště_N	bloudit_V

zbytečný_A	zbýt_V

náskok_N	skok_N

bicí_N	bít_V

Gota_N	gotajský_A

frňák_N	frnknout_V

subkultura_N	kultura_N

racemický_A	racemát_N

oslavenec_N	oslava_N

defilírka_N	defilé_N

omšelý_A	mech_N

rozepsat_V	psát_V

verbež_N	verbovat_V

šlacha_N	šlahoun_N

útlocit_N	útlý_A

nepokoj_N	pokoj_N

prelatura_N	prelát_N

pieta_N	Pius_N

milióntý_A	milión_C

ledaskde_D	kde_P

přemítat_V	mést_V

trdlo_N	trdliště_N

dít_V	děj_N

shodnout_V	shoda_N

Peršan_N	Persie_N

kyrilice_N	Cyril_N

knírač_N	knír_N

přespříliš_D	příliš_D

Tbilisan_N	Tbilisi_N

zrzavý_A	rezavý_A

formule_N	forma_N

trafika_N	trafikant_N

Kovářík_N	Kovařík_N

šukat_V	pošuk_N

hovnocuc_N	hovno_N

štěpit_V	štěpka_N

trpasličí_A	trpaslík_N

hofmistr_N	mistr_N

učit_V	učeň_N

trnož_N	noha_N

vyjasnit_V	jasný_A

reciproční_A	reciprocita_N

rybniční_A	rybník_N

hoch_N	holka_N

půlstrana_N	strana_N

Ganges_N	Ganga_None

veliký_A	velikášství_N

pozitiv_N	diapozitiv_NC

Jenda_N	Jan_N

genofond_N	gen_N

Moravačka_N	Morava_N

farmacie_N	farmaceut_N

rozmařilý_A	rozmar_N

dávnověký_A	dávný_A

závěsný_A	zavěsit_V

načas_D	čas_N

federalismus_N	federace_N

integrita_N	integrál_N

vabank_D	bank_N

podpalubí_N	paluba_N

oceán_N	oceanárium_N

dopsat_V	psát_V

organela_N	orgán_N

druhohory_N	čtvrtohory_N

odpočet_N	počet_N

Etiopan_N	Etiopie_N

přespříští_A	příští_A

einsteinium_N	Einstein_N

ďoura_N	díra_N

sovchoz_N	kolchoz_N

zanedlouho_D	dlouho_D

odstoupit_V	stoupat_V

punčocháče_N	punčocha_N

Český_A	český_A

odpaliště_N	odpálit_V

neduh_N	dužina_N

štolba_N	maštal_N

pelagický_A	pelagiál_N

judaistika_N	judaismus_N

vaginální_A	vagína_N

miniatura_N	zminiaturizovat_V

hudba_N	hudební_A

kališní_A	kalich_N

Klement_N	Kliment_N

osazenstvo_N	osada_N

nechutenství_N	znechutit_V

Galaxie_N	galaxie_N

obídek_N	oběd_N

Drška_N	dršťka_N

zbraň_N	ozbrojený_A

klerofašista_N	fašismus_N

ostošest_D	sto_C

přepažit_V	pažení_N

zpátky_D	zpět_None

Novozélanďan_N	novozélandský_AC

rozrod_N	rod_N

pokradmo_D	kradmo_D

indián_N	Ind_N

ikona_N	ikonostas_NC

vybočit_V	bok_N

Bukovec_N	buk_N

výfuk_N	vyfoukat_V

zmírat_V	zemřít_V

laser_N	maser_N

směr_N	mířit_V

zjara_D	jarní_A

netoliko_D	toliko_D

chvalitebný_A	chválit_V

doňa_N	don_N

eratém_N	éra_N

klapat_V	klepat_V

Drbohlav_N	drbat_V

rabinát_N	rabín_N

beztíže_N	tíže_N

Severokorejec_N	Korejec_N

Rosický_N	Rosice_N

předpeklí_N	peklo_N

šeptmo_D	šeptat_V

rys_N	velkorysý_AC

fritovat_V	fritéza_N

Jednota_N	jednota_N

graffiti_N	grafit_N

mnišstvo_N	mnich_N

moučnivka_N	mouka_N

formát_N	forma_N

Diův_A	Zeus_N

topor_N	topůrko_N

úrok_N	rok_N

pobrekávat_V	brečet_V

vysrat_V	srát_V

kluzký_A	kluziště_N

pronikat_V	vznikat_V

škvor_N	škvařit_V

nalačno_D	lačný_A

příloha_N	přiložit_V

figuralista_N	figura_N

droboučký_A	drobný_A

rádlo_N	radlice_N

lama_N	dalajlama_N

Jedlička_N	jedlička_N

rus_N	Rus_N

onehdy_D	onde_D

Pováží_N	Váh_N

gymnázium_N	gymnazista_N

Turkménie_N	Turkmenistán_N

navěky_D	věk_N

budit_V	bdít_V

Jiskra_N	jiskra_N

pivot_N	pivotmanka_N

konkrétní_A	zkonkretizovat_V

podprsenka_N	prs_N

Podskalí_N	skála_N

jmeniny_N	jméno_N

hovnivál_N	hovno_N

podnebí_N	nebe_N

harfenista_N	harfa_N

záliba_N	líbit_V

odběr_N	odebrat_V

branný_A	bránit_V

obvyklý_A	návyk_N

zrnožravý_A	zrní_N

byro_N	byrokratismus_N

sesterna_N	sestra_N

zatuchat_V	tuchnout_V

zubr_N	Zubří_N

soustředit_V	střed_N

podnítit_V	podnět_N

ulice_N	úl_N

Šalomoun_N	Šalamoun_N

nořit_V	únor_N

františek_N	František_N

proslýchat_V	slýchat_V

donebevolající_A	volající_A

ratio_N	poměr_N

Vendula_N	Václava_N

tvarůžkárna_N	tvaroh_N

doutnat_V	dout_V

výkrm_N	krmit_V

perleť_N	perla_N

tvarosloví_N	slovo_N

Bláha_N	Blažej_N

plačky_D	Plačková_N

kickbox_N	box_N

příjezd_N	přijet_V

nestraník_N	nestranný_A

směrodatný_A	směr_N

Řehák_N	Řehoř_N

manganičitý_A	mangan_N

Kubíčková_N	Jakub_N

čihař_N	číhat_V

holčina_N	holka_N

optika_N	synoptický_A

čtvrtlitr_N	čtvrt_C

pomlka_N	pomlčka_N

ztvárnit_V	tvář_N

Alex_N	Alexandr_N

dělat_V	dít_V

okraj_N	kraj_N

karbon_N	karbanátek_N

veganský_A	veganství_N

svědčit_V	svědek_N

Dalibor_N	Ratibor_N

zženštit_V	žena_N

mašinérie_N	mašina_N

přilnavý_A	lnout_V

Jáša_N	Jáchym_N

pokrevní_A	krevní_A

kňourat_V	knír_N

nikam_D	kam_D

souostroví_N	ostrov_N

zohlednit_V	ohled_N

vpololeže_D	ležet_V

dvojí_A	dvojče_N

chvost_N	hvozd_N

vybízet_V	nabídka_N

úhrn_N	hrnout_V

štíhlý_A	plnoštíhlý_AC

podhůří_N	hora_N

vlezdoprdelka_N	prdel_N

Lévi_N	levita_N

bezcenný_A	cena_N

odkop_N	kopat_V

kazeta_N	videokazeta_NC

zámek_N	zamykat_V

Kocourkov_N	kocourek_N

geniální_A	génius_N

kodex_N	kód_N

pechfógl_N	pech_N

Achilles_N	achilovka_N

vývrh_N	vrhnout_V

toreador_N	korida_N

digestivní_A	digestoř_N

potenciál_N	potentát_N

pátrat_V	patřit_V

zevnitř_D	zevní_A

přisvojit_V	osvojit_V

klučičí_A	kluk_N

pošuk_N	šukat_V

oktrojírka_N	oktrojovat_V

methemoglobin_N	hemoglobin_N

nalevo_D	levý_A

Linus_N	Linux_N

Oslavany_N	Oslava_N

Achilleus_N	Achilles_N

linie_N	lajna_N

pestrý_A	psát_V

Zeman_N	zeman_N

výpravčí_N	výprava_N

Sandra_N	Alexandra_N

popelín_N	popel_N

dioxid_N	oxid_N

dlužní_A	dluh_N

otakárek_N	Otakar_N

šalinkarta_N	šalina_N

mravenec_N	mravenečník_N

proutěný_A	prut_N

pobíhat_V	běhat_V

oblak_N	oblačnost_N

Jičíněves_N	Jičín_None

Kutnohorsko_N	kutnohorský_A

Mohamed_N	mohamedánský_A

podsvětí_N	svět_N

ubíhat_V	běhat_V

titan_N	Titán_N

peří_N	pero_N

nárameník_N	náramek_N

sanice_N	saně_N

legion_N	legionář_N

Budapešť_N	Budapešťan_N

bludařit_V	bloudit_V

cílevědomý_A	cíl_N

torpédoborec_N	torpédo_N

kořalečník_N	kořalka_N

komando_N	komandant_N

zlatulinký_A	zlatý_N

Muhammad_N	mohamedánský_A

podměrečný_A	měřit_V

pýří_N	pýr_N

klát_N	kolbiště_N

úbytek_N	být_V

výpalné_N	vypalovačka_N

cmrndat_V	přicmrndávat_V

vesměs_D	směs_N

vazký_A	vaz_N

omyl_N	mýlit_V

kosinus_N	sinus_N

housenka_N	husa_N

pasparta_N	pasáž_N

humanismus_N	humanistický_A

kecat_V	kydat_V

milerád_A	mile_D

soupis_N	psát_V

zplnomocnit_V	moct_V

Modřice_N	modrý_A

Štangler_N	štangle_N

kartuzián_N	kartouza_N

racemát_N	racemický_A

černoprdelník_N	prdel_N

Dobřichovice_N	Dobříš_N

Křesadlo_N	křesadlo_N

šoustat_V	obšoustník_N

temperovat_V	temperatura_N

trdlice_N	trdliště_N

barabizna_N	baraba_N

Oslo_N	oselský_A

exantematický_A	exantém_N

anekční_A	anexionizmus_N

rozprávět_V	pravit_V

výpusť_N	pustit_V

neřád_N	řád_N

bordel_N	bordelmamá_N

tříjazyčný_A	jazyk_N

zmasit_V	maso_N

Kliment_N	Klement_N

bezocasý_A	ocas_N

freeware_N	software_N

Pohořelec_N	hořet_V

jednostopý_A	stopa_N

dobrý_A	doba_N

poklonkovat_V	poklonit_V

Hranice_N	hranice_N

terminál_N	termín_N

lazebník_N	lázeň_N

trápit_V	trpět_V

vlom_N	lom_N

duch_N	duchovní_N

paprsek_N	prskat_V

frekventant_N	frekvence_N

Hrabě_N	hrabě_N

odmlouvat_V	mluvit_V

krotký_A	krotit_V

Mars_N	Marťan_N

huhňat_V	huhlat_V

výhon_N	vyhnat_V

proreformní_A	reformní_A

taneční_N	tanec_N

schůdný_A	schod_N

concertino_N	koncert_N

galerista_N	galerie_N

strofický_A	strofa_N

Nikaragujec_N	Nikaragua_N

šampionát_N	šampión_N

zřítelnice_N	zřít_V

Šíp_N	šíp_N

Úpice_N	Úpa_None

potýkat_V	týkat_V

unikat_V	vznikat_V

výlevka_N	vylít_V

koma_N	kometa_N

erotika_N	erós_N

neschopenka_N	neschopný_A

alef_N	alfa_N

škatulkovat_V	škatule_N

Jakubův_N	Jakub_N

jatýrka_N	játra_N

kapitulovat_V	kapitál_N

pobožný_A	zbožný_A

obchodněprávní_A	právní_A

nadstrážmistr_N	strážmistr_N

Miluše_N	Miloš_N

romaneto_N	román_N

Bartoš_N	Bartoloměj_N

idiotština_N	idiotský_A

semílat_V	omílat_V

pryž_N	pružina_N

erudice_N	erudovaný_A

klít_V	kletba_N

bláha_N	blázen_N

hoblovat_V	hoblík_N

upírat_V	přít_V

sýkora_N	syčet_V

Svačina_N	svačina_N

ouřední_A	ouřada_N

kabinet_N	kabina_N

předprseň_N	prs_N

próza_N	prozaický_A

zásuvný_A	zásuvka_N

katastr_N	katastrální_A

kopiník_N	kopí_N

dlabat_V	zdlábnout_V

jednosměrka_N	osmisměrka_N

trávit_V	potrava_N

koňař_N	kůň_N

stelivo_N	stlát_V

slabý_A	slabozrakost_N

Kovář_N	Kovařík_N

padlí_N	padat_V

odbor_N	odborně_D

blud_N	bloudit_V

srostlý_A	růst_N

anestezie_N	anestetikum_N

oddenek_N	dno_N

lechtat_V	lechtivý_A

Popelka_N	popel_N

prorektor_N	rektor_N

chroptit_V	chrapot_N

stéblo_N	zblo_N

zevšeobecnit_V	všeobecný_AC

tabatěrka_N	tabák_N

podvozek_N	vůz_N

panic_N	panenský_A

Votka_N	votský_A

banální_A	zbanalizovat_V

spratek_N	párat_V

souhrn_N	úhrn_N

Marián_N	Marie_N

Jakoubková_N	Jakub_N

rozmach_N	máchat_V

vichřice_N	vichr_N

sifon_N	uzávěrka_N

jevit_V	zjev_N

proč_D	pročež_J

zdvojnásobit_V	násobit_V

Bukovice_N	buk_N

heslo_N	hodit_V

akceptor_N	akceptovatelný_A

zářijový_A	září_N

skořepina_N	skořápka_N

zacelit_V	celý_A

zaklechtat_V	záklechtka_N

náměr_N	mířit_V

shromáždit_V	hromada_N

nekuřák_N	kuřák_N

ucpat_V	cpát_V

bělogvardějec_N	bílý_A

srůst_N	růst_N

prťák_N	prtě_N

kopat_V	zlatokop_N

semeno_N	seminář_N

manšestr_N	Manchester_N

obtisk_N	tisk_N

předdveří_N	dveře_N

výzkum_N	zkoumat_V

pětiměsíční_A	pět_C

dvounohý_A	noha_N

závažný_A	vážný_A

předpotopní_A	potopa_N

akvarista_N	akvárium_N

předehnat_V	hnát_N

vačice_N	váček_N

šlupka_N	slupka_N

zbezvýznamnit_V	význam_N

soběslavský_A	Soběslav_N

zesvětlit_V	světlo_N

Helada_N	helénský_A

rosol_N	rosolovitý_A

Bosna_N	bosenština_N

převaz_N	obvaz_N

vandrovní_A	vandrovat_V

kufírek_N	kufr_N

Všetice_N	Vsetín_None

mauricijský_A	Mauricius_N

trnka_N	Trnková_N

fundace_N	fond_N

táta_N	taťka_N

titaničitý_A	titanový_A

sedmnáctka_N	šestnáctka_N

Lucinka_N	Lucie_N

předchorobí_N	choroba_N

obklíčit_V	klíčit_V

judaikum_N	judaismus_N

reanalýza_N	analýza_N

ústavodárce_N	ústavodárný_A

staře_D	stáří_N

Rosťa_N	Rostislav_N

porevoluční_A	revoluční_A

hynout_V	hubit_V

oblouk_N	oblý_A

vzlínat_V	lnout_V

car_N	carevna_N

lomikámen_N	lámat_V

podlaha_N	podložit_V

zleva_D	levý_A

skrutátor_N	skrutinium_N

kaskadér_N	kaskáda_N

bezradný_A	rada_N

šikmo_D	šik_A

žok_N	sak_N

součin_N	čin_N

namodralý_A	modrý_A

sunita_N	sunnita_N

arendátor_N	arenda_N

zanožit_V	noha_N

celebrovat_V	celebrita_N

plachetnice_N	plachta_N

zchvátit_V	ztrhat_V

perfektivní_A	perfektní_A

pověra_N	víra_N

Světluše_N	světlo_N

rýt_V	rypák_N

krvinka_N	krev_N

sklep_N	sklepení_N

Volgograd_N	Volha_None

potají_D	taj_N

baronet_N	baron_N

jednojazyčný_A	jazyk_N

úspora_N	spořit_V

přívětivý_A	závěť_N

Rudolfinum_N	Rudolf_N

náušnice_N	ucho_N

svačit_V	svačina_N

pach_N	páchnout_V

podnožka_N	noha_N

baťůžkář_N	batoh_N

oboupohlavní_A	pohlavní_A

zmítat_V	mést_V

beruška_N	brouk_N

netbook_N	notebook_N

pěkný_A	psát_V

obojace_D	obojakost_N

odkrojit_V	krájet_V

Mrazík_N	mráz_N

domácí_N	dům_N

Nigérie_N	Niger_N

rozpažit_V	paže_N

příval_N	přivalit_V

premiant_N	primát_N

stance_N	sloka_N

Julius_N	Julie_N

metro_N	metropole_N

sarajevský_A	Sarajevo_N

opětovat_V	opět_D

pojišťovák_N	pojišťovna_N

servat_V	rvát_V

rituál_N	ritus_N

složnokvětý_A	složenina_N

prázdniny_N	prázdný_A

průzor_N	zor_N

miliardtý_A	miliarda_C

fantazie_N	fantastický_A

dispozice_N	disponovat_V

setník_N	setnina_N

žebřík_N	žebro_N

nebesa_N	nebe_N

neprávo_N	právo_N

vůz_N	vozit_V

laň_N	jelen_N

pohlavek_N	hlava_N

drůbky_N	droby_N

mrdník_N	mrdat_V

odvodnit_V	voda_N

kamenivo_N	kámen_N

viselec_N	viset_V

Abchaz_N	Abcházie_N

očekávat_V	čekat_V

Tatarka_N	tatar_N

nandu_N	najít_V

unavit_V	únava_N

přetisk_N	tisk_N

nehynoucí_A	hynout_V

kamení_N	kámen_N

panský_N	pán_N

Jindřišská_N	Jindřich_N

klokoč_N	klokočí_N

Gruntorád_N	grunt_N

úplný_A	plný_A

konvertita_N	konverze_N

deštík_N	déšť_N

klnout_V	klít_V

Jamajka_N	Jamajčan_N

rvát_V	poryv_N

jmění_N	movitost_N

mix_N	mixér_N

žmolenka_N	žmolek_N

holý_A	holínka_N

prvopis_N	první_C

výpomoc_N	pomoc_N

shůry_D	pohoří_N

sdílný_A	sdělení_N

vatelín_N	vatový_A

představenstvo_N	představovat_V

mázdřivka_N	mázdra_N

sekundant_N	sekundér_N

Gábi_N	Gabriel_N

zavšivit_V	veš_N

přechytralý_A	chytrý_A

postilion_N	poštovní_A

omnibus_N	bus_N

cvičenka_N	cvičit_V

marka_N	markrabě_N

erós_N	Erós_N

zarybnit_V	ryba_N

hlad_N	hladomor_N

výkres_N	kreslit_V

méďa_N	medvěd_N

podkapitola_N	kapitola_N

Sváťa_N	Svatopluk_N

hyenismus_N	hyena_N

formální_A	zformalizovat_V

jiskérka_N	jiskra_N

alfabeta_N	alfa_N

bezmezný_A	mez_N

čeřit_V	čeřen_N

tangens_N	kotangens_N

profesionalizmus_N	profesionální_A

korný_A	kůra_N

bezhotovostní_A	hotovostní_A

bebínko_N	bebí_N

lampion_N	lampa_N

popořádku_D	pořádek_N

Hamburk_N	hamburger_N

služné_N	sluha_N

žabisko_N	žába_N

noradrenalin_N	adrenalin_N

pantofel_N	pantoflíček_N

úmor_N	mořit_V

zrzek_N	zrzavý_A

gesce_N	digestoř_N

podskupina_N	skupina_N

jinaký_A	jiný_A

maligní_A	malignita_N

management_N	manažer_N

Maťa_N	Martin_N

nekalosoutěžní_A	soutěžní_A

Poniklá_N	koniklec_N

vrdlouhat_V	hrdlo_N

sestoupit_V	sestup_N

koniklec_N	Punkva_N

Kolumbijka_N	Kolumbie_N

hrábě_N	hrabat_V

svršek_N	vrch_N

dynamo_N	dynamický_A

rozptyl_N	rozptýlit_V

žebřiňák_N	žebřina_N

atypický_A	typický_A

sloupořadí_N	sloup_N

hnedlinko_D	hnedle_D

Pardubák_N	Pardubice_N

pružit_V	pryž_N

ouško_N	ucho_N

oplodnit_V	plod_N

naprosto_D	prostý_A

služebný_N	služba_N

Uran_N	uranizmus_N

dvořan_N	dvůr_N

pytel_N	pytlák_N

čepýřit_V	pýří_N

křehounce_D	křehký_A

zástřelné_N	zastřelit_V

hnědozem_N	zem_N

přeprat_V	prát_V

Eleonora_N	Nora_N

kultivovat_V	kultura_N

ořešák_N	ořech_N

pětiúhelník_N	pět_C

Blažík_N	Blažej_N

fixírka_N	fix_N

Seveřan_N	severský_A

managujský_A	Managua_N

trn_N	Trneček_N

umravnit_V	mravně_D

jednoslovný_A	slovo_N

potucha_N	tušit_V

Javánka_N	Jáva_N

Nizozemsko_N	země_N

kožich_N	kožešina_N

Kolář_N	kolář_N

upokojit_V	nepokoj_N

vtip_N	vtípek_N

Medek_N	Medard_N

cívka_N	céva_N

malíček_N	malý_A

Natálie_N	Nataša_N

zápočet_N	počet_N

liz_N	lízat_V

jiřina_N	Jiřina_N

genotyp_N	gen_N

data_N	datum_N

principiální_A	princip_N

flamendr_N	flámovat_V

ztmavit_V	tmavě_D

vlet_N	let_N

Kuroslepy_N	kur_N

nadloží_N	podloží_N

schopný_A	chopit_V

Marek_N	Marius_N

návštěva_N	navštívit_V

indispozice_N	indisponovaný_A

žalm_N	žaltář_N

pot_N	upoceně_D

Bořivoj_N	voj_N

volha_N	Volha_N

Kladno_N	Kladeňák_N

snůška_N	snosit_V

knot_N	kratiknot_N

bezzubý_A	zub_N

zmijovec_N	zmije_N

ulehčit_V	lehký_A

psí_A	pes_N

populace_N	populární_A

úchyt_N	chytit_V

drhat_V	zdrhnout_V

bujet_V	bujný_A

aktuální_A	akt_N

zahlenit_V	hlen_N

skýtat_V	výskyt_N

fuka_N	Fuka_N

pokrm_N	krmit_V

torpédomet_N	torpédo_N

článek_N	člen_N

pryč_D	napříč_R

echolokace_N	echo_N

epilace_N	epilátor_N

strejda_N	strýc_N

kajícnictví_N	kát_V

žít_V	žeň_N

determinismus_N	determinace_N

deblkajak_N	kajak_N

východisko_N	východ_N

nehoda_N	hodit_V

Zahradník_N	zahradník_N

slynout_V	slout_V

angažovat_V	angažmá_N

natolik_D	tolik_None

výztuha_N	tužit_V

Švýcar_N	švýcarský_A

kamna_N	komín_N

tereziánský_A	Terezie_N

vyšilovat_V	šílet_V

fakule_N	fakulta_N

vroubit_V	roubit_V

Nusle_N	nuselský_A

vichr_N	vichřice_N

Kateřina_N	Kačena_N

hlíznatý_A	hlíza_N

presumpce_N	presumovat_V

čnělka_N	čnít_V

zemanovec_N	Zeman_N

džíny_N	džínsovina_N

účin_N	čin_N

kaňhat_V	kanit_V

prvolezec_N	lezec_N

rozvášnit_V	vášeň_N

Křeček_N	křeček_N

rozžíhat_V	žíhat_V

Mosambičan_N	Mosambik_N

bromovodík_N	vodík_N

arbitráž_N	arbitrární_A

shovívavý_A	hovět_V

baťůžek_N	batoh_N

smečenský_A	Smečno_None

cucflek_N	flek_N

huhňa_N	huhlat_V

okamžitý_A	okamžik_N

dočasný_A	čas_N

brácha_N	bratr_N

tamtudy_D	tam_D

poprsnice_N	prs_N

normativ_N	norma_N

kopt_N	koptský_A

leukémie_N	leukocyt_NC

Posázaví_N	Sázava_N

idol_N	idolatrie_N

vštípit_V	štípat_V

zuhelnatit_V	uhlík_N

jednohubka_N	huba_N

zakusit_V	zkusit_V

metla_N	šlehačka_N

paralyzovat_V	paralytik_N

průzkum_N	prozkoumat_V

slon_N	slonice_N

lenní_A	léno_N

ekumena_N	anekumena_N

uveřejnit_V	veřejný_A

tlama_N	tlachat_V

rokenrol_N	rock_N

bohočlověk_N	člověk_N

cvik_N	cvičiště_N

May_N	mayovka_N

podčeleď_N	čeleď_N

klást_V	poklad_N

Pitrová_N	Petrová_N

odkaliště_N	kal_N

Hracholusky_N	hrách_N

nahotina_N	nahý_A

soprán_N	sopranistka_N

Rakovec_N	rak_N

Kuchař_N	kuchař_N

markýrovat_V	marka_N

Sarajevo_N	sarajevský_A

Sehnal_N	sehnat_V

hrana_N	hranol_N

pětadvacátník_N	pětadvacítka_N

srdceryvný_A	srdce_N

dvouslabičný_A	slabičný_A

masokombinát_N	maso_N

plasticita_N	plast_N

zároveň_D	rovný_A

panker_N	punk_N

xylolitář_N	xylolit_NC

oběť_N	obětovat_V

obava_N	obávat_V

strunatec_N	struna_N

ochota_N	chtít_V

Agaton_N	Agáta_N

nástřel_N	střílet_V

babča_N	babka_N

kolovrátek_N	kolovrat_N

slípka_N	slepice_N

klanět_V	klonit_V

slaďák_N	sladký_A

nerovný_A	rovný_A

meteoroid_N	meteor_N

prohlubeň_N	hloubit_V

kysličník_N	kyslík_N

signovat_V	signatář_N

věšet_V	viset_V

frája_N	frajer_N

přihnat_V	hnát_V

kolchoz_N	sovchoz_N

dekor_N	dekorativní_A

koza_N	kozel_N

letohrádek_N	léto_N

předzápas_N	zápas_N

zneškodnit_V	neškodný_A

mlíčí_N	mléko_N

mříž_N	zamřížovaný_A

mouřenín_N	mour_N

zvětšit_V	většinový_A

zlatokrt_N	krtek_N

datlovník_N	datle_N

posměšný_A	směšný_A

Zíma_N	zima_N

bezesporu_D	spor_N

komolý_A	homole_N

Šalamoun_N	šalamoun_N

bezkontaktní_A	kontakt_N

zručný_A	ruka_N

jirský_A	Jiří_N

zírat_V	zor_N

vál_N	válet_V

zídka_N	zeď_N

eden_N	Eden_N

škrabopis_N	psát_V

Olomoučák_N	Olomouc_None

vyhazov_N	vyhodit_V

zelniště_N	zelí_N

záhlavec_N	hlava_N

výměnek_N	výměna_N

sondáž_N	sonda_N

drvoštěp_N	dřevo_N

žabina_N	žába_N

vladyka_N	vládnout_V

foném_N	fonetický_A

sešítek_N	sešit_N

oprátka_N	oprať_N

zavděk_D	vděk_N

Arménie_N	arménský_A

věrohodný_A	hodný_A

krvácet_V	krev_N

paštika_N	paštikárna_N

padesátník_N	padesátiny_N

afektivní_A	afektovaný_A

vakovlk_N	vlk_N

přelet_N	let_N

fusak_N	fusekle_N

příměstský_A	městský_A

dospat_V	spát_V

klatba_N	kletba_N

přecpat_V	cpát_V

vlkodlak_N	vlk_N

brankoviště_N	brankář_N

Antek_N	Antonín_N

rozepře_N	přít_V

zbídačit_V	bída_N

duševní_A	duše_N

purkmistr_N	purkrabí_N

sylabotónický_A	sylaba_N

maestro_N	magistr_N

dějinný_A	dějiny_N

Božek_N	Bohumír_N

kakost_N	kost_N

mour_N	mourek_N

Lubor_N	Libuše_N

úkrok_N	krok_N

Bollywood_N	Hollywood_N

avízo_N	avizovat_V

storublovka_N	rubl_N

sídliště_N	sídlo_N

islamistika_N	islám_N

slétat_V	letět_V

výrostek_N	výrůstek_N

popis_N	popsat_V

Kamenice_N	kámen_N

modernismus_N	moderní_A

černoplodý_A	plod_N

bariéra_N	bezbariérový_AC

pomaďarštit_V	Maďar_N

stopky_N	stopovat_V

káča_N	kachna_N

mód_N	modus_N

jař_N	jaro_N

vzmužit_V	muž_N

žloutenka_N	žlutý_A

zdokonalit_V	dokonalý_A

pole_N	polař_N

těhotenský_A	těhule_N

bohačka_N	boháč_N

María_N	Marie_N

bomba_N	bombardovat_V

taky_D	tak_None

všanc_D	šance_N

pazvuk_N	zvuk_N

ježatec_N	ježek_N

rotný_N	rota_N

prézens_N	prezent_N

achromát_N	achromatizmus_N

opotřebit_V	potřebovat_V

kantaberský_A	Kantábrie_N

zaháknout_V	hák_N

Slavoj_N	voj_N

dativ_N	datum_N

klenotnička_N	klenotník_N

adhezívní_A	adheze_N

Mostečan_N	Most_N

káthmándský_A	Káthmándú_N

křovinořez_N	křovina_N

ošoust_N	šoustat_V

zlatý_A	zlatonosný_A

beryl_N	beryllium_N

pakomár_N	komár_N

hobby_N	kůň_N

svědomitý_A	svědomí_N

diktovat_V	diktát_N

kráčet_V	krok_N

hložinka_N	hloh_N

zvratky_N	zvracet_V

Popov_N	pop_N

bezzemek_N	země_N

grafikon_N	graf_N

inzert_N	inzerovat_V

souosý_A	osový_A

klinika_N	klimakterium_N

Kujeba_N	Kujebák_N

prapor_N	pero_N

hořknout_V	hořký_A

ouřada_N	úřad_N

flexe_N	flekční_A

rozněžnit_V	něha_N

osmnáctka_N	sedmnáctka_N

kozle_N	koza_N

podmnožina_N	množina_N

koprocesor_N	procesor_N

rakvář_N	rakev_N

elektro_N	elektrikář_N

shora_D	hora_N

sputum_N	hnis_N

dosavadní_A	dosavad_None

hadraplán_N	hadr_N

Thajsko_N	Thajka_N

Vokurka_N	okurka_N

sklípkan_N	sklípek_N

propaganda_N	propagátor_N

curie_N	curium_N

metrum_N	metronom_NC

Majka_N	Marie_N

mrtvý_A	smrt_N

křižák_N	kříž_N

manžel_N	muž_N

srbocharvátský_A	Charvát_N

Trosky_N	troska_N

předsudek_N	soud_N

brejle_N	brýle_N

bezvaječný_A	vajíčko_N

desátník_N	desetinný_A

stáložárný_A	stálý_A

podkládat_V	klást_V

sečtělý_A	číst_V

barpult_N	pult_N

tempo_N	spadat_V

ciferník_N	cifra_N

jaderný_A	jádro_N

ret_N	rtěnka_N

siena_N	Siena_None

jitrocel_N	jitro_N

prognóza_N	pranostika_N

dohra_N	hra_N

konjunktura_N	konjunkce_N

konzervatorista_N	konzervatoř_N

patřit_V	pátrat_V

nabodat_V	bodat_V

hokejbal_N	hokej_N

večer_N	svatvečer_N

vtisk_N	tisk_N

otčím_N	otec_N

zhlaví_N	hlava_N

nástěnný_A	stěna_N

odvětit_V	závěť_N

Maročan_N	Maroko_N

Andrej_N	Ondřej_N

manko_N	mankař_N

rovnou_D	rovný_A

růže_N	Růžena_N

rybničný_A	rybník_N

prošustrovat_V	švec_N

nastlat_V	stlát_V

nádoba_N	doba_N

chcanky_N	chcát_V

opásat_V	pás_N

zdymadlo_N	zdýmat_V

lihoměr_N	líh_N

anabolikum_N	anabolizmus_N

modloslužba_N	modla_N

sousloví_N	slovo_N

porézní_A	pór_N

algoritmizace_N	algoritmus_N

košikář_N	koš_N

usmrtit_V	smrt_N

půlměsíc_N	měsíc_N

Uhříněves_N	ves_N

vlajka_N	vlát_V

křtěnec_N	křtít_V

zdárný_A	zdar_N

pecivál_N	pec_N

muka_N	mučidlo_N

námezdní_A	mzda_N

příkrm_N	krmit_V

zákeřný_A	keř_N

spižírna_N	spíž_N

přísluní_N	slunce_N

zviditelnit_V	viditelný_A

vysvětlit_V	světlo_N

zamáčknout_V	mačkat_V

zpaměti_D	paměť_N

zažíhat_V	žíhat_V

zlatičký_A	zlatý_N

dvouslovný_A	slovo_N

předlouhý_A	dlouhý_A

vpisek_N	vepsat_V

nula_N	vynulovat_V

uršulinka_N	Uršula_N

podučitel_N	učitel_N

hošan_N	hoch_N

nedočkavý_A	dočkat_V

beztuký_A	tuk_N

nalíc_D	líc_N

korelativní_A	korelát_N

paramedik_N	medik_N

kvádr_N	kvadrát_N

nepaměť_N	paměť_N

včera_D	předevčírem_D

podnes_D	dneska_D

režim_N	rychtář_N

návěstidlo_N	návěstí_N

Odra_N	oderský_A

motto_N	moto_N

bezbarvý_A	barevný_A

merkur_N	Merkur_None

poprsník_N	prs_N

muflonče_N	muflon_N

fluorovodík_N	vodík_N

vlákénko_N	vlákno_N

podváha_N	váha_N

Donbas_N	Doněck_N

bodlina_N	bodat_V

praktikábl_N	praktika_N

Hlinsko_N	hlinka_N

pantomima_N	mim_N

stesk_N	stýskat_V

Střela_N	střílet_V

zvonkohra_N	zvon_N

kružidlo_N	kruh_N

železodárný_A	železo_N

studený_A	zastudena_D

altista_N	alt_N

utilizace_N	utilita_N

obeznámit_V	znát_V

kótovat_V	kotační_A

Písek_N	písek_N

prorok_N	říct_V

luh_N	louže_N

užitný_A	žít_V

špehovat_V	špehýrka_N

vtipkář_N	vtip_N

lid_N	lidičky_N

zevní_A	vnější_A

Mendel_N	Menachem_N

pokoj_N	odpočinek_N

piano_N	pianino_N

choroboplodný_A	choroba_N

Líba_N	Libor_N

vrtoch_N	vrt_N

jednodenní_A	denní_A

Héliův_A	Hélios_N

teorie_N	teoretický_A

agitprop_N	agitace_N

albín_N	albinismus_N

osamostatnit_V	samostatný_AC

kromaňonský_A	kromaňonec_N

spravedlivý_A	spravedlnost_N

koncept_N	koncipient_N

loreta_N	bakalář_N

látka_N	látat_V

roub_N	rubáš_N

vyprat_V	prát_V

ranit_V	rána_N

navždy_D	vždy_D

brexit_N	exit_N

nacionalizace_N	znacionalizovat_V

zateplit_V	teplý_A

pětisetkoruna_N	koruna_N

chřupan_N	chrup_N

tonžský_A	Tonga_N

fortepiano_N	piano_N

sprcha_N	pršet_V

pořádat_V	řád_N

vrána_N	vraný_A

Hruška_N	hruška_N

slavizmus_N	slovanský_A

přemístit_V	místo_N

masařka_N	maso_N

miamský_A	Miami_N

žoužel_N	žížala_N

labiála_N	labium_N

Mazury_N	mazurský_A

bezsrstý_A	srst_N

rozpuk_N	puk_N

Jarda_N	Jaroslav_N

amazoňan_N	Amazonka_N

dvojice_N	dvojče_N

předstírat_V	prostřít_V

profesura_N	profesor_N

barvínek_N	barva_N

vlak_N	vléct_V

radlice_N	rádlo_N

pifka_N	píka_N

veseloherný_A	veselohra_N

skotačina_N	skot_N

dohodce_N	dohodit_V

žilinský_A	Žilina_N

Smetana_N	smetana_N

plebej_N	plebs_N

Znojemsko_N	Znojmo_N

hrabičky_N	hrábě_N

koenzym_N	enzym_N

vnímat_V	jímat_V

folkloristika_N	folklór_N

napořád_D	pořád_D

stříbřenka_N	stříbro_N

lehký_A	ultralehký_AC

pryč_N	napříč_R

hudec_N	housle_N

psoriatik_N	psoriáza_N

klíč_N	utáhnout_V

botel_N	hotel_N

pakostnice_N	kost_N

kýbl_N	kupa_N

fenomenální_A	fenomén_N

jemný_A	křehký_A

nepořádek_N	pořádek_N

sesadit_V	sadit_V

kožený_A	kůže_N

chlorovodík_N	vodík_N

ucho_N	ušitý_A

ubezpečit_V	bezpečnost_N

jiskřiště_N	jiskra_N

Fuka_N	fuka_N

Šedý_N	šedý_A

pinda_N	pinďa_N

učebna_N	učební_A

házenkář_N	házená_N

držadlo_N	držet_V

klíšťky_N	kleště_N

vaginismus_N	vagína_N

bručet_V	brum_N

obrys_N	rys_N

nemakačenko_N	makat_V

mrzký_A	mrzet_V

vést_V	vůdkyně_N

rdousit_V	hrdlo_N

smůla_N	sesmolit_V

kasa_N	inkaso_N

naleziště_N	nalézt_V

také_D	tak_None

technika_N	technolog_N

Tomeš_N	Tomáš_N

ufoun_N	ufon_N

manikúra_N	kúra_N

výpůjční_A	půjčit_V

ordál_N	ortel_N

bezobsažný_A	obsah_N

deštivo_D	déšť_N

kartézský_A	Descartes_N

pořez_N	řezat_V

našedivělý_A	šedivý_A

rozstřihat_V	střihat_V

zajímat_V	jímat_V

bráhma_N	bráhmanismus_N

kondicionovat_V	kondice_N

naruby_D	rub_N

bachratý_A	bachor_N

Šturm_N	šturm_N

pilný_A	píle_N

lexikon_N	lexikografie_NC

doběh_N	běh_N

opušťák_N	opustit_V

druhorozený_A	druhorodička_N

bank_N	bankéř_N

rosnička_N	rosa_N

nerez_A	rezavět_V

křehotinka_N	křehký_A

Martuška_N	Martin_N

spartakiáda_N	Spartakus_None

újezd_N	ujet_V

předměstí_N	město_N

mrkváče_N	mrkev_N

botulotoxin_N	botulizmus_N

šeptat_V	šeptanda_N

galantní_A	gala_N

koňák_N	kůň_N

chlebárna_N	chléb_N

travěnka_N	tráva_N

ochlupení_N	chlup_N

zádveří_N	dveře_N

kdysi_D	někdy_D

zvát_V	název_N

lasturnatka_N	lastura_N

Tatar_N	tatar_N

lampión_N	lampa_N

akontace_N	konto_N

dělostřelec_N	dělo_N

srůst_V	růst_N

politika_N	zpolitizovat_V

luetik_N	lues_N

vazba_N	vaz_N

Heřmaň_N	Heřmanův_A

zlevnit_V	levný_A

rabí_N	rabínský_A

galaxie_N	Galaxie_N

vlaštovka_N	vlaštovičník_N

krýt_V	krovka_N

krupovka_N	kroupa_N

Abrahám_N	abrahámoviny_N

odlesnit_V	les_N

úmluva_N	mluvit_V

slivovice_N	slíva_N

štěpka_N	štěpkovač_N

překližka_N	klih_N

vyzyvatel_N	výzva_N

buničina_N	buňka_N

prádelna_N	prát_V

mula_N	mezek_N

oko_N	očař_N

Orlickoústecko_N	orlickoústecký_A

pancéřovat_V	pancíř_N

Stowasser_N	sto_C

rozcestí_N	cesta_N

hradubický_A	Pardubice_N

mizina_N	mizet_V

Abrhám_N	Abrahám_N

vévoda_N	voj_N

Borovička_N	borovička_N

václavka_N	Václav_N

ratolístka_N	ratolest_N

vratiprst_N	prst_N

vývěva_N	vát_V

lahodit_V	lahodný_A

znalečné_N	znalec_N

elektronika_N	elektron_NC

hrachovitý_A	hrách_N

smát_V	úsměv_N

žárlit_V	žár_N

integrovat_V	integrál_N

hluchý_A	nahluchlý_A

hnědouš_N	hnědý_A

buben_N	bubínek_N

padesátihaléř_N	haléř_N

ústav_N	stav_N

Řepa_N	řepa_N

korek_N	kůra_N

buněčný_A	buňka_N

plac_N	plácek_N

zářit_V	ozařovač_N

bavlna_N	vlna_N

Pražka_N	Praha_N

holyňský_A	Holyně_N

robit_V	robota_N

Rusava_N	rusý_A

knížepán_N	kníže_N

vláknina_N	vlákno_N

přízemí_N	země_N

únor_N	nořit_V

zlidštět_V	lid_N

pohrůžka_N	pohrozit_V

beznohý_A	noha_N

chlorit_N	chlór_N

nasrat_V	srát_V

koňar_N	kůň_N

Libuš_N	libý_A

úsloví_N	slovo_N

vloni_D	loňský_A

Dačicko_N	dačický_A

záhať_N	hať_N

kostlín_N	kost_N

uspat_V	spát_V

Anuše_N	Anna_N

jednohlasý_A	hlas_N

vděčit_V	děkovat_V

růženín_N	růžový_A

kanava_N	kanafas_N

smrtící_A	smrt_N

edice_N	editorial_N

dominikán_N	Dominik_N

Saša_N	Alexandr_N

blanitý_A	blána_N

tuhý_A	ztuhnout_V

soutok_N	tok_N

psoun_N	pes_N

svatý_A	světec_N

ochoz_N	chodit_V

svatvečer_N	večer_N

chaldejský_A	Chaldea_None

závrt_N	vrt_N

vyprázdnit_V	prázdný_A

heptahydrát_N	hydrát_N

přepis_N	psát_V

Samojed_N	samojedský_A

houba_N	podhoubí_N

nadlidský_A	lidský_A

blokáda_N	blokovat_V

Bonifác_N	Pankrác_N

dostupný_A	stoupat_V

Chovanec_N	chovanec_N

kojeneček_N	kojenecký_A

letorost_N	léto_N

jezule_N	Jezule_None

doopravdy_D	pravda_N

podtyp_N	typ_N

odosobnit_V	osoba_N

důkladný_A	doklad_N

věječka_N	vát_V

zákrut_N	krut_N

doslech_N	slech_N

oviparní_A	oviparie_N

pětitýdenní_A	pět_C

půlkulatý_A	kulatý_A

souš_N	suchý_A

nadporučík_N	poručík_N

husita_N	Hus_N

napočtvrté_D	napoprvé_D

palčivý_A	pálit_V

travina_N	tráva_N

ječný_A	ječmen_N

brkoslav_N	brk_N

přísežný_A	přísahat_V

předpověď_N	předpovídat_V

délka_N	dlouhý_A

prostřihat_V	střihat_V

Dunaj_N	podunajský_AC

kadečka_N	káď_N

sekretář_N	sekretariát_N

optat_V	ptát_V

nijak_D	jak_N

jet_V	jízda_N

vyprávět_V	pravit_V

eféb_N	efebofilie_NC

feminismus_N	femininum_N

Dobroslav_N	dobrý_A

mařit_V	mořit_V

osamět_V	samotný_A

ochutit_V	chuť_N

robě_N	robit_V

službukonající_A	služba_N

meritokratický_A	meritokracie_NC

disciplína_N	interdisciplinární_AC

mžikat_V	okamžik_N

deštník_N	déšť_N

líbánky_N	líbat_V

besarabský_A	Besarábie_N

překrojit_V	krájet_V

poskytnout_V	skýtat_V

přesto_D	přes_R

pirožka_N	piroh_N

kvákat_V	kvák_I

foukat_V	nafukovací_A

zastřešit_V	střecha_N

obdivovat_V	div_N

červený_A	červ_N

brigadýr_N	brigáda_N

páteř_N	bezpáteřník_N

podobor_N	obor_N

triola_N	trio_N

Ivančice_N	Ivan_N

mandel_N	kopa_N

odškodné_N	odškodnit_V

solárium_N	solární_A

střechýl_N	střecha_N

stevard_N	letuška_N

příměr_N	přiměřený_A

veveřice_N	veverka_N

třepetat_V	třepat_V

priorita_N	převor_N

šůsek_N	šos_N

Švec_N	švec_N

romanopisec_N	román_N

liteřina_N	litera_N

kuřárna_N	kuřák_N

bordó_N	Bordeaux_N

dechberoucí_A	brát_V

nějak_D	jak_N

beztřídní_A	třída_N

Bábová_N	Bába_N

sádelnatý_A	sádlo_N

seminarista_N	seminář_N

louskáček_N	louskat_V

plenární_A	plénum_N

teď_D	teďka_D

dluh_N	dluhopis_N

Páv_N	páv_N

panonský_A	Panonie_N

jukebox_N	box_N

zastánce_N	zastat_V

Josefína_N	Josef_N

kafíčkář_N	kafíčko_N

miserere_N	mizerný_A

subdodavatel_N	subdodávka_N

neexistence_N	existence_N

kozoroh_N	koza_N

bezcitný_A	cit_N

roj_N	řeka_N

zádumčivý_A	dumat_V

záhněda_N	hnědý_A

železoprůmysl_N	železo_N

raník_N	ráno_N

Vojtíšek_N	Vojtěch_N

Blansko_N	Blanensko_N

cihla_N	cihelna_N

Ligurie_N	ligurský_A

svíjet_V	vít_V

embolie_N	embolus_N

Ota_N	Otýlie_N

volebný_A	volit_V

nerovnice_N	rovnice_N

proteze_N	protetický_A

Ferenc_N	František_N

herbář_N	herbicid_N

Věroslav_N	Věra_N

kbelík_N	kupa_N

individualismus_N	individuální_A

poťouchlý_A	utuchnout_V

bílkovina_N	bílek_N

chůdy_N	chodit_V

pětinásobek_N	pět_C

nářaďovna_N	nářadí_N

pochoutka_N	chuť_N

remizovat_V	remíza_N

Bundesliga_N	liga_N

Běloves_N	ves_N

slza_N	slzet_V

skelnatý_A	skleněný_A

Kladsko_N	kladský_A

měšec_N	měch_N

paličkovat_V	palice_N

stručný_A	stroužek_N

díkybohu_D	bůh_N

zimoviště_N	zima_N

stihomam_N	stíhat_V

nadehnat_V	hnát_V

pláň_N	planý_A

Arne_N	Arnošt_N

kolísat_V	kolébat_V

přitažlivý_A	přitahovat_V

afrikán_N	Afrika_N

Ježíš_N	jezuita_N

necičky_N	necky_N

peřej_N	práh_N

konzument_N	konzumovat_V

hodlat_V	hodit_V

předposlední_A	poslední_A

upomínat_V	paměť_N

bubák_N	bu_N

mikronéský_A	Mikronésie_N

štědrovečerní_A	štědrodenní_A

růst_N	porost_N

kůra_N	kůrovec_N

zkrut_N	krut_N

pozice_N	opozice_N

odvšivit_V	veš_N

struhátko_N	strouhat_V

zbůhdarma_D	bůh_N

magie_N	mág_N

banda_N	bandita_N

strana_N	odstranit_V

neptunium_N	Neptun_N

povolební_A	volební_A

oteplováky_N	tepláky_N

Kobyly_N	kobyla_N

mužický_A	mužik_N

bezhrbý_A	hrb_N

Petříčková_N	Petr_N

reference_N	referát_N

zemlbába_N	bába_N

lhostejný_A	stejný_A

poživatina_N	požít_V

drsnosrstý_A	srst_N

existencialistický_A	existencialismus_N

přítlak_N	přetlak_N

formaldehyd_N	aldehyd_N

Eros_N	erós_N

zavdat_V	dát_V

Martinů_N	Martin_N

přisadit_V	sadit_V

usamostatnit_V	samostatný_AC

iont_N	ionosféra_N

Sychrov_N	sychravý_A

lahvinka_N	láhev_N

upažit_V	paže_N

Kuřátko_N	kuřátko_N

Belgie_N	belgický_A

střemhlavý_A	střemhlav_D

skvost_N	skvoucí_A

rozpor_N	přít_V

žandarmeristický_A	žandarmerie_N

šetřit_V	šetrný_A

identický_A	identita_N

skin_N	skinhead_NC

brahmín_N	bráhmanismus_N

rozlišovač_N	rozlišovat_V

násoska_N	sosák_N

fach_N	foch_N

bašta_N	baštýř_N

struktura_N	infrastruktura_NC

mudrosloví_N	moudrý_A

jaksi_D	jak_N

Strejček_N	strejček_N

žoldnéř_N	žold_N

závěj_N	vát_V

očumovat_V	čumět_V

Kobylnice_N	kobyla_N

dav_N	dávit_V

kápnout_V	kapat_V

dvousetkoruna_N	koruna_N

chytristika_N	chytrý_A

nápěv_N	pěvec_N

tichošlápek_N	šlapat_V

cukrblik_N	cukr_N

žmoulat_V	žmolit_V

hrdý_A	hrouda_N

syntaktický_A	syntax_N

klient_N	klientela_N

Modrava_N	modrý_A

paralýza_N	paralytik_N

Janský_N	Janův_A

Irčan_N	Irsko_N

žeberní_A	žebro_N

šach_N	šachovnice_N

Metud_N	Metoděj_N

stupňovitý_A	stupeň_N

seriál_N	série_N

letopis_N	léto_N

Odysseus_N	odysea_N

medvěd_N	med_N

větrat_V	vítr_N

babišovec_N	Babiš_N

yorský_A	York_N

Šmak_N	šmak_N

houstonský_A	Houston_N

winnipežský_A	Winnipeg_N

Bartoň_N	Bartoloměj_N

známý_A	znát_V

drezura_N	drezírovat_V

vleže_D	leh_N

viržinko_N	Virginie_N

popruh_N	pruh_N

prožrat_V	žrát_V

Bukovina_N	buk_N

ustlat_V	stlát_V

hlavoun_N	hlava_N

poušť_N	poustevník_N

unašeč_N	unést_V

bible_N	biblizmus_N

renta_N	rentiér_N

vektor_N	zvektorizovat_V

zamítat_V	mést_V

ostraha_N	střežit_V

hegemonismus_N	hegemonie_N

malovat_V	malířství_N

kvocient_N	kvóta_N

pěticiferný_A	ciferný_A

tisícikoruna_N	koruna_N

metat_V	mést_V

flotila_N	flota_N

zhoubovatět_V	houba_N

celulární_A	multicelulární_AC

nadučitel_N	učitel_N

točna_N	točit_V

molybden_N	molybdenit_N

dolomit_N	lomit_V

zavináč_N	závin_N

mocipán_N	moc_D

čepec_N	čapka_N

chrchel_N	hnis_N

přespat_V	spát_V

Benda_N	Beneš_None

anestetikum_N	anestezie_N

žatva_N	žeň_N

princ_N	princezna_N

Laďka_N	Vlaďka_N

železňák_N	železo_N

Šnábl_N	Schnabelová_N

závit_N	vít_V

Litva_N	Litevec_N

slunit_V	slunce_N

nadace_N	nadat_V

diabetes_N	diabetolog_N

rafinovat_V	rafinérie_N

Malajsko_N	Malajsie_N

zdírat_V	dřít_V

nadkritický_A	kritický_A

Sašenka_N	Alexandr_N

nástupiště_N	stoupat_V

carica_A	car_N

šarmantní_A	šarm_N

Hradec_N	hrad_N

Tonžan_N	Tonga_N

Michaelka_N	Michal_N

romistika_N	Rom_N

barborka_N	Barbora_N

pánbíček_N	pánbůh_N

fousatý_A	vous_N

zlidštit_V	lid_N

přívod_N	přivést_V

zpravidla_D	pravidlo_N

Komín_N	komín_N

rozpomínat_V	paměť_N

ochmelka_N	chmel_N

třepit_V	třepat_V

bdít_V	budit_V

Podněstří_N	Dněstr_N

buten_N	butan_N

puntičkář_N	puntík_N

dopovat_V	dopink_N

zoborožec_N	zoboun_N

kukla_N	zakuklenec_N

uvozhřený_A	vozher_N

přídavný_A	přidat_V

bankomat_N	banka_N

praktický_A	praxe_N

zpyt_N	zpyták_N

nosohltan_N	nos_N

výstižný_A	vystihnout_V

premiér_N	vicepremiér_NC

holenek_N	hoch_N

předloktí_N	loket_N

argumentátor_N	argumentovat_V

pohůnek_N	pohnat_V

Sparta_N	Spartakus_None

sushi_N	suši_N

obuv_N	obout_V

průchozí_A	projít_V

přemet_N	přemítat_V

předevčírem_D	včera_D

avunkulokální_A	avunkulokalita_N

vždy_D	navždy_D

žeň_N	žnout_V

drobet_N	drobit_V

leprózní_A	lepra_N

Nový_N	nový_A

Havlová_N	Havel_N

příhra_N	hra_N

vehnat_V	hnát_V

chvátat_V	chvat_N

prvovolič_N	volič_N

strategie_N	stratég_N

hliniště_N	hlína_N

biják_N	biograf_N

kamenina_N	kámen_N

nakonec_D	konec_N

kanout_V	kanit_V

dělit_V	díl_N

velebit_V	velebníček_N

Štěpán_N	Štefan_N

ranhojič_N	rána_N

Blažeková_N	Blažej_N

sborná_N	sbor_N

výchozí_A	vyjít_V

prvohory_N	čtvrtohory_N

přesladký_A	sladký_A

tvrdý_A	tvrdohlavý_AC

stěžej_N	stěžeň_N

palist_N	list_N

buran_N	Búr_N

sedmidenní_A	denní_A

jízlivý_A	jizlivost_N

Mendelssohn_N	Mendel_N

akordeon_N	akord_N

řvát_V	řev_N

riziko_N	riskovat_V

propsat_V	psát_V

slunečko_N	slunce_N

trihydrát_N	hydrát_N

odboj_N	boj_N

ujasnit_V	jasný_A

hantec_N	hantýrka_N

klimakterium_N	klinika_N

slout_V	slýchat_V

potrubí_N	trouba_N

demise_N	mise_N

nářez_N	řezat_V

stydnout_V	studený_A

čelist_N	čelo_N

prát_V	prádelna_N

lučištník_N	luk_N

Poruba_N	rubat_V

zdát_V	dít_V

pitomý_A	píce_N

příděl_N	přidělenkyně_N

alibismus_N	alibi_N

Hornorakušan_N	Rakušan_N

zlatinký_A	zlatý_N

Bask_N	Baskicko_N

profánní_A	profanace_N

poškolák_N	školák_N

pobídka_N	nabídka_N

všudybyl_N	všude_D

šev_N	šít_V

gymnaziální_A	gymnázium_N

kramář_N	krám_N

Žirafa_N	žirafa_N

vrata_N	vrátka_N

dochvilný_A	chvíle_N

bezuzdný_A	uzda_N

hnedky_D	hnedle_D

prstoklad_N	prst_N

doposud_D	dosavadní_A

dusnatý_A	dusno_N

krypton_N	krypta_N

pešek_N	pěšky_D

čítárna_N	čtení_N

vzpažit_V	paže_N

netopýr_N	pero_N

jednonohý_A	noha_N

subtropy_N	tropy_N

obratiště_N	obrátit_V

příchuť_N	chuť_N

tuze_D	tužit_V

kolozubý_A	zub_N

vytmavit_V	tmavě_D

zatraktivnit_V	atraktivní_A

dvoustopý_A	stopa_N

plodenství_N	plod_N

Karol_N	Karolína_N

vzpomínat_V	paměť_N

Bosňačka_N	bosenský_A

báj_N	báječný_A

sedlák_N	sedlo_N

kleště_N	klestit_V

napolo_D	polo_None

lstivý_A	lest_N

peklo_N	pekelný_A

Podyjí_N	Dyje_N

přehlídka_N	přehlédnout_V

píchat_V	píchačky_N

padrť_N	drť_N

čtvrtička_N	čtvrtka_C

ožíhat_V	žíhat_V

Václavský_N	Václav_N

Novák_N	nový_A

boulovatý_A	boule_N

šetřílek_N	šetřit_V

finále_N	finalistka_N

smýčit_V	smyk_N

červeň_N	červený_A

Holub_N	holub_N

Washington_N	washingtonský_A

zrcátko_N	zrcadlo_N

bezúročný_A	úrok_N

odění_N	odít_V

povíce_D	vícero_N

počty_N	počítat_V

sympaťák_N	sympatický_A

novelizovat_V	novela_N

bobule_N	bob_N

kalendář_N	koleda_N

nadsázka_N	sázka_N

podhradí_N	hrad_N

Hřeben_N	hřeben_N

fajn_A	rafinovat_V

škvrňátko_N	škvrně_N

Blanensko_N	Blansko_N

gotajský_A	gothajský_A

ňadratý_A	ňadra_N

ulejvárna_N	ulejváctví_N

záhodný_A	zahodit_V

dvořit_V	dvůr_N

závaží_N	závažný_A

salicylalkohol_N	alkohol_N

neduživý_A	neduh_N

Zakavkazsko_N	Kavkaz_N

schnout_V	suchý_A

Božík_N	Bohumír_N

pikel_N	pikle_N

pípat_V	pí_N

podprostor_N	prostor_N

Toskánec_N	Toskánsko_N

vozidýlko_N	vozidlo_N

shakespearovský_A	Shakespeare_N

relikvie_N	relikviář_N

ježatý_A	ježek_N

Věrunka_N	Věra_N

vědma_N	vědět_V

mrznout_V	zmrznout_V

úleva_N	ulevit_V

páchat_V	prostopášný_AC

klepat_V	překlep_N

blasfémie_N	blasfemický_A

emerzní_A	submerzní_A

běs_N	běsnit_V

Slavík_N	slavík_N

žabař_N	žába_N

ořeší_N	ořech_N

paví_A	páv_N

smutek_N	smutný_A

Anča_N	Anna_N

obžalovaný_N	obžalovat_V

divoženka_N	žena_N

kamenět_V	kámen_N

odmazat_V	mazat_V

záchvěv_N	zachvívat_V

beneficium_N	benefiční_A

šištice_N	šiška_N

spletitý_A	splést_V

sklizeň_N	sklidit_V

zdůvodnit_V	důvod_N

husopas_N	husa_N

travka_N	tráva_N

debatér_N	debata_N

skalnička_N	skála_N

vydře_N	vydra_N

období_N	doba_N

soumrak_N	mrak_N

legranda_N	legrace_N

pochcat_V	chcát_V

princezna_N	princ_N

sousoší_N	socha_N

pavučina_N	pavouk_N

Čtvrtek_N	čtvrtek_N

jidáš_N	Jidáš_N

těšit_V	tišit_V

akademie_N	akademizmus_N

publicista_N	publikovat_V

hajzldědek_N	hajzl_N

vratislavský_A	Vratislav_N

lub_N	loupat_V

Slapy_N	slap_N

tovaryš_N	továrna_N

komise_N	komitét_N

embolus_N	embolie_N

umření_N	umřít_V

žluknout_V	žlutý_A

Znojmo_N	Znojemsko_N

hříbek_N	hřib_N

fičet_V	fičák_N

mongol_N	Mongolsko_N

Džibutsko_N	Džibuti_N

rádium_N	rádiový_A

Lukin_N	Lukáš_N

jitřit_V	jitro_N

hniloba_N	hnít_V

platforma_N	forma_N

Bořislav_N	Borislav_N

jařina_N	jaro_N

mrazivo_D	mráz_N

vidloroh_N	vidle_N

děrovat_V	díra_N

jádřinec_N	jádro_N

blogger_N	blogovat_V

maměnka_N	matka_N

Páral_N	párat_V

kanibalizmus_N	kanibalský_A

kvantita_N	kvantový_A

voda_N	vodopád_NC

jikrnáč_N	jikra_N

chytračit_V	chytrý_A

šestinedělí_N	neděle_N

vřešťan_N	vřískot_N

pařan_N	pařit_V

kukuč_N	koukat_V

expert_N	expertiza_N

Vrchlický_N	vrch_N

elektrárna_N	elektřina_N

Krušnohoří_N	krušnohorský_A

loděnice_N	loď_N

vepř_N	zelí_N

jako_D	jak_N

topolanský_A	Topolany_None

černozem_N	zem_N

hrdopýšek_N	hrdý_A

zpozornět_V	pozorování_N

bagatelizovat_V	pakatel_N

kontokorent_N	konto_N

studénecký_A	Studénka_N

výše_N	zvyšovat_V

mašinfíra_N	mašina_N

přiléhat_V	ležet_V

Sudoměř_N	soud_N

Poodří_N	Odra_N

hřejivý_A	hřát_V

oharek_N	hořet_V

dobrat_V	brát_V

kuře_N	kur_N

moto_N	motto_N

soudobý_A	doba_N

poručenec_N	poručník_N

makulatura_N	makulář_N

ztrojnásobit_V	násobit_V

ponožka_N	noha_N

snožit_V	noha_N

procentuální_A	procento_N

Magda_N	Magdaléna_N

hnětýnka_N	hníst_V

podkategorie_N	kategorie_N

kolega_N	kolegialita_N

ušanka_N	ucho_N

záprsí_N	prs_N

obchvat_N	obchvátit_V

ospravedlnit_V	spravedlnost_N

bezvětrný_A	větrný_A

vymetat_V	mést_V

kopí_N	kopiník_N

vylizovat_V	lízat_V

zonální_A	zóna_N

člen_N	dvojčlenný_A

Rozkoš_N	rozkoš_N

vynikat_V	vznikat_V

odlesk_N	lesk_N

bezcelní_A	clo_N

komentovat_V	komentář_N

úpis_N	upsat_V

Kadlčák_N	Kadlec_N

krmelec_N	krmit_V

agnostik_N	agnosticismus_N

tříslabičný_A	slabičný_A

Štefek_N	Štěpán_N

účet_N	účetní_N

namouvěru_D	věru_D

kalkulovat_V	kalkulačka_N

ordálie_N	ortel_N

parasympatický_A	sympatický_A

záprstní_A	prst_N

litovelský_A	Litovelsko_N

sestávat_V	stávat_V

nazad_D	zadní_A

adamita_N	Adam_N

túra_N	turista_N

evangelium_N	evangelík_N

nadprodukce_N	produkce_N

budoucí_A	být_V

nálož_N	naložit_V

Joník_N	Jonáš_N

důl_N	dolní_A

barzoj_N	brzy_D

zchromit_V	chromit_N

zlatitý_A	zlatý_N

revolver_N	revoluce_N

bedlivý_A	bdít_V

buržoazní_A	buržuj_N

všední_A	den_N

nadchod_N	chodit_V

Bechyně_N	Bechyňsko_N

vzdech_N	dech_N

vřeštět_V	vřískot_N

obecenstvo_N	obecný_A

klevetnictví_N	klevetník_N

halas_N	hlas_N

jerišský_A	Jericho_None

zdražit_V	drahý_A

strýc_N	strejda_N

Poohří_N	Ohře_N

přechodnice_N	přechodník_N

bezkonkurenční_A	konkurenční_A

Jihoameričan_N	Američan_N

ježura_N	ježek_N

zamlada_D	mládí_N

idiomatika_N	idiom_N

neodbytný_A	odbýt_V

dynovačka_N	šlehačka_N

doptat_V	ptát_V

odtok_N	tok_N

rtěnka_N	ret_N

kameniště_N	kámen_N

půltón_N	tón_N

konstituovat_V	konstitutivní_A

concerto_N	koncert_N

ostrý_A	ostří_N

spiklenec_N	spiknout_V

konev_N	konvice_N

poseroutka_N	posera_N

kyrys_N	kyrysar_N

recepis_N	psát_V

Miky_N	Mikuláš_N

lymfa_N	lymfocyt_NC

železisko_N	železo_N

Bára_N	Barbora_N

zelí_N	vepř_N

hostel_N	hotel_N

prachatý_A	prachy_N

septik_N	sepse_N

klientela_N	klient_N

mikrob_N	mikrobiologie_N

navíjet_V	vít_V

porub_N	rubat_V

Jitka_N	Judita_N

portfej_N	portfolio_N

Kadlčík_N	Kadlec_N

ranař_N	rána_N

Urbánková_N	Urban_N

předtisk_N	tisk_N

junák_N	jinoch_N

pop_N	Popov_None

perla_N	perlivý_A

sedmice_N	sedmička_N

jakpak_D	jak_N

nesouhlas_N	hlas_N

hlaveň_N	hlava_N

obrace_D	obrátit_V

roztodivný_A	divný_A

pasé_A	pasáž_N

smyčec_N	smyk_N

kapesník_N	kapsa_N

mamina_N	matka_N

waleský_A	Wales_N

obšoustník_N	šoustat_V

societa_N	sociální_A

labuť_N	labutí_A

estetično_N	estetický_A

ovzduší_N	vzduch_N

seminárka_N	seminář_N

lázeňský_A	lázně_N

Renata_N	Renáta_N

popravdě_D	pravda_N

ponožtička_N	ponožka_N

sympatikus_N	sympatický_A

prověrka_N	prověřovat_V

zavodnit_V	voda_N

ňadro_N	záňadří_N

neofašistický_A	fašismus_N

zplna_D	plný_A

líný_A	lenost_N

pyrit_N	chalkopyrit_N

štítonoš_N	štít_N

silnoproud_N	proud_N

strašpytel_N	strašidlo_N

cizota_N	cizí_A

zeť_N	snacha_N

bobkovišeň_N	višeň_N

ódium_N	odiózní_A

někdejší_A	někdy_None

píka_N	pikador_N

jarmark_N	jarmarečník_N

utuchat_V	tuchnout_V

mandarinka_N	mandarín_N

octovatět_V	ocet_N

Halabala_N	halabala_D

nalézt_V	nálezce_N

vybíjená_N	vybít_V

cizoložit_V	cizí_A

půllán_N	lán_N

proprat_V	prát_V

spermicid_N	sperma_N

souputník_N	poutník_N

protkat_V	tkát_V

zpopelnit_V	popel_N

amfiteatrální_A	amfiteátr_N

suši_N	sushi_N

jabčák_N	jablko_N

eliptický_A	elipsa_N

tam_D	tamější_A

daněk_N	daňče_N

Arno_N	Arnošt_N

Tunisan_N	Tunisko_N

okolí_N	kolo_N

užovka_N	uher_N

býložravý_A	žravý_None

skolit_V	kolbiště_N

veselohra_N	hra_N

facka_N	fackovné_N

vzdoušek_N	vzduch_N

díra_N	děrovačka_N

Mráz_N	mráz_N

bezhvězdný_A	hvězdný_A

spokojit_V	pokoj_N

Magdaléna_N	Magda_N

zánětlivý_A	zánět_N

fotr_N	fotrovatět_V

Kout_N	kout_N

modernizovat_V	moderní_A

zabočit_V	bok_N

úplata_N	uplatit_V

panel_N	infopanel_NC

drakobijce_N	drak_N

říhat_V	říje_N

disciplinárka_N	disciplína_N

podbradek_N	brada_N

blonďatý_A	blondýna_N

krupobití_N	kroupa_N

potměšilý_A	tma_N

akvaristika_N	akvárium_N

cín_N	Cínovec_N

zbožný_A	bůh_N

útlý_A	křehký_A

povel_N	velet_V

stěh_N	stěžeň_N

rozpis_N	psát_V

důležitý_A	náležitý_A

Marathon_N	Marathón_N

králický_A	Králíky_N

mimčo_N	miminko_N

průraz_N	razit_V

předúprava_N	úprava_N

náhrobek_N	hrob_N

vyžíhat_V	žíhat_V

Pavlína_N	Pavel_N

vpravo_D	pravý_A

hlávkovat_V	hlava_N

Stalingradec_N	Stalingrad_None

Olomučany_N	Olomouc_None

tele_N	teletník_NC

Bětulinka_N	Alžběta_N

výkal_N	kal_N

náves_N	ves_N

globalizovat_V	globalistický_A

vpadat_V	padat_V

labilní_A	lapsus_N

pěch_N	pěšky_D

alergen_N	alergie_N

auťák_N	auto_N

akcie_N	akce_N

znárodnit_V	národ_N

ostříž_N	ostrý_A

hiragana_N	kana_N

pálit_V	spáleniště_N

dovtípit_V	vtip_N

příkop_N	kopat_V

slzet_V	slza_N

Pětikostelí_N	pět_C

drobet_D	drobit_V

vilník_N	vilný_A

sten_N	sténat_V

želé_N	želírovat_V

Persie_N	perský_A

nalhat_V	lhát_V

blatník_N	bláto_N

Středoameričan_N	Američan_N

přibíhat_V	běhat_V

hlemýždí_A	hlemýžď_N

zanedbat_V	dbát_V

optimismus_N	optimalizovat_V

odvěký_A	věk_N

podlaží_N	podlaha_N

klíh_N	kližka_N

souvěký_A	věk_N

štědrodenní_A	štědrovečerní_A

přinožit_V	noha_N

bělet_V	bílý_A

pokožka_N	kůže_N

jed_N	jedovatý_A

toxin_N	toxický_A

úvěr_N	uvěřit_V

angorák_N	angorizmus_N

dvouhlavý_A	hlava_N

lanýž_N	laň_N

pronárod_N	národ_N

dvůr_N	dvořan_N

vtipálek_N	vtip_N

děva_N	děvče_N

separatista_N	separace_N

bibličtina_N	bible_N

oteplit_V	teplý_A

skrut_N	krut_N

přeprodej_N	přeprodejce_N

Erasmus_N	erasmák_N

posmívat_V	smát_V

hrbolatý_A	hrb_N

pomezí_N	mez_N

dřívější_A	dříve_D

baltofinský_A	finský_A

nebohý_A	nebožtík_N

upřednostnit_V	přednost_N

věčnověký_A	věk_N

závrať_N	vrátit_V

Antiocheia_N	Antiochos_N

primán_N	primát_N

Hnětkovský_N	hníst_V

cukrle_N	cukr_N

podšálek_N	šálek_N

žurnál_N	žurnalistka_N

expremiér_N	premiér_N

půlmaraton_N	maraton_N

médium_N	mediální_A

dřevnatý_A	dřevěný_A

muchomůrka_N	moucha_N

stačit_V	statek_N

ušmudlánek_N	ušmudlaný_A

štikozubec_N	štika_N

půhon_N	pohnat_V

měšťan_N	město_N

poliklinika_N	klinika_N

pláteník_N	plátno_N

Jura_N	Jiří_N

vepřové_N	vepř_N

Slavín_N	sláva_N

límec_N	lem_N

zmačkat_V	mačkat_V

realizmus_N	reálný_A

zpropadený_A	propadnout_V

denaturák_N	denaturovaný_A

funebrální_A	funebrák_N

butylalkohol_N	alkohol_N

dumný_A	dumat_V

Markyta_N	Markéta_N

bájesloví_N	bajka_N

emise_N	mise_N

jednobřitý_A	břit_N

čtivý_A	číst_V

objektiv_N	objektivizovat_V

rejdit_V	rejdy_N

Frankfort_N	Frankfurt_N

trochu_D	trocha_N

brňavka_N	brnět_V

nádor_N	nadřít_V

Moldova_N	Moldava_None

doslova_D	slovo_N

desetitisíc_N	desetitisícina_N

zejména_D	jméno_N

puškohled_N	puška_N

alfa_N	alef_N

hloubit_V	hluboký_A

sesekat_V	sekat_V

prcat_V	šprcka_N

bělohlavý_A	bílý_A

kyrysar_N	kyrysník_N

jinak_D	jiný_A

kastrůlek_N	kastrol_N

boltcovitka_N	boltec_N

Věněk_N	Věnek_N

obmysl_N	úmysl_N

disparita_N	disparátní_A

uzda_N	uzdečka_N

zblo_N	stéblo_N

nadlouho_D	dlouho_D

třešeň_N	třešně_N

Újezd_N	újezd_N

bezbřehý_A	břeh_N

subtropický_A	subtropy_N

vraný_A	vrána_N

nenávidět_V	vidět_V

kominík_N	komín_N

bláznoství_N	blázen_N

koninec_N	kůň_N

píšťala_N	pištět_V

lánský_A	Lány_N

Mikeš_N	Mikuláš_N

turismus_N	turistika_N

snožmo_D	noha_N

nasládlý_A	sladký_A

sbíhat_V	běhat_V

kapitola_N	kapitál_N

nadobyčej_D	obyčej_N

předsíň_N	síň_N

čest_N	ctižádost_N

šňupat_V	šnuptychl_N

zákop_N	kopat_V

svatyně_N	svatý_A

ožrat_V	žrát_V

plž_N	plazit_V

roztok_N	téct_V

sulfoxid_N	oxid_N

vejčitý_A	vejce_N

hledí_N	hledět_V

pětitisícovka_N	pět_C

přípona_N	spona_N

bastion_N	bašta_N

Plašil_N	plachý_A

ryba_N	Ryba_N

Duchcovan_N	duchcovský_A

mateří_A	matka_N

doprat_V	prát_V

kulovitý_A	koule_N

pracující_N	pracovat_V

pobřišnice_N	břicho_N

současný_A	čas_N

svatebčan_N	svatba_N

napodruhé_D	napoprvé_D

koprodukce_N	produkce_N

berný_A	brát_V

báze_N	bazální_A

omeleta_N	amoleta_N

třídenní_A	denní_A

kompletovat_V	kompletní_A

soustrast_N	strast_N

Johana_N	Jana_N

hrabky_N	hrábě_N

Odysseia_N	odysea_N

zálesák_N	les_N

ukrajina_N	Ukrajina_N

pitivo_N	pít_V

nuzota_N	nouze_N

Libuše_N	libý_A

padoucnice_N	padat_V

mulat_N	mul_N

Mikša_N	Mikuláš_N

bezolovnatý_A	olovo_N

doslov_N	slovo_N

bezpráví_N	právo_N

elektro_A	elektrikář_N

zvýhodnit_V	výhoda_N

abortus_N	abortivní_A

pijan_N	pít_V

zeslabit_V	slabě_D

Jadran_N	jaderský_A

reálný_A	realita_N

tkalcovna_N	tkadlec_N

krupice_N	kroupa_N

oktrojovat_V	oktrojírka_N

Antonie_N	Antonín_N

umožnit_V	možný_A

slibotechna_N	slib_N

březovka_N	bříza_N

zvukotěsný_A	těsný_A

vývod_N	vyvádět_V

atlant_N	Atlas_N

podzim_N	zima_N

krojit_V	krájet_V

bikros_N	kros_N

jehličí_N	jehla_N

mužatka_N	muž_N

Franěk_N	František_N

rozeštvat_V	štvát_V

Stromovka_N	stromovka_N

chlebnatý_A	chléb_N

vyjádřit_V	jádro_N

člověkoden_N	člověk_N

mela_N	mlít_V

Hela_N	Helena_N

Tetčice_N	teta_N

železobaron_N	železo_N

řvoun_N	řvát_V

houbařství_N	houba_N

nadít_V	dít_V

hrob_N	pohřeb_N

burundský_A	Burundi_N

jednotlivý_A	jednotný_A

lučiště_N	luk_N

přenádherný_A	nádherný_A

lze_V	lehký_A

europium_N	Europa_N

půtka_N	potkat_V

Tatry_N	tatranský_A

hacking_N	hacker_N

bachyně_N	machna_N

týden_N	den_N

prvorodička_N	rodička_N

tíž_N	těžký_A

zdrsnit_V	drsný_A

nadrovina_N	rovina_N

odvar_N	vařit_V

Judea_N	judaismus_N

děloha_N	lože_N

Svoboda_N	svoboda_N

třít_V	trdliště_N

zřitel_N	zřít_V

vláčet_V	vléct_V

bezpředmětný_A	předmět_N

přídech_N	dech_N

muší_A	moucha_N

Tonka_N	Tonda_N

Helena_N	Elena_N

vzdušno_N	vzduch_N

pokec_N	kecat_V

recepční_A	recepce_N

Pomoraví_N	Morava_N

kočovat_V	kočí_N

odsluní_N	slunce_N

prostřít_V	obestřít_V

paradigmatika_N	paradigma_N

blivajz_N	blít_V

bezvládí_N	vláda_N

bankrot_N	banka_N

Barunka_N	Barbora_N

sdostatek_D	dostatek_N

pavouk_N	pavučina_N

kivi_N	kiwi_N

katalog_N	zkatalogizovat_V

mrtvola_N	mrtvý_A

pastevec_N	pást_V

dhácký_A	Dháka_N

Aram_N	aramejský_A

Liboš_N	Libuše_N

odtamtud_D	od_R

podobat_V	doba_N

odůvodnit_V	důvod_N

jídlonoš_N	jídelna_N

podřád_N	řád_N

bramborovina_N	brambořiště_N

průlet_N	let_N

bazilární_A	báze_N

přeslech_N	slech_N

lišej_N	lišaj_N

závětří_N	vítr_N

předškolní_A	školní_A

kotva_N	kotviště_N

souška_N	suchý_A

zkrátka_D	zakrátko_D

šrotovné_N	šrot_N

Vilém_N	Vilemína_N

Burgunďan_N	Burgundsko_N

tečka_N	dvojtečka_NC

čechoamerický_A	Čechoameričan_N

teorém_N	teorie_N

přadlena_N	příst_V

naposledy_D	sled_N

Karlov_N	Karel_N

pít_V	opájet_V

exministr_N	ministr_N

Věruška_N	Věra_N

Úpa_N	Úpice_N

vanilovník_N	vanilka_N

Vesnin_N	vesna_N

buřtguláš_N	buřt_N

pakůň_N	kůň_N

legitka_N	legitimace_N

plochý_A	plocha_N

břichatka_N	břicho_N

důvod_N	vést_V

oštěp_N	štípat_V

institut_N	institucionální_A

přístup_N	stoupat_V

pětka_N	pět_C

virus_N	zavirovat_V

marno_D	marně_D

Severoameričan_N	Američan_N

Zajíc_N	zajíc_N

kmen_N	soukmenovec_N

kule_N	koule_N

odysea_N	Odysseus_None

ponížit_V	nízký_A

přesnídávka_N	snídaně_N

svářet_V	svar_N

obličej_N	líce_N

roh_N	jednorožec_N

scéna_N	inscenace_N

předehra_N	hra_N

máslovník_N	máslo_N

prohoz_N	hodit_V

hrachor_N	hrách_N

polykat_V	lokat_V

navlas_D	vlas_N

područí_N	ruka_N

nabíhat_V	běhat_V

barevný_A	barva_N

prozaik_N	próza_N

akvarijní_A	akvárium_N

vystružit_V	výstružník_N

kombinačka_N	kombinovat_V

žvejkat_V	žvýkat_V

nultý_A	nula_N

podezřívat_V	podezření_N

Alžběta_N	Bětuška_N

denodenní_A	den_N

Míša_N	Michal_N

Kosovan_N	Kosovo_None

copánek_N	cop_N

hoření_A	hořet_V

předvolební_A	volební_A

vzpřimovat_V	vzpřímený_A

Kosmas_N	kosmos_N

luna_N	novoluní_NC

začít_V	začátek_N

beryllium_N	beryl_N

včelomorka_N	včela_N

podpatek_N	pata_N

draslík_N	drásat_V

Hliník_N	hlinka_N

unionismus_N	unie_N

bohulibý_A	libý_A

starý_A	zastaralý_A

kraťasy_N	krátký_A

pacholek_N	pachole_N

Bukovany_N	buk_N

keř_N	křoví_N

šumař_N	šumět_V

Říha_N	Řehoř_N

execírovat_V	execírka_N

výměra_N	vyměřit_V

mnohde_D	mnoho_C

zápěstí_N	pěst_N

Gábina_N	Gabriel_N

kamének_N	kámen_N

oblý_A	oblouk_N

osudí_N	osud_N

kozodoj_N	koza_N

jedenáctidenní_A	denní_A

zvířectvo_N	zvíře_N

penze_N	penzijní_A

zpronevěřit_V	věřit_V

Rostislav_N	růst_N

chám_N	chámovod_N

obrnit_V	brnění_N

spodní_A	pod_R

Škopek_N	škopek_N

olezlý_A	lézt_V

pas_N	pasport_N

sun_N	sunout_V

Jozef_N	Josef_N

slečna_N	šlechtic_N

Běta_N	Alžběta_N

půlhodina_N	hodina_N

roztoč_N	točit_V

vyslepičit_V	slepice_N

nadpoloviční_A	poloviční_A

levo_A	levobok_NC

jeskyňář_N	jeskyně_N

hibernakulum_N	hibernace_N

pikolo_N	pikola_N

Dvořáčková_N	Dvořáková_N

stanovit_V	stan_N

kalkulátor_N	kalkulačka_N

sídlo_N	sedět_V

člověčenstvo_N	člověk_N

Antiochie_N	Antiochos_N

proutí_N	prut_N

splávek_N	splavný_A

čistoskvoucí_A	skvoucí_A

inaugurovat_V	augur_N

bratr_N	brácha_N

majstrštyk_N	majstr_N

Jablonné_N	jablko_N

Kameruňanka_N	Kamerun_N

krajíc_N	krájet_V

tíseň_N	tísnit_V

pozadí_N	záda_N

hubeňour_N	hubit_V

dále_D	další_A

věrolomný_A	lomit_V

převlek_N	vléct_V

hampejz_N	hampejznice_N

podruh_N	druh_N

kalhotky_N	kalhoty_N

krejčí_N	krájet_V

moravista_N	moravský_A

Emílie_N	Emil_N

půltucet_N	tucet_N

stověžatý_A	věž_N

Javorník_N	javor_N

blaze_D	blažený_A

věřící_N	věřit_V

servírovat_V	servis_N

hlubotisk_N	tisk_N

nohejbal_N	noha_N

Rak_N	rak_N

bělírna_N	bělidlo_N

záňadří_N	ňadro_N

podkoní_N	kůň_N

předvídat_V	vídat_V

chroupat_V	chrupka_N

naskrze_D	skrz_R

bažina_N	bahno_N

hrudník_N	hruď_N

hrnout_V	souhrn_N

Máří_N	Marie_N

prst_N	prsteník_N

urbanismus_N	Urban_N

soubor_N	brát_V

válec_N	válet_V

převzácný_A	vzácný_A

sendvič_N	sendvičovač_N

němčina_N	Německo_N

zkraje_D	kraj_N

prvok_N	prvek_N

Čuchonec_N	čuchonský_A

duplikovat_V	duplicita_N

uzákonit_V	zákon_N

převislý_A	převis_N

masáž_N	masírovat_V

Kristus_N	Kryštof_N

popichovat_V	popíchnout_V

siloměr_N	silný_A

živočich_N	čich_N

velvarský_A	Velvary_N

vždycky_D	vždy_None

jenom_D	nejen_D

Aristoteles_N	aristotelizmus_N

právě_D	právo_N

předpremiéra_N	premiéra_N

Olympie_N	olympiáda_N

narkóza_N	narkotikum_N

Hroznětín_N	hrozen_N

plácat_V	placka_N

bříza_N	březen_N

opevnit_V	pevný_A

orient_N	orientovaný_A

sezona_N	sezónní_A

půjčovní_A	půjčovné_N

recenze_N	zrecenzovat_V

vtípek_N	vtip_N

zbíhat_V	běhat_V

záběr_N	zabrat_V

Ondráš_N	Ondřej_N

výkrut_N	krut_N

Šváb_N	švábský_A

židokřesťan_N	křesťan_N

popozítří_D	zítra_D

pěticípý_A	pět_C

týt_V	tloustnout_V

tolerance_N	tolerovat_V

horký_A	hořet_V

odpadek_N	padat_V

útlum_N	utlumit_V

huť_N	kutat_V

poptat_V	ptát_V

skrček_N	krčit_V

Katalánsko_N	katalánština_N

křemen_N	křemík_N

Sláva_N	slavský_A

roštěnka_N	rošt_N

klih_N	kližka_N

Bzdinka_N	bzdít_V

sdírat_V	dřít_V

nízko_D	níže_N

shromaždiště_N	shromažďovat_V

sonatina_N	sonáta_N

jistý_A	zajisté_T

zauhlit_V	uhlí_N

hacknout_V	hacker_N

klíště_N	klestit_V

křísnout_V	křesat_V

frazém_N	frazeologie_NC

přídavek_N	přidat_V

acetaldehyd_N	aldehyd_N

plivat_V	plíva_N

topeniště_N	topírna_N

oxidáza_N	oxid_N

Opočno_N	Opočenský_N

teoretik_N	teorie_N

exšéf_N	šéf_N

alžbětinka_N	Alžběta_N

rozmezí_N	mez_N

Žabovřesky_N	žába_N

doposavad_D	dosavadní_A

konsekuce_N	konsekutivně_D

kose_N	kosý_A

předaleko_D	daleko_D

glukagon_N	glukóza_N

napospas_D	pospas_N

kopilot_N	pilot_N

kamínka_N	kamna_N

svažitý_A	svah_N

Milouš_N	Miloš_N

fráze_N	frazeologie_NC

Uhry_N	uherský_A

blýskat_V	blesk_N

Michálek_N	Michal_N

poddaný_A	poddat_V

vratidlo_N	vrátek_N

dojížďka_N	dojíždět_V

katakana_N	kana_N

potulný_A	toulavý_A

jachta_N	jachting_N

přelstít_V	lest_N

vistasměnka_N	směnka_N

lučebník_N	lučba_N

březen_N	bříza_N

odlov_N	lov_N

rachomejtle_N	raketa_N

píď_N	pnout_V

klad_N	klást_V

Vávra_N	Vavřinec_N

měřit_V	míra_N

mikulášský_A	Mikuláš_N

otýpka_N	otýpečka_N

namnoze_D	mnohý_P

naze_D	nahota_N

anexní_A	anexionizmus_N

skřehotat_V	skřek_N

skotačit_V	skot_N

newfoundlandský_A	Newfoundland_N

vřed_N	vřídek_N

svinit_V	svině_N

navzájem_D	vzájemný_A

fešák_N	fešný_A

palanda_N	palác_N

Křivoklát_N	křivý_A

plout_V	plavat_V

jaterník_N	játra_N

orlickoústecký_A	Orlickoústecko_N

Pootaví_N	otavský_A

továrna_N	tovar_N

festival_N	fesťák_N

šik_A	šikovat_V

Kobylisy_N	kobyla_N

Franc_N	František_N

levita_N	Lévi_N

brouzdat_V	brouzdaliště_N

strýčkování_N	strýc_N

neurotik_N	neuróza_N

zametat_V	mést_V

delegačenka_N	delegace_N

zedničit_V	zedník_N

paradigma_N	paradigmatika_N

závěrečný_A	závěr_N

opravdu_D	pravda_N

karetní_A	karta_N

chtít_V	ochota_N

Ugrofin_N	ugrofinistika_N

ohromit_V	hrom_N

ukrajinistika_N	Ukrajina_N

zrakvit_V	rakev_N

parmazán_N	Parma_N

okrsek_N	okres_N

lak_N	šelak_N

úhlavní_A	hlava_N

štígro_N	štěstí_N

handlovat_V	handlíř_N

chán_N	chanát_N

Petrik_N	Petr_N

verš_N	veršotepec_N

příraz_N	razit_V

konice_N	kůň_N

máslárna_N	máslo_N

šprtec_N	šprtat_V

bradavičnatý_A	bradavice_N

bahno_N	bahenní_A

kodek_N	kód_N

předloha_N	předložit_V

prozatím_D	zatím_I

liberka_N	libra_N

gotika_N	gótský_A

pasta_N	paštika_N

mol_N	knihomol_NC

ženšen_N	vyhánět_V

zátaras_N	zatarasit_V

vtělit_V	tělo_N

nevěra_N	věřit_V

kalorifer_N	kalorie_N

delfinárium_N	delfín_N

soudcová_N	soudce_N

Černoch_N	Černý_N

Oto_N	Otýlie_N

varianta_N	varieta_N

austromarxista_N	austromarxizmus_NC

jakubka_N	Jakub_N

zdar_N	zdárně_D

placka_N	placatý_A

finesa_N	rafinovat_V

přeprška_N	pršet_V

třasořitka_N	třást_V

balerína_N	balet_N

Kyrgyzstán_N	Kyrgyz_N

půdoznalec_N	znalec_N

Vítkovice_N	Vítek_N

příbuzný_A	příbuznost_N

Cyril_N	cyrilice_N

oddíl_N	díl_N

Kobylníky_N	kobyla_N

vladislavský_A	Vladislav_N

kadit_V	kadidelnice_N

drbárna_N	drbat_V

Mečislav_N	meč_N

napříště_D	příští_A

Ctibor_N	Ratibor_N

pročpak_D	proč_D

třesk_N	třeskutě_D

kaleidoskopický_A	kaleidoskop_NC

Starý_N	starý_N

regent_N	rychtář_N

leninovec_N	Lenin_N

zářez_N	řezat_V

Bordeaux_N	bordeauxský_A

Max_N	Maxim_N

půlrok_N	rok_N

žaltář_N	žalm_N

těžit_V	těžiště_N

průhledítko_N	prohlédnout_V

taškařice_N	taškář_N

ploutev_N	plout_V

kalvinista_N	kalvínský_A

nadvarle_N	varle_N

kavárna_N	káva_N

konvekce_N	advekce_N

obíhat_V	běhat_V

vsítit_V	síť_N

příbuzenský_A	příbuzný_N

inscenovat_V	scéna_N

záhlaví_N	hlava_N

osmiválec_N	válec_N

překvapit_V	kvapit_V

jablečný_A	jablko_N

penalizovat_V	penále_N

tovar_N	továrna_N

režírovat_V	režie_N

vůně_N	voňavý_A

pěchota_N	pěšky_D

kamenovat_V	kámen_N

souhvězdí_N	hvězda_N

polarizovat_V	pól_N

překročit_V	krok_N

divý_A	divoženka_N

vystroužit_V	výstružník_N

vývar_N	vařit_V

Bart_N	Bartoloměj_N

žíla_N	žilnatět_V

studio_N	studovat_V

nádiva_N	nadívat_V

dotek_N	dotknout_V

předchůdce_N	předejít_V

šlahačka_N	šlehačka_N

klínopis_N	psát_V

jankovitý_A	Janek_None

Komsomol_N	komsomolec_N

močopudný_A	moč_N

promenovat_V	promenoár_N

galapážský_A	Galapágy_N

emblém_N	embolie_N

odtajnit_V	tajný_N

zapřít_V	přít_V

otčina_N	otec_N

reedukace_N	edukace_N

Atlantida_N	Atlantik_None

opájet_V	pít_V

úschovné_N	úschovna_N

křehký_A	krušný_A

Olympia_N	olympiáda_N

černokabátník_N	kabátník_N

symbióza_N	symbiont_N

kdesi_D	kde_P

ontarijský_A	Ontario_N

sáhodlouhý_A	dlouhý_A

hnojit_V	hnůj_N

seč_N	sekat_V

Vorlová_N	Vorlíčková_N

pouhý_A	pouze_D

hřebčín_N	hříbě_N

diplomovat_V	diplomacie_N

osmistovka_N	stovka_N

zápětí_N	vzápětí_D

čerchmant_N	čert_N

zastoupit_V	zástup_N

nedbalky_N	dbát_V

Katalánie_N	katalánský_A

digestivum_N	digestiv_N

kamélie_N	Kamel_None

oscilovat_V	osciloskop_NC

podlouhlý_A	dlouhý_A

zlatulenký_A	zlatý_N

děravý_A	díra_N

teďka_D	teď_D

nadřád_N	řád_N

gardedáma_N	dáma_N

Příbor_N	příbor_N

Ostravák_N	Ostrava_None

jaderniště_N	jádro_N

samojský_A	Samoa_N

vizuální_A	zvizualizovat_V

šťastný_A	štěstí_N

parmezán_N	Parma_N

těhotný_A	těhotenství_N

kralovat_V	král_N

vepředu_D	kupředu_D

dolet_N	let_N

