adherovávatelně	adherovávatelný	(C) NO PARENT BEFORE
afirmovávatelně	afirmovávatelný	(C) NO PARENT BEFORE
alfabetizovávatelně	alfabetizovávatelný	(C) NO PARENT BEFORE
amalgamovávatelně	amalgamovávatelný	(C) NO PARENT BEFORE
anatomizovávatelně	anatomizovávatelný	(C) NO PARENT BEFORE
apgrejdovávatelně	apgrejdovávatelný	(C) NO PARENT BEFORE
apreciovávatelně	apreciovávatelný	(C) NO PARENT BEFORE
arbitrovávatelně	arbitrovávatelný	(C) NO PARENT BEFORE
asamblovávatelně	asamblovávatelný	(C) NO PARENT BEFORE
autentifikovávatelně	autentifikovávatelný	(C) NO PARENT BEFORE
autovávatelně	autovávatelný	(C) NO PARENT BEFORE
backtestovávatelně	backtestovávatelný	(C) NO PARENT BEFORE
bálovávatelně	bálovávatelný	(C) NO PARENT BEFORE
balzakovávatelně	balzakovávatelný	(C) NO PARENT BEFORE
bankovávatelně	bankovávatelný	(C) NO PARENT BEFORE
barbarizovávatelně	barbarizovávatelný	(C) NO PARENT BEFORE
barterovávatelně	barterovávatelný	(C) NO PARENT BEFORE
betatestovávatelně	betatestovávatelný	(C) NO PARENT BEFORE
bezplenkovávatelně	bezplenkovávatelný	(C) NO PARENT BEFORE
bikovávatelně	bikovávatelný	(C) NO PARENT BEFORE
bluesovávatelně	bluesovávatelný	(C) NO PARENT BEFORE
bohovávatelně	bohovávatelný	(C) NO PARENT BEFORE
bohyňovávatelně	bohyňovávatelný	(C) NO PARENT BEFORE
brandovávatelně	brandovávatelný	(C) NO PARENT BEFORE
brasírovávatelně	brasírovávatelný	(C) NO PARENT BEFORE
bublinkovávatelně	bublinkovávatelný	(C) NO PARENT BEFORE
carvovávatelně	carvovávatelný	(C) NO PARENT BEFORE
copyrightovávatelně	copyrightovávatelný	(C) NO PARENT BEFORE
cyklizovávatelně	cyklizovávatelný	(C) NO PARENT BEFORE
čantovávatelně	čantovávatelný	(C) NO PARENT BEFORE
čekovávatelně	čekovávatelný	(C) NO PARENT BEFORE
čórovávatelně	čórovávatelný	(C) NO PARENT BEFORE
čunkovávatelně	čunkovávatelný	(C) NO PARENT BEFORE
dealkoholizovávatelně	dealkoholizovávatelný	(C) NO PARENT BEFORE
dealovávatelně	dealovávatelný	(C) NO PARENT BEFORE
deeskalovávatelně	deeskalovávatelný	(C) NO PARENT BEFORE
defibrilovávatelně	defibrilovávatelný	(C) NO PARENT BEFORE
dekomunizovávatelně	dekomunizovávatelný	(C) NO PARENT BEFORE
dekoncentrovávatelně	dekoncentrovávatelný	(C) NO PARENT BEFORE
demytologizovávatelně	demytologizovávatelný	(C) NO PARENT BEFORE
denudovávatelně	denudovávatelný	(C) NO PARENT BEFORE
denuklearizovávatelně	denuklearizovávatelný	(C) NO PARENT BEFORE
depenalizovávatelně	depenalizovávatelný	(C) NO PARENT BEFORE
depigmentovávatelně	depigmentovávatelný	(C) NO PARENT BEFORE
depreciovávatelně	depreciovávatelný	(C) NO PARENT BEFORE
derniérovávatelně	derniérovávatelný	(C) NO PARENT BEFORE
desakralizovávatelně	desakralizovávatelný	(C) NO PARENT BEFORE
destalinizovávatelně	destalinizovávatelný	(C) NO PARENT BEFORE
developovávatelně	developovávatelný	(C) NO PARENT BEFORE
diabolisovávatelně	diabolisovávatelný	(C) NO PARENT BEFORE
dialektizovávatelně	dialektizovávatelný	(C) NO PARENT BEFORE
dichotomizovávatelně	dichotomizovávatelný	(C) NO PARENT BEFORE
diskretizovávatelně	diskretizovávatelný	(C) NO PARENT BEFORE
dobalovávatelně	dobalovávatelný	(C) NO PARENT BEFORE
doblogovávatelně	doblogovávatelný	(C) NO PARENT BEFORE
dobubnovávatelně	dobubnovávatelný	(C) NO PARENT BEFORE
dobuzovávatelně	dobuzovávatelný	(C) NO PARENT BEFORE
dockovávatelně	dockovávatelný	(C) NO PARENT BEFORE
dodekorovávatelně	dodekorovávatelný	(C) NO PARENT BEFORE
dodiskutovávatelně	dodiskutovávatelný	(C) NO PARENT BEFORE
dodotovávatelně	dodotovávatelný	(C) NO PARENT BEFORE
dodrancovávatelně	dodrancovávatelný	(C) NO PARENT BEFORE
dofantazírovávatelně	dofantazírovávatelný	(C) NO PARENT BEFORE
dofixovávatelně	dofixovávatelný	(C) NO PARENT BEFORE
doháčkovávatelně	doháčkovávatelný	(C) NO PARENT BEFORE
dointonovávatelně	dointonovávatelný	(C) NO PARENT BEFORE
dojmenovávatelně	dojmenovávatelný	(C) NO PARENT BEFORE
dokanalizovávatelně	dokanalizovávatelný	(C) NO PARENT BEFORE
dokapitalizovávatelně	dokapitalizovávatelný	(C) NO PARENT BEFORE
dokombinovávatelně	dokombinovávatelný	(C) NO PARENT BEFORE
domanévrovávatelně	domanévrovávatelný	(C) NO PARENT BEFORE
domapovávatelně	domapovávatelný	(C) NO PARENT BEFORE
domilovávatelně	domilovávatelný	(C) NO PARENT BEFORE
doobchodovávatelně	doobchodovávatelný	(C) NO PARENT BEFORE
doopravovávatelně	doopravovávatelný	(C) NO PARENT BEFORE
dopichovávatelně	dopichovávatelný	(C) NO PARENT BEFORE
doplynofikovávatelně	doplynofikovávatelný	(C) NO PARENT BEFORE
doporcovávatelně	doporcovávatelný	(C) NO PARENT BEFORE
doradovávatelně	doradovávatelný	(C) NO PARENT BEFORE
doreformovávatelně	doreformovávatelný	(C) NO PARENT BEFORE
dosádrovávatelně	dosádrovávatelný	(C) NO PARENT BEFORE
doslavovávatelně	doslavovávatelný	(C) NO PARENT BEFORE
dospalovávatelně	dospalovávatelný	(C) NO PARENT BEFORE
dospárovávatelně	dospárovávatelný	(C) NO PARENT BEFORE
dosportovávatelně	dosportovávatelný	(C) NO PARENT BEFORE
dosprchovávatelně	dosprchovávatelný	(C) NO PARENT BEFORE
dostahovávatelně	dostahovávatelný	(C) NO PARENT BEFORE
dostopovávatelně	dostopovávatelný	(C) NO PARENT BEFORE
dosurfovávatelně	dosurfovávatelný	(C) NO PARENT BEFORE
dosvěcovávatelně	dosvěcovávatelný	(C) NO PARENT BEFORE
dotestovávatelně	dotestovávatelný	(C) NO PARENT BEFORE
dotěžovávatelně	dotěžovávatelný	(C) NO PARENT BEFORE
doupravovávatelně	doupravovávatelný	(C) NO PARENT BEFORE
douzovávatelně	douzovávatelný	(C) NO PARENT BEFORE
doválcovávatelně	doválcovávatelný	(C) NO PARENT BEFORE
drajvovávatelně	drajvovávatelný	(C) NO PARENT BEFORE
drezúrovávatelně	drezúrovávatelný	(C) NO PARENT BEFORE
drnovávatelně	drnovávatelný	(C) NO PARENT BEFORE
dřepovávatelně	dřepovávatelný	(C) NO PARENT BEFORE
džoukovávatelně	džoukovávatelný	(C) NO PARENT BEFORE
edukovávatelně	edukovávatelný	(C) NO PARENT BEFORE
echovávatelně	echovávatelný	(C) NO PARENT BEFORE
emblematizovávatelně	emblematizovávatelný	(C) NO PARENT BEFORE
empatizovávatelně	empatizovávatelný	(C) NO PARENT BEFORE
epilovávatelně	epilovávatelný	(C) NO PARENT BEFORE
euforizovávatelně	euforizovávatelný	(C) NO PARENT BEFORE
europeizovávatelně	europeizovávatelný	(C) NO PARENT BEFORE
exemplifikovávatelně	exemplifikovávatelný	(C) NO PARENT BEFORE
exprimovávatelně	exprimovávatelný	(C) NO PARENT BEFORE
fáborkovávatelně	fáborkovávatelný	(C) NO PARENT BEFORE
facebookovávatelně	facebookovávatelný	(C) NO PARENT BEFORE
facilitovávatelně	facilitovávatelný	(C) NO PARENT BEFORE
fanatizovávatelně	fanatizovávatelný	(C) NO PARENT BEFORE
festovírovávatelně	festovírovávatelný	(C) NO PARENT BEFORE
fibrilovávatelně	fibrilovávatelný	(C) NO PARENT BEFORE
flankovávatelně	flankovávatelný	(C) NO PARENT BEFORE
fluoridovávatelně	fluoridovávatelný	(C) NO PARENT BEFORE
fokalizovávatelně	fokalizovávatelný	(C) NO PARENT BEFORE
folklorizovávatelně	folklorizovávatelný	(C) NO PARENT BEFORE
frotážovávatelně	frotážovávatelný	(C) NO PARENT BEFORE
gramatikalizovávatelně	gramatikalizovávatelný	(C) NO PARENT BEFORE
hajduchovávatelně	hajduchovávatelný	(C) NO PARENT BEFORE
hajdukovávatelně	hajdukovávatelný	(C) NO PARENT BEFORE
haškovávatelně	haškovávatelný	(C) NO PARENT BEFORE
hegemonizovávatelně	hegemonizovávatelný	(C) NO PARENT BEFORE
hláškovávatelně	hláškovávatelný	(C) NO PARENT BEFORE
hlávkovávatelně	hlávkovávatelný	(C) NO PARENT BEFORE
homologizovávatelně	homologizovávatelný	(C) NO PARENT BEFORE
hybernovávatelně	hybernovávatelný	(C) NO PARENT BEFORE
hybridizovávatelně	hybridizovávatelný	(C) NO PARENT BEFORE
hydroizolovávatelně	hydroizolovávatelný	(C) NO PARENT BEFORE
hyperventilovávatelně	hyperventilovávatelný	(C) NO PARENT BEFORE
choreografovávatelně	choreografovávatelný	(C) NO PARENT BEFORE
ilegalizovávatelně	ilegalizovávatelný	(C) NO PARENT BEFORE
infantilizovávatelně	infantilizovávatelný	(C) NO PARENT BEFORE
institualizovávatelně	institualizovávatelný	(C) NO PARENT BEFORE
interiorizovávatelně	interiorizovávatelný	(C) NO PARENT BEFORE
intimizovávatelně	intimizovávatelný	(C) NO PARENT BEFORE
intubovávatelně	intubovávatelný	(C) NO PARENT BEFORE
investigovávatelně	investigovávatelný	(C) NO PARENT BEFORE
jazzovávatelně	jazzovávatelný	(C) NO PARENT BEFORE
kabelizovávatelně	kabelizovávatelný	(C) NO PARENT BEFORE
kapitánovávatelně	kapitánovávatelný	(C) NO PARENT BEFORE
kastovávatelně	kastovávatelný	(C) NO PARENT BEFORE
kaučovávatelně	kaučovávatelný	(C) NO PARENT BEFORE
kelímkovávatelně	kelímkovávatelný	(C) NO PARENT BEFORE
knockautovávatelně	knockautovávatelný	(C) NO PARENT BEFORE
komunizovávatelně	komunizovávatelný	(C) NO PARENT BEFORE
konceptualizovávatelně	konceptualizovávatelný	(C) NO PARENT BEFORE
kontejnerovávatelně	kontejnerovávatelný	(C) NO PARENT BEFORE
kontextualizovávatelně	kontextualizovávatelný	(C) NO PARENT BEFORE
korepetitovávatelně	korepetitovávatelný	(C) NO PARENT BEFORE
kvantizovávatelně	kvantizovávatelný	(C) NO PARENT BEFORE
lajkovávatelně	lajkovávatelný	(C) NO PARENT BEFORE
legendarizovávatelně	legendarizovávatelný	(C) NO PARENT BEFORE
lídrovávatelně	lídrovávatelný	(C) NO PARENT BEFORE
lignifikovávatelně	lignifikovávatelný	(C) NO PARENT BEFORE
lístkovávatelně	lístkovávatelný	(C) NO PARENT BEFORE
luhovávatelně	luhovávatelný	(C) NO PARENT BEFORE
lynchovávatelně	lynchovávatelný	(C) NO PARENT BEFORE
manažovávatelně	manažovávatelný	(C) NO PARENT BEFORE
maskulinizovávatelně	maskulinizovávatelný	(C) NO PARENT BEFORE
masterovávatelně	masterovávatelný	(C) NO PARENT BEFORE
mastrovávatelně	mastrovávatelný	(C) NO PARENT BEFORE
meadrovávatelně	meadrovávatelný	(C) NO PARENT BEFORE
mejlovávatelně	mejlovávatelný	(C) NO PARENT BEFORE
mesmerizovávatelně	mesmerizovávatelný	(C) NO PARENT BEFORE
meziskladovávatelně	meziskladovávatelný	(C) NO PARENT BEFORE
mitigovávatelně	mitigovávatelný	(C) NO PARENT BEFORE
mobilovávatelně	mobilovávatelný	(C) NO PARENT BEFORE
monetizovávatelně	monetizovávatelný	(C) NO PARENT BEFORE
mýtizovávatelně	mýtizovávatelný	(C) NO PARENT BEFORE
nabalíkovávatelně	nabalíkovávatelný	(C) NO PARENT BEFORE
nabalzámovávatelně	nabalzámovávatelný	(C) NO PARENT BEFORE
nabatikovávatelně	nabatikovávatelný	(C) NO PARENT BEFORE
nabodovávatelně	nabodovávatelný	(C) NO PARENT BEFORE
nabonzovávatelně	nabonzovávatelný	(C) NO PARENT BEFORE
nabrífovávatelně	nabrífovávatelný	(C) NO PARENT BEFORE
nabruslovávatelně	nabruslovávatelný	(C) NO PARENT BEFORE
naburcovávatelně	naburcovávatelný	(C) NO PARENT BEFORE
nacejchovávatelně	nacejchovávatelný	(C) NO PARENT BEFORE
načárovávatelně	načárovávatelný	(C) NO PARENT BEFORE
načunkovávatelně	načunkovávatelný	(C) NO PARENT BEFORE
nadekorovávatelně	nadekorovávatelný	(C) NO PARENT BEFORE
nadelegovávatelně	nadelegovávatelný	(C) NO PARENT BEFORE
nadesignovávatelně	nadesignovávatelný	(C) NO PARENT BEFORE
nadiskutovávatelně	nadiskutovávatelný	(C) NO PARENT BEFORE
nadrancovávatelně	nadrancovávatelný	(C) NO PARENT BEFORE
nadrážkovávatelně	nadrážkovávatelný	(C) NO PARENT BEFORE
nadrilovávatelně	nadrilovávatelný	(C) NO PARENT BEFORE
nadstavovávatelně	nadstavovávatelný	(C) NO PARENT BEFORE
nadstřešovávatelně	nadstřešovávatelný	(C) NO PARENT BEFORE
nafakturovávatelně	nafakturovávatelný	(C) NO PARENT BEFORE
nafrézovávatelně	nafrézovávatelný	(C) NO PARENT BEFORE
nagelovávatelně	nagelovávatelný	(C) NO PARENT BEFORE
nahláskovávatelně	nahláskovávatelný	(C) NO PARENT BEFORE
nachromovávatelně	nachromovávatelný	(C) NO PARENT BEFORE
nainvestovávatelně	nainvestovávatelný	(C) NO PARENT BEFORE
naježovávatelně	naježovávatelný	(C) NO PARENT BEFORE
nakalibrovávatelně	nakalibrovávatelný	(C) NO PARENT BEFORE
nakoncentrovávatelně	nakoncentrovávatelný	(C) NO PARENT BEFORE
nakondenzovávatelně	nakondenzovávatelný	(C) NO PARENT BEFORE
nakontraktovávatelně	nakontraktovávatelný	(C) NO PARENT BEFORE
nakouskovávatelně	nakouskovávatelný	(C) NO PARENT BEFORE
nakrepovávatelně	nakrepovávatelný	(C) NO PARENT BEFORE
nalahvovávatelně	nalahvovávatelný	(C) NO PARENT BEFORE
naleasovávatelně	naleasovávatelný	(C) NO PARENT BEFORE
nalyžovávatelně	nalyžovávatelný	(C) NO PARENT BEFORE
nametalizovávatelně	nametalizovávatelný	(C) NO PARENT BEFORE
namotivovávatelně	namotivovávatelný	(C) NO PARENT BEFORE
namulčovávatelně	namulčovávatelný	(C) NO PARENT BEFORE
nanormovávatelně	nanormovávatelný	(C) NO PARENT BEFORE
naobálkovávatelně	naobálkovávatelný	(C) NO PARENT BEFORE
naobdivovávatelně	naobdivovávatelný	(C) NO PARENT BEFORE
naobveselovávatelně	naobveselovávatelný	(C) NO PARENT BEFORE
naoperovávatelně	naoperovávatelný	(C) NO PARENT BEFORE
naoslavovávatelně	naoslavovávatelný	(C) NO PARENT BEFORE
naoxidovávatelně	naoxidovávatelný	(C) NO PARENT BEFORE
napatinovávatelně	napatinovávatelný	(C) NO PARENT BEFORE
napenetrovávatelně	napenetrovávatelný	(C) NO PARENT BEFORE
napiglovávatelně	napiglovávatelný	(C) NO PARENT BEFORE
napipetovávatelně	napipetovávatelný	(C) NO PARENT BEFORE
napodepisovávatelně	napodepisovávatelný	(C) NO PARENT BEFORE
napodmiňovávatelně	napodmiňovávatelný	(C) NO PARENT BEFORE
napochybovávatelně	napochybovávatelný	(C) NO PARENT BEFORE
naposilovávatelně	naposilovávatelný	(C) NO PARENT BEFORE
napoučovávatelně	napoučovávatelný	(C) NO PARENT BEFORE
napoukazovávatelně	napoukazovávatelný	(C) NO PARENT BEFORE
napozorovávatelně	napozorovávatelný	(C) NO PARENT BEFORE
napráškovávatelně	napráškovávatelný	(C) NO PARENT BEFORE
napreparovávatelně	napreparovávatelný	(C) NO PARENT BEFORE
naprodukovávatelně	naprodukovávatelný	(C) NO PARENT BEFORE
napropojovávatelně	napropojovávatelný	(C) NO PARENT BEFORE
naprotestovávatelně	naprotestovávatelný	(C) NO PARENT BEFORE
naproužkovávatelně	naproužkovávatelný	(C) NO PARENT BEFORE
napředstavovávatelně	napředstavovávatelný	(C) NO PARENT BEFORE
napřevodovávatelně	napřevodovávatelný	(C) NO PARENT BEFORE
narozčilovávatelně	narozčilovávatelný	(C) NO PARENT BEFORE
narozdělovávatelně	narozdělovávatelný	(C) NO PARENT BEFORE
narozumovávatelně	narozumovávatelný	(C) NO PARENT BEFORE
nashromažďovávatelně	nashromažďovávatelný	(C) NO PARENT BEFORE
naskládkovávatelně	naskládkovávatelný	(C) NO PARENT BEFORE
naskriptovávatelně	naskriptovávatelný	(C) NO PARENT BEFORE
nasněžovávatelně	nasněžovávatelný	(C) NO PARENT BEFORE
nasoudruhovávatelně	nasoudruhovávatelný	(C) NO PARENT BEFORE
naspídovávatelně	naspídovávatelný	(C) NO PARENT BEFORE
nasportovávatelně	nasportovávatelný	(C) NO PARENT BEFORE
nastimulovávatelně	nastimulovávatelný	(C) NO PARENT BEFORE
nastrukturovávatelně	nastrukturovávatelný	(C) NO PARENT BEFORE
nasudovávatelně	nasudovávatelný	(C) NO PARENT BEFORE
nasugerovávatelně	nasugerovávatelný	(C) NO PARENT BEFORE
nasužovávatelně	nasužovávatelný	(C) NO PARENT BEFORE
našamponovávatelně	našamponovávatelný	(C) NO PARENT BEFORE
naštemovávatelně	naštemovávatelný	(C) NO PARENT BEFORE
naštěpkovávatelně	naštěpkovávatelný	(C) NO PARENT BEFORE
naštukovávatelně	naštukovávatelný	(C) NO PARENT BEFORE
nataktovávatelně	nataktovávatelný	(C) NO PARENT BEFORE
natemperovávatelně	natemperovávatelný	(C) NO PARENT BEFORE
natestovávatelně	natestovávatelný	(C) NO PARENT BEFORE
natónovávatelně	natónovávatelný	(C) NO PARENT BEFORE
natrasovávatelně	natrasovávatelný	(C) NO PARENT BEFORE
natvarovávatelně	natvarovávatelný	(C) NO PARENT BEFORE
nautahovávatelně	nautahovávatelný	(C) NO PARENT BEFORE
naúvěrovávatelně	naúvěrovávatelný	(C) NO PARENT BEFORE
navakcinovávatelně	navakcinovávatelný	(C) NO PARENT BEFORE
naviksovávatelně	naviksovávatelný	(C) NO PARENT BEFORE
navočkovávatelně	navočkovávatelný	(C) NO PARENT BEFORE
navondulovávatelně	navondulovávatelný	(C) NO PARENT BEFORE
navracovávatelně	navracovávatelný	(C) NO PARENT BEFORE
navypůjčovávatelně	navypůjčovávatelný	(C) NO PARENT BEFORE
navysvětlovávatelně	navysvětlovávatelný	(C) NO PARENT BEFORE
navytahovávatelně	navytahovávatelný	(C) NO PARENT BEFORE
navyžadovávatelně	navyžadovávatelný	(C) NO PARENT BEFORE
nažalovávatelně	nažalovávatelný	(C) NO PARENT BEFORE
negociovávatelně	negociovávatelný	(C) NO PARENT BEFORE
noclehovávatelně	noclehovávatelný	(C) NO PARENT BEFORE
obatikovávatelně	obatikovávatelný	(C) NO PARENT BEFORE
obaťůžkovávatelně	obaťůžkovávatelný	(C) NO PARENT BEFORE
obestupovávatelně	obestupovávatelný	(C) NO PARENT BEFORE
obkličkovávatelně	obkličkovávatelný	(C) NO PARENT BEFORE
obojkovávatelně	obojkovávatelný	(C) NO PARENT BEFORE
obrejličkovávatelně	obrejličkovávatelný	(C) NO PARENT BEFORE
obrýsovávatelně	obrýsovávatelný	(C) NO PARENT BEFORE
obstřikovávatelně	obstřikovávatelný	(C) NO PARENT BEFORE
obšlapovávatelně	obšlapovávatelný	(C) NO PARENT BEFORE
obubnovávatelně	obubnovávatelný	(C) NO PARENT BEFORE
ocertifikovávatelně	ocertifikovávatelný	(C) NO PARENT BEFORE
ocitronovávatelně	ocitronovávatelný	(C) NO PARENT BEFORE
očekovávatelně	očekovávatelný	(C) NO PARENT BEFORE
odargumentovávatelně	odargumentovávatelný	(C) NO PARENT BEFORE
odbalkanizovávatelně	odbalkanizovávatelný	(C) NO PARENT BEFORE
odbaštovávatelně	odbaštovávatelný	(C) NO PARENT BEFORE
odblešovávatelně	odblešovávatelný	(C) NO PARENT BEFORE
odbreberkovávatelně	odbreberkovávatelný	(C) NO PARENT BEFORE
odbydlovávatelně	odbydlovávatelný	(C) NO PARENT BEFORE
oddeklamovávatelně	oddeklamovávatelný	(C) NO PARENT BEFORE
oddekretovávatelně	oddekretovávatelný	(C) NO PARENT BEFORE
oddramatizovávatelně	oddramatizovávatelný	(C) NO PARENT BEFORE
odekorovávatelně	odekorovávatelný	(C) NO PARENT BEFORE
odentrovávatelně	odentrovávatelný	(C) NO PARENT BEFORE
odfetovávatelně	odfetovávatelný	(C) NO PARENT BEFORE
odfinancovávatelně	odfinancovávatelný	(C) NO PARENT BEFORE
odháčkovávatelně	odháčkovávatelný	(C) NO PARENT BEFORE
odkomentovávatelně	odkomentovávatelný	(C) NO PARENT BEFORE
odkorkovávatelně	odkorkovávatelný	(C) NO PARENT BEFORE
odkrucovávatelně	odkrucovávatelný	(C) NO PARENT BEFORE
odkurtovávatelně	odkurtovávatelný	(C) NO PARENT BEFORE
odliberalizovávatelně	odliberalizovávatelný	(C) NO PARENT BEFORE
odlyžovávatelně	odlyžovávatelný	(C) NO PARENT BEFORE
odmýtizovávatelně	odmýtizovávatelný	(C) NO PARENT BEFORE
odorizovávatelně	odorizovávatelný	(C) NO PARENT BEFORE
odpluhovávatelně	odpluhovávatelný	(C) NO PARENT BEFORE
odpremiérovávatelně	odpremiérovávatelný	(C) NO PARENT BEFORE
odprezentovávatelně	odprezentovávatelný	(C) NO PARENT BEFORE
odprivatizovávatelně	odprivatizovávatelný	(C) NO PARENT BEFORE
odpružovávatelně	odpružovávatelný	(C) NO PARENT BEFORE
odputovávatelně	odputovávatelný	(C) NO PARENT BEFORE
odrátkovávatelně	odrátkovávatelný	(C) NO PARENT BEFORE
odrázovávatelně	odrázovávatelný	(C) NO PARENT BEFORE
odredovávatelně	odredovávatelný	(C) NO PARENT BEFORE
odreferovávatelně	odreferovávatelný	(C) NO PARENT BEFORE
odregulovávatelně	odregulovávatelný	(C) NO PARENT BEFORE
odrekreovávatelně	odrekreovávatelný	(C) NO PARENT BEFORE
odremizovávatelně	odremizovávatelný	(C) NO PARENT BEFORE
odretušovávatelně	odretušovávatelný	(C) NO PARENT BEFORE
odřazovávatelně	odřazovávatelný	(C) NO PARENT BEFORE
odservírovávatelně	odservírovávatelný	(C) NO PARENT BEFORE
odsexualizovávatelně	odsexualizovávatelný	(C) NO PARENT BEFORE
odsledovávatelně	odsledovávatelný	(C) NO PARENT BEFORE
odsmečovávatelně	odsmečovávatelný	(C) NO PARENT BEFORE
odsportovávatelně	odsportovávatelný	(C) NO PARENT BEFORE
odstávkovávatelně	odstávkovávatelný	(C) NO PARENT BEFORE
odstresovávatelně	odstresovávatelný	(C) NO PARENT BEFORE
odstudovávatelně	odstudovávatelný	(C) NO PARENT BEFORE
odšlapovávatelně	odšlapovávatelný	(C) NO PARENT BEFORE
odtestovávatelně	odtestovávatelný	(C) NO PARENT BEFORE
odtipovávatelně	odtipovávatelný	(C) NO PARENT BEFORE
odúřadovávatelně	odúřadovávatelný	(C) NO PARENT BEFORE
odválcovávatelně	odválcovávatelný	(C) NO PARENT BEFORE
odventilovávatelně	odventilovávatelný	(C) NO PARENT BEFORE
odzdržovávatelně	odzdržovávatelný	(C) NO PARENT BEFORE
odztrátovávatelně	odztrátovávatelný	(C) NO PARENT BEFORE
odzvoňovávatelně	odzvoňovávatelný	(C) NO PARENT BEFORE
ofáborkovávatelně	ofáborkovávatelný	(C) NO PARENT BEFORE
ofáborovávatelně	ofáborovávatelný	(C) NO PARENT BEFORE
oglosovávatelně	oglosovávatelný	(C) NO PARENT BEFORE
ohonorovávatelně	ohonorovávatelný	(C) NO PARENT BEFORE
okachličkovávatelně	okachličkovávatelný	(C) NO PARENT BEFORE
okloboukovávatelně	okloboukovávatelný	(C) NO PARENT BEFORE
okostýmovávatelně	okostýmovávatelný	(C) NO PARENT BEFORE
opálkovávatelně	opálkovávatelný	(C) NO PARENT BEFORE
operacionalizovávatelně	operacionalizovávatelný	(C) NO PARENT BEFORE
oplošťovávatelně	oplošťovávatelný	(C) NO PARENT BEFORE
opocovávatelně	opocovávatelný	(C) NO PARENT BEFORE
oponožkovávatelně	oponožkovávatelný	(C) NO PARENT BEFORE
oprávkovávatelně	oprávkovávatelný	(C) NO PARENT BEFORE
opřipomínkovávatelně	opřipomínkovávatelný	(C) NO PARENT BEFORE
opuntíkovávatelně	opuntíkovávatelný	(C) NO PARENT BEFORE
opupínkovávatelně	opupínkovávatelný	(C) NO PARENT BEFORE
osekvenovávatelně	osekvenovávatelný	(C) NO PARENT BEFORE
oservisovávatelně	oservisovávatelný	(C) NO PARENT BEFORE
oskórovávatelně	oskórovávatelný	(C) NO PARENT BEFORE
osondovávatelně	osondovávatelný	(C) NO PARENT BEFORE
ospurtovávatelně	ospurtovávatelný	(C) NO PARENT BEFORE
ošéfovávatelně	ošéfovávatelný	(C) NO PARENT BEFORE
ošvejkovávatelně	ošvejkovávatelný	(C) NO PARENT BEFORE
otapetovávatelně	otapetovávatelný	(C) NO PARENT BEFORE
otetovávatelně	otetovávatelný	(C) NO PARENT BEFORE
outsourcovávatelně	outsourcovávatelný	(C) NO PARENT BEFORE
ovulovávatelně	ovulovávatelný	(C) NO PARENT BEFORE
oxygenovávatelně	oxygenovávatelný	(C) NO PARENT BEFORE
paralizovávatelně	paralizovávatelný	(C) NO PARENT BEFORE
parfemovávatelně	parfemovávatelný	(C) NO PARENT BEFORE
pekáčovávatelně	pekáčovávatelný	(C) NO PARENT BEFORE
performovávatelně	performovávatelný	(C) NO PARENT BEFORE
perzonifikovávatelně	perzonifikovávatelný	(C) NO PARENT BEFORE
píďalkovávatelně	píďalkovávatelný	(C) NO PARENT BEFORE
piglovávatelně	piglovávatelný	(C) NO PARENT BEFORE
plastinovávatelně	plastinovávatelný	(C) NO PARENT BEFORE
plodovávatelně	plodovávatelný	(C) NO PARENT BEFORE
poameričťovávatelně	poameričťovávatelný	(C) NO PARENT BEFORE
pocentrovávatelně	pocentrovávatelný	(C) NO PARENT BEFORE
pocestovávatelně	pocestovávatelný	(C) NO PARENT BEFORE
podměřovávatelně	podměřovávatelný	(C) NO PARENT BEFORE
podskakovávatelně	podskakovávatelný	(C) NO PARENT BEFORE
podstřelovávatelně	podstřelovávatelný	(C) NO PARENT BEFORE
podšprajcovávatelně	podšprajcovávatelný	(C) NO PARENT BEFORE
pofackovávatelně	pofackovávatelný	(C) NO PARENT BEFORE
pohecovávatelně	pohecovávatelný	(C) NO PARENT BEFORE
pokérovávatelně	pokérovávatelný	(C) NO PARENT BEFORE
pokondolovávatelně	pokondolovávatelný	(C) NO PARENT BEFORE
pokoštovávatelně	pokoštovávatelný	(C) NO PARENT BEFORE
pokritizovávatelně	pokritizovávatelný	(C) NO PARENT BEFORE
pokřesťanšťovávatelně	pokřesťanšťovávatelný	(C) NO PARENT BEFORE
poloprofesionalizovávatelně	poloprofesionalizovávatelný	(C) NO PARENT BEFORE
popiskovávatelně	popiskovávatelný	(C) NO PARENT BEFORE
popracovávatelně	popracovávatelný	(C) NO PARENT BEFORE
popřehazovávatelně	popřehazovávatelný	(C) NO PARENT BEFORE
poradcovávatelně	poradcovávatelný	(C) NO PARENT BEFORE
poradovávatelně	poradovávatelný	(C) NO PARENT BEFORE
porotovávatelně	porotovávatelný	(C) NO PARENT BEFORE
poshazovávatelně	poshazovávatelný	(C) NO PARENT BEFORE
posvařovávatelně	posvařovávatelný	(C) NO PARENT BEFORE
potapetovávatelně	potapetovávatelný	(C) NO PARENT BEFORE
potemňovávatelně	potemňovávatelný	(C) NO PARENT BEFORE
poupravovávatelně	poupravovávatelný	(C) NO PARENT BEFORE
pověnovávatelně	pověnovávatelný	(C) NO PARENT BEFORE
povinšovávatelně	povinšovávatelný	(C) NO PARENT BEFORE
povlakovávatelně	povlakovávatelný	(C) NO PARENT BEFORE
povrstvovávatelně	povrstvovávatelný	(C) NO PARENT BEFORE
povyhazovávatelně	povyhazovávatelný	(C) NO PARENT BEFORE
povyměňovávatelně	povyměňovávatelný	(C) NO PARENT BEFORE
povyřizovávatelně	povyřizovávatelný	(C) NO PARENT BEFORE
pozápadňovávatelně	pozápadňovávatelný	(C) NO PARENT BEFORE
poženšťovávatelně	poženšťovávatelný	(C) NO PARENT BEFORE
prázdninovávatelně	prázdninovávatelný	(C) NO PARENT BEFORE
prdelkovávatelně	prdelkovávatelný	(C) NO PARENT BEFORE
precipitovávatelně	precipitovávatelný	(C) NO PARENT BEFORE
prelustrovávatelně	prelustrovávatelný	(C) NO PARENT BEFORE
prioritizovávatelně	prioritizovávatelný	(C) NO PARENT BEFORE
profilcovávatelně	profilcovávatelný	(C) NO PARENT BEFORE
profízlovávatelně	profízlovávatelný	(C) NO PARENT BEFORE
prohospodařovávatelně	prohospodařovávatelný	(C) NO PARENT BEFORE
projikovávatelně	projikovávatelný	(C) NO PARENT BEFORE
prokvašovávatelně	prokvašovávatelný	(C) NO PARENT BEFORE
proluftovávatelně	proluftovávatelný	(C) NO PARENT BEFORE
proolejovávatelně	proolejovávatelný	(C) NO PARENT BEFORE
propaběrkovávatelně	propaběrkovávatelný	(C) NO PARENT BEFORE
propádlovávatelně	propádlovávatelný	(C) NO PARENT BEFORE
proplečkovávatelně	proplečkovávatelný	(C) NO PARENT BEFORE
propluhovávatelně	propluhovávatelný	(C) NO PARENT BEFORE
propocovávatelně	propocovávatelný	(C) NO PARENT BEFORE
propytlíkovávatelně	propytlíkovávatelný	(C) NO PARENT BEFORE
prorajtovávatelně	prorajtovávatelný	(C) NO PARENT BEFORE
prorecitovávatelně	prorecitovávatelný	(C) NO PARENT BEFORE
prorozkazovávatelně	prorozkazovávatelný	(C) NO PARENT BEFORE
prorýhovávatelně	prorýhovávatelný	(C) NO PARENT BEFORE
prosvicovávatelně	prosvicovávatelný	(C) NO PARENT BEFORE
prosvorkovávatelně	prosvorkovávatelný	(C) NO PARENT BEFORE
prošroubovávatelně	prošroubovávatelný	(C) NO PARENT BEFORE
protifinancovávatelně	protifinancovávatelný	(C) NO PARENT BEFORE
protrénovávatelně	protrénovávatelný	(C) NO PARENT BEFORE
provařovávatelně	provařovávatelný	(C) NO PARENT BEFORE
provazovávatelně	provazovávatelný	(C) NO PARENT BEFORE
proveslovávatelně	proveslovávatelný	(C) NO PARENT BEFORE
průvodcovávatelně	průvodcovávatelný	(C) NO PARENT BEFORE
přebásníkovávatelně	přebásníkovávatelný	(C) NO PARENT BEFORE
přebookovávatelně	přebookovávatelný	(C) NO PARENT BEFORE
přebruslovávatelně	přebruslovávatelný	(C) NO PARENT BEFORE
přebuchtovávatelně	přebuchtovávatelný	(C) NO PARENT BEFORE
předčisťovávatelně	předčisťovávatelný	(C) NO PARENT BEFORE
předestilovávatelně	předestilovávatelný	(C) NO PARENT BEFORE
předformulovávatelně	předformulovávatelný	(C) NO PARENT BEFORE
předikovávatelně	předikovávatelný	(C) NO PARENT BEFORE
přediktovávatelně	přediktovávatelný	(C) NO PARENT BEFORE
předinvestovávatelně	předinvestovávatelný	(C) NO PARENT BEFORE
předkupovávatelně	předkupovávatelný	(C) NO PARENT BEFORE
předlážďovávatelně	předlážďovávatelný	(C) NO PARENT BEFORE
předmontovávatelně	předmontovávatelný	(C) NO PARENT BEFORE
předoktorovávatelně	předoktorovávatelný	(C) NO PARENT BEFORE
předplacovávatelně	předplacovávatelný	(C) NO PARENT BEFORE
předpracovávatelně	předpracovávatelný	(C) NO PARENT BEFORE
předregistrovávatelně	předregistrovávatelný	(C) NO PARENT BEFORE
předriblovávatelně	předriblovávatelný	(C) NO PARENT BEFORE
předsušovávatelně	předsušovávatelný	(C) NO PARENT BEFORE
předvychovávatelně	předvychovávatelný	(C) NO PARENT BEFORE
přeevidovávatelně	přeevidovávatelný	(C) NO PARENT BEFORE
přefestivalovávatelně	přefestivalovávatelný	(C) NO PARENT BEFORE
přefukovávatelně	přefukovávatelný	(C) NO PARENT BEFORE
přegolfovávatelně	přegolfovávatelný	(C) NO PARENT BEFORE
přehájkovávatelně	přehájkovávatelný	(C) NO PARENT BEFORE
přehavlovávatelně	přehavlovávatelný	(C) NO PARENT BEFORE
přehecovávatelně	přehecovávatelný	(C) NO PARENT BEFORE
přehernovávatelně	přehernovávatelný	(C) NO PARENT BEFORE
přehotelovávatelně	přehotelovávatelný	(C) NO PARENT BEFORE
přehušťovávatelně	přehušťovávatelný	(C) NO PARENT BEFORE
přehvězdovávatelně	přehvězdovávatelný	(C) NO PARENT BEFORE
přechytračovávatelně	přechytračovávatelný	(C) NO PARENT BEFORE
přeinterpretovávatelně	přeinterpretovávatelný	(C) NO PARENT BEFORE
překalibrovávatelně	překalibrovávatelný	(C) NO PARENT BEFORE
překoordinovávatelně	překoordinovávatelný	(C) NO PARENT BEFORE
překoštovávatelně	překoštovávatelný	(C) NO PARENT BEFORE
překvašovávatelně	překvašovávatelný	(C) NO PARENT BEFORE
přemarketovávatelně	přemarketovávatelný	(C) NO PARENT BEFORE
přemedializovávatelně	přemedializovávatelný	(C) NO PARENT BEFORE
přeobchodovávatelně	přeobchodovávatelný	(C) NO PARENT BEFORE
přepapouškovávatelně	přepapouškovávatelný	(C) NO PARENT BEFORE
přeparoubkovávatelně	přeparoubkovávatelný	(C) NO PARENT BEFORE
přepatrovávatelně	přepatrovávatelný	(C) NO PARENT BEFORE
přepsovávatelně	přepsovávatelný	(C) NO PARENT BEFORE
přerámovávatelně	přerámovávatelný	(C) NO PARENT BEFORE
přereklamovávatelně	přereklamovávatelný	(C) NO PARENT BEFORE
přerybňovávatelně	přerybňovávatelný	(C) NO PARENT BEFORE
přeřizovávatelně	přeřizovávatelný	(C) NO PARENT BEFORE
přesazbovávatelně	přesazbovávatelný	(C) NO PARENT BEFORE
přesbírkovávatelně	přesbírkovávatelný	(C) NO PARENT BEFORE
přeseriálovávatelně	přeseriálovávatelný	(C) NO PARENT BEFORE
přesíťovávatelně	přesíťovávatelný	(C) NO PARENT BEFORE
přeskladňovávatelně	přeskladňovávatelný	(C) NO PARENT BEFORE
přesládkovávatelně	přesládkovávatelný	(C) NO PARENT BEFORE
přesofistikovávatelně	přesofistikovávatelný	(C) NO PARENT BEFORE
přesportovávatelně	přesportovávatelný	(C) NO PARENT BEFORE
přesupermarketovávatelně	přesupermarketovávatelný	(C) NO PARENT BEFORE
přesymbolizovávatelně	přesymbolizovávatelný	(C) NO PARENT BEFORE
přešroubovávatelně	přešroubovávatelný	(C) NO PARENT BEFORE
přeštukovávatelně	přeštukovávatelný	(C) NO PARENT BEFORE
přetetovávatelně	přetetovávatelný	(C) NO PARENT BEFORE
přetopolánkovávatelně	přetopolánkovávatelný	(C) NO PARENT BEFORE
převerbovávatelně	převerbovávatelný	(C) NO PARENT BEFORE
převolovávatelně	převolovávatelný	(C) NO PARENT BEFORE
přezónovávatelně	přezónovávatelný	(C) NO PARENT BEFORE
přežehlovávatelně	přežehlovávatelný	(C) NO PARENT BEFORE
přicukrovávatelně	přicukrovávatelný	(C) NO PARENT BEFORE
přidaňovávatelně	přidaňovávatelný	(C) NO PARENT BEFORE
přihmuřovávatelně	přihmuřovávatelný	(C) NO PARENT BEFORE
přihojovávatelně	přihojovávatelný	(C) NO PARENT BEFORE
přikrčovávatelně	přikrčovávatelný	(C) NO PARENT BEFORE
přikukovávatelně	přikukovávatelný	(C) NO PARENT BEFORE
přítelíčkovávatelně	přítelíčkovávatelný	(C) NO PARENT BEFORE
přivoňovávatelně	přivoňovávatelný	(C) NO PARENT BEFORE
psychiatrizovávatelně	psychiatrizovávatelný	(C) NO PARENT BEFORE
psychoanalyzovávatelně	psychoanalyzovávatelný	(C) NO PARENT BEFORE
pyskovávatelně	pyskovávatelný	(C) NO PARENT BEFORE
rautovávatelně	rautovávatelný	(C) NO PARENT BEFORE
reabsorbovávatelně	reabsorbovávatelný	(C) NO PARENT BEFORE
reambulovávatelně	reambulovávatelný	(C) NO PARENT BEFORE
rebalancovávatelně	rebalancovávatelný	(C) NO PARENT BEFORE
recertifikovávatelně	recertifikovávatelný	(C) NO PARENT BEFORE
redesignovávatelně	redesignovávatelný	(C) NO PARENT BEFORE
reduplikovávatelně	reduplikovávatelný	(C) NO PARENT BEFORE
reemitovávatelně	reemitovávatelný	(C) NO PARENT BEFORE
reformulovávatelně	reformulovávatelný	(C) NO PARENT BEFORE
regionalizovávatelně	regionalizovávatelný	(C) NO PARENT BEFORE
rehydratovávatelně	rehydratovávatelný	(C) NO PARENT BEFORE
rekanalizovávatelně	rekanalizovávatelný	(C) NO PARENT BEFORE
rekontextualizovávatelně	rekontextualizovávatelný	(C) NO PARENT BEFORE
relativovávatelně	relativovávatelný	(C) NO PARENT BEFORE
remastrovávatelně	remastrovávatelný	(C) NO PARENT BEFORE
remontovávatelně	remontovávatelný	(C) NO PARENT BEFORE
renacionalizovávatelně	renacionalizovávatelný	(C) NO PARENT BEFORE
renegociovávatelně	renegociovávatelný	(C) NO PARENT BEFORE
reoperovávatelně	reoperovávatelný	(C) NO PARENT BEFORE
reorientovávatelně	reorientovávatelný	(C) NO PARENT BEFORE
repolarizovávatelně	repolarizovávatelný	(C) NO PARENT BEFORE
repovávatelně	repovávatelný	(C) NO PARENT BEFORE
repreparovávatelně	repreparovávatelný	(C) NO PARENT BEFORE
reprofilovávatelně	reprofilovávatelný	(C) NO PARENT BEFORE
retinovávatelně	retinovávatelný	(C) NO PARENT BEFORE
retrofitovávatelně	retrofitovávatelný	(C) NO PARENT BEFORE
revakcinovávatelně	revakcinovávatelný	(C) NO PARENT BEFORE
revaskularizovávatelně	revaskularizovávatelný	(C) NO PARENT BEFORE
rolbovávatelně	rolbovávatelný	(C) NO PARENT BEFORE
rošovávatelně	rošovávatelný	(C) NO PARENT BEFORE
rozbojovávatelně	rozbojovávatelný	(C) NO PARENT BEFORE
rozborovávatelně	rozborovávatelný	(C) NO PARENT BEFORE
rozcestovávatelně	rozcestovávatelný	(C) NO PARENT BEFORE
rozcuckovávatelně	rozcuckovávatelný	(C) NO PARENT BEFORE
rozčepovávatelně	rozčepovávatelný	(C) NO PARENT BEFORE
rozdrancovávatelně	rozdrancovávatelný	(C) NO PARENT BEFORE
rozesazovávatelně	rozesazovávatelný	(C) NO PARENT BEFORE
rozfajrovávatelně	rozfajrovávatelný	(C) NO PARENT BEFORE
rozhecovávatelně	rozhecovávatelný	(C) NO PARENT BEFORE
rozchvacovávatelně	rozchvacovávatelný	(C) NO PARENT BEFORE
rozpádlovávatelně	rozpádlovávatelný	(C) NO PARENT BEFORE
rozpamatovávatelně	rozpamatovávatelný	(C) NO PARENT BEFORE
rozpárovávatelně	rozpárovávatelný	(C) NO PARENT BEFORE
rozpásmovávatelně	rozpásmovávatelný	(C) NO PARENT BEFORE
rozpěstovávatelně	rozpěstovávatelný	(C) NO PARENT BEFORE
rozpilovávatelně	rozpilovávatelný	(C) NO PARENT BEFORE
rozpixelovávatelně	rozpixelovávatelný	(C) NO PARENT BEFORE
rozplombovávatelně	rozplombovávatelný	(C) NO PARENT BEFORE
rozpoložkovávatelně	rozpoložkovávatelný	(C) NO PARENT BEFORE
rozposunovávatelně	rozposunovávatelný	(C) NO PARENT BEFORE
rozprivatizovávatelně	rozprivatizovávatelný	(C) NO PARENT BEFORE
rozprostraňovávatelně	rozprostraňovávatelný	(C) NO PARENT BEFORE
rozprskovávatelně	rozprskovávatelný	(C) NO PARENT BEFORE
rozpříčkovávatelně	rozpříčkovávatelný	(C) NO PARENT BEFORE
rozpulzovávatelně	rozpulzovávatelný	(C) NO PARENT BEFORE
rozpumprdlíkovávatelně	rozpumprdlíkovávatelný	(C) NO PARENT BEFORE
roztmelovávatelně	roztmelovávatelný	(C) NO PARENT BEFORE
roztrénovávatelně	roztrénovávatelný	(C) NO PARENT BEFORE
rutinizovávatelně	rutinizovávatelný	(C) NO PARENT BEFORE
sabrážovávatelně	sabrážovávatelný	(C) NO PARENT BEFORE
samolikvidovávatelně	samolikvidovávatelný	(C) NO PARENT BEFORE
samoočišťovávatelně	samoočišťovávatelný	(C) NO PARENT BEFORE
samoopylovávatelně	samoopylovávatelný	(C) NO PARENT BEFORE
samopasovávatelně	samopasovávatelný	(C) NO PARENT BEFORE
samoprezentovávatelně	samoprezentovávatelný	(C) NO PARENT BEFORE
samoprivatizovávatelně	samoprivatizovávatelný	(C) NO PARENT BEFORE
samoprodukovávatelně	samoprodukovávatelný	(C) NO PARENT BEFORE
samoreprodukovávatelně	samoreprodukovávatelný	(C) NO PARENT BEFORE
samorozšiřovávatelně	samorozšiřovávatelný	(C) NO PARENT BEFORE
samospravovávatelně	samospravovávatelný	(C) NO PARENT BEFORE
samostudovávatelně	samostudovávatelný	(C) NO PARENT BEFORE
samotitulovávatelně	samotitulovávatelný	(C) NO PARENT BEFORE
samovyměřovávatelně	samovyměřovávatelný	(C) NO PARENT BEFORE
samovyšetřovávatelně	samovyšetřovávatelný	(C) NO PARENT BEFORE
samovzněcovávatelně	samovzněcovávatelný	(C) NO PARENT BEFORE
samozásobovávatelně	samozásobovávatelný	(C) NO PARENT BEFORE
samozlikvidovávatelně	samozlikvidovávatelný	(C) NO PARENT BEFORE
sanitovávatelně	sanitovávatelný	(C) NO PARENT BEFORE
sbalíkovávatelně	sbalíkovávatelný	(C) NO PARENT BEFORE
scatovávatelně	scatovávatelný	(C) NO PARENT BEFORE
scratchovávatelně	scratchovávatelný	(C) NO PARENT BEFORE
sekuritizovávatelně	sekuritizovávatelný	(C) NO PARENT BEFORE
senzitizovávatelně	senzitizovávatelný	(C) NO PARENT BEFORE
serfovávatelně	serfovávatelný	(C) NO PARENT BEFORE
seštěpkovávatelně	seštěpkovávatelný	(C) NO PARENT BEFORE
sešvindlovávatelně	sešvindlovávatelný	(C) NO PARENT BEFORE
sfáčovávatelně	sfáčovávatelný	(C) NO PARENT BEFORE
sfúzovávatelně	sfúzovávatelný	(C) NO PARENT BEFORE
shybovávatelně	shybovávatelný	(C) NO PARENT BEFORE
skipovávatelně	skipovávatelný	(C) NO PARENT BEFORE
skypovávatelně	skypovávatelný	(C) NO PARENT BEFORE
skytovávatelně	skytovávatelný	(C) NO PARENT BEFORE
slalomovávatelně	slalomovávatelný	(C) NO PARENT BEFORE
slámovávatelně	slámovávatelný	(C) NO PARENT BEFORE
směnovávatelně	směnovávatelný	(C) NO PARENT BEFORE
smlčovávatelně	smlčovávatelný	(C) NO PARENT BEFORE
somatizovávatelně	somatizovávatelný	(C) NO PARENT BEFORE
sortýrovávatelně	sortýrovávatelný	(C) NO PARENT BEFORE
soustachírovávatelně	soustachírovávatelný	(C) NO PARENT BEFORE
spamovávatelně	spamovávatelný	(C) NO PARENT BEFORE
spasovávatelně	spasovávatelný	(C) NO PARENT BEFORE
spojkovávatelně	spojkovávatelný	(C) NO PARENT BEFORE
spolufinacovávatelně	spolufinacovávatelný	(C) NO PARENT BEFORE
spolunominovávatelně	spolunominovávatelný	(C) NO PARENT BEFORE
spoluschvalovávatelně	spoluschvalovávatelný	(C) NO PARENT BEFORE
squatovávatelně	squatovávatelný	(C) NO PARENT BEFORE
strečovávatelně	strečovávatelný	(C) NO PARENT BEFORE
strokovávatelně	strokovávatelný	(C) NO PARENT BEFORE
supervenovávatelně	supervenovávatelný	(C) NO PARENT BEFORE
sveslovávatelně	sveslovávatelný	(C) NO PARENT BEFORE
symetrizovávatelně	symetrizovávatelný	(C) NO PARENT BEFORE
šábovávatelně	šábovávatelný	(C) NO PARENT BEFORE
širákovávatelně	širákovávatelný	(C) NO PARENT BEFORE
šmigrustovávatelně	šmigrustovávatelný	(C) NO PARENT BEFORE
špízovávatelně	špízovávatelný	(C) NO PARENT BEFORE
tamborírovávatelně	tamborírovávatelný	(C) NO PARENT BEFORE
tapecírovávatelně	tapecírovávatelný	(C) NO PARENT BEFORE
tarifikovávatelně	tarifikovávatelný	(C) NO PARENT BEFORE
tatarovávatelně	tatarovávatelný	(C) NO PARENT BEFORE
tématizovávatelně	tématizovávatelný	(C) NO PARENT BEFORE
tempovávatelně	tempovávatelný	(C) NO PARENT BEFORE
tendrovávatelně	tendrovávatelný	(C) NO PARENT BEFORE
térovávatelně	térovávatelný	(C) NO PARENT BEFORE
thesaurovávatelně	thesaurovávatelný	(C) NO PARENT BEFORE
trejdovávatelně	trejdovávatelný	(C) NO PARENT BEFORE
tuplovávatelně	tuplovávatelný	(C) NO PARENT BEFORE
twitterovávatelně	twitterovávatelný	(C) NO PARENT BEFORE
týčkovávatelně	týčkovávatelný	(C) NO PARENT BEFORE
týmovávatelně	týmovávatelný	(C) NO PARENT BEFORE
uargumentovávatelně	uargumentovávatelný	(C) NO PARENT BEFORE
ubalancovávatelně	ubalancovávatelný	(C) NO PARENT BEFORE
udrátovávatelně	udrátovávatelný	(C) NO PARENT BEFORE
uchraňovávatelně	uchraňovávatelný	(C) NO PARENT BEFORE
ukontrolovávatelně	ukontrolovávatelný	(C) NO PARENT BEFORE
ukoučovávatelně	ukoučovávatelný	(C) NO PARENT BEFORE
ulyžovávatelně	ulyžovávatelný	(C) NO PARENT BEFORE
umanévrovávatelně	umanévrovávatelný	(C) NO PARENT BEFORE
upádlovávatelně	upádlovávatelný	(C) NO PARENT BEFORE
upluhovávatelně	upluhovávatelný	(C) NO PARENT BEFORE
urejdovávatelně	urejdovávatelný	(C) NO PARENT BEFORE
urežírovávatelně	urežírovávatelný	(C) NO PARENT BEFORE
urolbovávatelně	urolbovávatelný	(C) NO PARENT BEFORE
usledovávatelně	usledovávatelný	(C) NO PARENT BEFORE
usoudcovávatelně	usoudcovávatelný	(C) NO PARENT BEFORE
usoudruhovávatelně	usoudruhovávatelný	(C) NO PARENT BEFORE
uštrykovávatelně	uštrykovávatelný	(C) NO PARENT BEFORE
utaktizovávatelně	utaktizovávatelný	(C) NO PARENT BEFORE
utilizovávatelně	utilizovávatelný	(C) NO PARENT BEFORE
uveslovávatelně	uveslovávatelný	(C) NO PARENT BEFORE
vaničkovávatelně	vaničkovávatelný	(C) NO PARENT BEFORE
vertikutovávatelně	vertikutovávatelný	(C) NO PARENT BEFORE
videotelefonovávatelně	videotelefonovávatelný	(C) NO PARENT BEFORE
vobětovávatelně	vobětovávatelný	(C) NO PARENT BEFORE
voblažovávatelně	voblažovávatelný	(C) NO PARENT BEFORE
voblbovávatelně	voblbovávatelný	(C) NO PARENT BEFORE
vobletovávatelně	vobletovávatelný	(C) NO PARENT BEFORE
voblizovávatelně	voblizovávatelný	(C) NO PARENT BEFORE
vobtěžovávatelně	vobtěžovávatelný	(C) NO PARENT BEFORE
vočumovávatelně	vočumovávatelný	(C) NO PARENT BEFORE
vodhalovávatelně	vodhalovávatelný	(C) NO PARENT BEFORE
vodhazovávatelně	vodhazovávatelný	(C) NO PARENT BEFORE
vodpádlovávatelně	vodpádlovávatelný	(C) NO PARENT BEFORE
vodpracovávatelně	vodpracovávatelný	(C) NO PARENT BEFORE
vodpuzovávatelně	vodpuzovávatelný	(C) NO PARENT BEFORE
vpresovávatelně	vpresovávatelný	(C) NO PARENT BEFORE
vyartikulovávatelně	vyartikulovávatelný	(C) NO PARENT BEFORE
vybruslovávatelně	vybruslovávatelný	(C) NO PARENT BEFORE
vybržďovávatelně	vybržďovávatelný	(C) NO PARENT BEFORE
vyčenžovávatelně	vyčenžovávatelný	(C) NO PARENT BEFORE
vydiskutovávatelně	vydiskutovávatelný	(C) NO PARENT BEFORE
vydokladovávatelně	vydokladovávatelný	(C) NO PARENT BEFORE
vydotovávatelně	vydotovávatelný	(C) NO PARENT BEFORE
vyemitovávatelně	vyemitovávatelný	(C) NO PARENT BEFORE
vyexovávatelně	vyexovávatelný	(C) NO PARENT BEFORE
vyfabrikovávatelně	vyfabrikovávatelný	(C) NO PARENT BEFORE
vykonzolovávatelně	vykonzolovávatelný	(C) NO PARENT BEFORE
vykonzultovávatelně	vykonzultovávatelný	(C) NO PARENT BEFORE
vyloktovávatelně	vyloktovávatelný	(C) NO PARENT BEFORE
vymapovávatelně	vymapovávatelný	(C) NO PARENT BEFORE
vymisťovávatelně	vymisťovávatelný	(C) NO PARENT BEFORE
vymražovávatelně	vymražovávatelný	(C) NO PARENT BEFORE
vyoutovávatelně	vyoutovávatelný	(C) NO PARENT BEFORE
vypádlovávatelně	vypádlovávatelný	(C) NO PARENT BEFORE
vysádkovávatelně	vysádkovávatelný	(C) NO PARENT BEFORE
vysamplovávatelně	vysamplovávatelný	(C) NO PARENT BEFORE
vyslancovávatelně	vyslancovávatelný	(C) NO PARENT BEFORE
vysprejovávatelně	vysprejovávatelný	(C) NO PARENT BEFORE
vyšpekovávatelně	vyšpekovávatelný	(C) NO PARENT BEFORE
vyšťavovávatelně	vyšťavovávatelný	(C) NO PARENT BEFORE
vyštengrovávatelně	vyštengrovávatelný	(C) NO PARENT BEFORE
vyšúrovávatelně	vyšúrovávatelný	(C) NO PARENT BEFORE
vytendrovávatelně	vytendrovávatelný	(C) NO PARENT BEFORE
vytestovávatelně	vytestovávatelný	(C) NO PARENT BEFORE
vyzvětšovávatelně	vyzvětšovávatelný	(C) NO PARENT BEFORE
westernizovávatelně	westernizovávatelný	(C) NO PARENT BEFORE
zabalíčkovávatelně	zabalíčkovávatelný	(C) NO PARENT BEFORE
zabalíkovávatelně	zabalíkovávatelný	(C) NO PARENT BEFORE
zaběžkovávatelně	zaběžkovávatelný	(C) NO PARENT BEFORE
zadatovávatelně	zadatovávatelný	(C) NO PARENT BEFORE
zadotovávatelně	zadotovávatelný	(C) NO PARENT BEFORE
zadrápkovávatelně	zadrápkovávatelný	(C) NO PARENT BEFORE
zadžemovávatelně	zadžemovávatelný	(C) NO PARENT BEFORE
zaexhibovávatelně	zaexhibovávatelný	(C) NO PARENT BEFORE
zahulovávatelně	zahulovávatelný	(C) NO PARENT BEFORE
zachatovávatelně	zachatovávatelný	(C) NO PARENT BEFORE
zainstalovávatelně	zainstalovávatelný	(C) NO PARENT BEFORE
zakapsovávatelně	zakapsovávatelný	(C) NO PARENT BEFORE
zakoncentrovávatelně	zakoncentrovávatelný	(C) NO PARENT BEFORE
zakoncipovávatelně	zakoncipovávatelný	(C) NO PARENT BEFORE
zakonferovávatelně	zakonferovávatelný	(C) NO PARENT BEFORE
zakonkurovávatelně	zakonkurovávatelný	(C) NO PARENT BEFORE
zakontrahovávatelně	zakontrahovávatelný	(C) NO PARENT BEFORE
zakonverzovávatelně	zakonverzovávatelný	(C) NO PARENT BEFORE
zakoučovávatelně	zakoučovávatelný	(C) NO PARENT BEFORE
zakreditovávatelně	zakreditovávatelný	(C) NO PARENT BEFORE
zakůrovávatelně	zakůrovávatelný	(C) NO PARENT BEFORE
zamotivovávatelně	zamotivovávatelný	(C) NO PARENT BEFORE
zamulčovávatelně	zamulčovávatelný	(C) NO PARENT BEFORE
zaobcovávatelně	zaobcovávatelný	(C) NO PARENT BEFORE
zaoperovávatelně	zaoperovávatelný	(C) NO PARENT BEFORE
zapachovávatelně	zapachovávatelný	(C) NO PARENT BEFORE
zapogovávatelně	zapogovávatelný	(C) NO PARENT BEFORE
zaprezentovávatelně	zaprezentovávatelný	(C) NO PARENT BEFORE
zapytlovávatelně	zapytlovávatelný	(C) NO PARENT BEFORE
zarabovávatelně	zarabovávatelný	(C) NO PARENT BEFORE
zaregulovávatelně	zaregulovávatelný	(C) NO PARENT BEFORE
zarelaxovávatelně	zarelaxovávatelný	(C) NO PARENT BEFORE
zarestovávatelně	zarestovávatelný	(C) NO PARENT BEFORE
zargumentovávatelně	zargumentovávatelný	(C) NO PARENT BEFORE
zarockovávatelně	zarockovávatelný	(C) NO PARENT BEFORE
zarotovávatelně	zarotovávatelný	(C) NO PARENT BEFORE
zasáňkovávatelně	zasáňkovávatelný	(C) NO PARENT BEFORE
zasejfovávatelně	zasejfovávatelný	(C) NO PARENT BEFORE
zasjezdovávatelně	zasjezdovávatelný	(C) NO PARENT BEFORE
zaskládkovávatelně	zaskládkovávatelný	(C) NO PARENT BEFORE
zasporovávatelně	zasporovávatelný	(C) NO PARENT BEFORE
zasuplovávatelně	zasuplovávatelný	(C) NO PARENT BEFORE
zašnorchlovávatelně	zašnorchlovávatelný	(C) NO PARENT BEFORE
zašopovávatelně	zašopovávatelný	(C) NO PARENT BEFORE
zašpérovávatelně	zašpérovávatelný	(C) NO PARENT BEFORE
zašumlovávatelně	zašumlovávatelný	(C) NO PARENT BEFORE
zatemperovávatelně	zatemperovávatelný	(C) NO PARENT BEFORE
zateoretizovávatelně	zateoretizovávatelný	(C) NO PARENT BEFORE
zatrolejovávatelně	zatrolejovávatelný	(C) NO PARENT BEFORE
zauditovávatelně	zauditovávatelný	(C) NO PARENT BEFORE
zavetovávatelně	zavetovávatelný	(C) NO PARENT BEFORE
zavkladovávatelně	zavkladovávatelný	(C) NO PARENT BEFORE
zazoomovávatelně	zazoomovávatelný	(C) NO PARENT BEFORE
zazorbovávatelně	zazorbovávatelný	(C) NO PARENT BEFORE
zbuzerovávatelně	zbuzerovávatelný	(C) NO PARENT BEFORE
zdemontovávatelně	zdemontovávatelný	(C) NO PARENT BEFORE
zdirigovávatelně	zdirigovávatelný	(C) NO PARENT BEFORE
zdominovávatelně	zdominovávatelný	(C) NO PARENT BEFORE
zdrojovávatelně	zdrojovávatelný	(C) NO PARENT BEFORE
zdublovávatelně	zdublovávatelný	(C) NO PARENT BEFORE
zdůvěryhodňovávatelně	zdůvěryhodňovávatelný	(C) NO PARENT BEFORE
zelektronizovávatelně	zelektronizovávatelný	(C) NO PARENT BEFORE
zestaršovávatelně	zestaršovávatelný	(C) NO PARENT BEFORE
zestařovávatelně	zestařovávatelný	(C) NO PARENT BEFORE
zfiletovávatelně	zfiletovávatelný	(C) NO PARENT BEFORE
zflikovávatelně	zflikovávatelný	(C) NO PARENT BEFORE
zfotodokumentovávatelně	zfotodokumentovávatelný	(C) NO PARENT BEFORE
zfrézovávatelně	zfrézovávatelný	(C) NO PARENT BEFORE
zgenerálkovávatelně	zgenerálkovávatelný	(C) NO PARENT BEFORE
zglobalizovávatelně	zglobalizovávatelný	(C) NO PARENT BEFORE
zchudobňovávatelně	zchudobňovávatelný	(C) NO PARENT BEFORE
zintelektualizovávatelně	zintelektualizovávatelný	(C) NO PARENT BEFORE
zjednosměrňovávatelně	zjednosměrňovávatelný	(C) NO PARENT BEFORE
zjizvovávatelně	zjizvovávatelný	(C) NO PARENT BEFORE
zkafovávatelně	zkafovávatelný	(C) NO PARENT BEFORE
zlobbovávatelně	zlobbovávatelný	(C) NO PARENT BEFORE
zmanažerovávatelně	zmanažerovávatelný	(C) NO PARENT BEFORE
zmasterovávatelně	zmasterovávatelný	(C) NO PARENT BEFORE
zmermomocňovávatelně	zmermomocňovávatelný	(C) NO PARENT BEFORE
zmineralizovávatelně	zmineralizovávatelný	(C) NO PARENT BEFORE
zmystifikovávatelně	zmystifikovávatelný	(C) NO PARENT BEFORE
znedůvěryhodňovávatelně	znedůvěryhodňovávatelný	(C) NO PARENT BEFORE
zneviditelňovávatelně	zneviditelňovávatelný	(C) NO PARENT BEFORE
zniterňovávatelně	zniterňovávatelný	(C) NO PARENT BEFORE
znovicírovávatelně	znovicírovávatelný	(C) NO PARENT BEFORE
znovunastartovávatelně	znovunastartovávatelný	(C) NO PARENT BEFORE
znovuzabydlovávatelně	znovuzabydlovávatelný	(C) NO PARENT BEFORE
znovuzbudovávatelně	znovuzbudovávatelný	(C) NO PARENT BEFORE
zokruhovávatelně	zokruhovávatelný	(C) NO PARENT BEFORE
zoperovávatelně	zoperovávatelný	(C) NO PARENT BEFORE
zprocesovávatelně	zprocesovávatelný	(C) NO PARENT BEFORE
zprodukovávatelně	zprodukovávatelný	(C) NO PARENT BEFORE
zprojektovávatelně	zprojektovávatelný	(C) NO PARENT BEFORE
zrekolaudovávatelně	zrekolaudovávatelný	(C) NO PARENT BEFORE
zremasterovávatelně	zremasterovávatelný	(C) NO PARENT BEFORE
zremixovávatelně	zremixovávatelný	(C) NO PARENT BEFORE
zremízovávatelně	zremízovávatelný	(C) NO PARENT BEFORE
zreponovávatelně	zreponovávatelný	(C) NO PARENT BEFORE
zresuscitovávatelně	zresuscitovávatelný	(C) NO PARENT BEFORE
zreturnovávatelně	zreturnovávatelný	(C) NO PARENT BEFORE
zrevitalizovávatelně	zrevitalizovávatelný	(C) NO PARENT BEFORE
zrevokovávatelně	zrevokovávatelný	(C) NO PARENT BEFORE
zrujnovávatelně	zrujnovávatelný	(C) NO PARENT BEFORE
ztečovávatelně	ztečovávatelný	(C) NO PARENT BEFORE
ztrátovávatelně	ztrátovávatelný	(C) NO PARENT BEFORE
zvěrohodňovávatelně	zvěrohodňovávatelný	(C) NO PARENT BEFORE
