dokamenovávatelnì	dokamenovávatelný	(E) PARENT DIFFERENT, CURRENT PARENT=	dokovávatelný
dolarizovávatelnì	dolarizovávatelný	(E) PARENT DIFFERENT, CURRENT PARENT=	dolovávatelný
dopointovávatelnì	dopointovávatelný	(E) PARENT DIFFERENT, CURRENT PARENT=	dopovávatelný
dopøesòovávatelnì	dopøesòovávatelný	(E) PARENT DIFFERENT, CURRENT PARENT=	dopovávatelný
dotunelovávatelnì	dotunelovávatelný	(E) PARENT DIFFERENT, CURRENT PARENT=	dotovávatelný
instrumentalizovávatelnì	instrumentalizovávatelný	(E) PARENT DIFFERENT, CURRENT PARENT=	instrumentovávatelný
kacéøovávatelnì	kacéøovávatelný	(E) PARENT DIFFERENT, CURRENT PARENT=	kovávatelný
kamerovávatelnì	kamerovávatelný	(E) PARENT DIFFERENT, CURRENT PARENT=	kovávatelný
kapslovávatelnì	kapslovávatelný	(E) PARENT DIFFERENT, CURRENT PARENT=	kovávatelný
konotovávatelnì	konotovávatelný	(E) PARENT DIFFERENT, CURRENT PARENT=	kovávatelný
kupážovávatelnì	kupážovávatelný	(E) PARENT DIFFERENT, CURRENT PARENT=	kovávatelný
odklièkovávatelnì	odklièkovávatelný	(E) PARENT DIFFERENT, CURRENT PARENT=	odkovávatelný
odkmotrovávatelnì	odkmotrovávatelný	(E) PARENT DIFFERENT, CURRENT PARENT=	odkovávatelný
odkolíkovávatelnì	odkolíkovávatelný	(E) PARENT DIFFERENT, CURRENT PARENT=	odkovávatelný
okøížkovávatelnì	okøížkovávatelný	(E) PARENT DIFFERENT, CURRENT PARENT=	okovávatelný
pokamenovávatelnì	pokamenovávatelný	(E) PARENT DIFFERENT, CURRENT PARENT=	pokovávatelný
puchýøkovávatelnì	puchýøkovávatelný	(E) PARENT DIFFERENT, CURRENT PARENT=	pucovávatelný
radiofikovávatelnì	radiofikovávatelný	(E) PARENT DIFFERENT, CURRENT PARENT=	radiovávatelný
rozpumprlíkovávatelnì	rozpumprlíkovávatelný	(E) PARENT DIFFERENT, CURRENT PARENT=	rozpumpovávatelný
skolíkovávatelnì	skolíkovávatelný	(E) PARENT DIFFERENT, CURRENT PARENT=	skovávatelný
vykšeftovávatelnì	vykšeftovávatelný	(E) PARENT DIFFERENT, CURRENT PARENT=	vykovávatelný
zaposilovávatelnì	zaposilovávatelný	(E) PARENT DIFFERENT, CURRENT PARENT=	zapovávatelný
zkolážovávatelnì	zkolážovávatelný	(E) PARENT DIFFERENT, CURRENT PARENT=	zkovávatelný
zpumprlíkovávatelnì	zpumprlíkovávatelný	(E) PARENT DIFFERENT, CURRENT PARENT=	zpumpovávatelný
