dokamenovávaně	dokamenovávaný	(E) PARENT DIFFERENT, CURRENT PARENT=	dokovávaný
dolarizovávaně	dolarizovávaný	(E) PARENT DIFFERENT, CURRENT PARENT=	dolovávaný
dopointovávaně	dopointovávaný	(E) PARENT DIFFERENT, CURRENT PARENT=	dopovávaný
dopřesňovávaně	dopřesňovávaný	(E) PARENT DIFFERENT, CURRENT PARENT=	dopovávaný
dotunelovávaně	dotunelovávaný	(E) PARENT DIFFERENT, CURRENT PARENT=	dotovávaný
instrumentalizovávaně	instrumentalizovávaný	(E) PARENT DIFFERENT, CURRENT PARENT=	instrumentovávaný
kacéřovávaně	kacéřovávaný	(E) PARENT DIFFERENT, CURRENT PARENT=	kovávaný
kamerovávaně	kamerovávaný	(E) PARENT DIFFERENT, CURRENT PARENT=	kovávaný
kapslovávaně	kapslovávaný	(E) PARENT DIFFERENT, CURRENT PARENT=	kovávaný
konotovávaně	konotovávaný	(E) PARENT DIFFERENT, CURRENT PARENT=	kovávaný
kupážovávaně	kupážovávaný	(E) PARENT DIFFERENT, CURRENT PARENT=	kovávaný
odkličkovávaně	odkličkovávaný	(E) PARENT DIFFERENT, CURRENT PARENT=	odkovávaný
odkmotrovávaně	odkmotrovávaný	(E) PARENT DIFFERENT, CURRENT PARENT=	odkovávaný
odkolíkovávaně	odkolíkovávaný	(E) PARENT DIFFERENT, CURRENT PARENT=	odkovávaný
okřížkovávaně	okřížkovávaný	(E) PARENT DIFFERENT, CURRENT PARENT=	okovávaný
pokamenovávaně	pokamenovávaný	(E) PARENT DIFFERENT, CURRENT PARENT=	pokovávaný
puchýřkovávaně	puchýřkovávaný	(E) PARENT DIFFERENT, CURRENT PARENT=	pucovávaný
radiofikovávaně	radiofikovávaný	(E) PARENT DIFFERENT, CURRENT PARENT=	radiovávaný
rozpumprlíkovávaně	rozpumprlíkovávaný	(E) PARENT DIFFERENT, CURRENT PARENT=	rozpumpovávaný
skolíkovávaně	skolíkovávaný	(E) PARENT DIFFERENT, CURRENT PARENT=	skovávaný
vykšeftovávaně	vykšeftovávaný	(E) PARENT DIFFERENT, CURRENT PARENT=	vykovávaný
zaposilovávaně	zaposilovávaný	(E) PARENT DIFFERENT, CURRENT PARENT=	zapovávaný
zkolážovávaně	zkolážovávaný	(E) PARENT DIFFERENT, CURRENT PARENT=	zkovávaný
zpumprlíkovávaně	zpumprlíkovávaný	(E) PARENT DIFFERENT, CURRENT PARENT=	zpumpovávaný
