adherovávaně	adherovávaný	(C) NO PARENT BEFORE
afirmovávaně	afirmovávaný	(C) NO PARENT BEFORE
alfabetizovávaně	alfabetizovávaný	(C) NO PARENT BEFORE
amalgamovávaně	amalgamovávaný	(C) NO PARENT BEFORE
anatomizovávaně	anatomizovávaný	(C) NO PARENT BEFORE
apgrejdovávaně	apgrejdovávaný	(C) NO PARENT BEFORE
apreciovávaně	apreciovávaný	(C) NO PARENT BEFORE
arbitrovávaně	arbitrovávaný	(C) NO PARENT BEFORE
asamblovávaně	asamblovávaný	(C) NO PARENT BEFORE
autentifikovávaně	autentifikovávaný	(C) NO PARENT BEFORE
autovávaně	autovávaný	(C) NO PARENT BEFORE
backtestovávaně	backtestovávaný	(C) NO PARENT BEFORE
bálovávaně	bálovávaný	(C) NO PARENT BEFORE
balzakovávaně	balzakovávaný	(C) NO PARENT BEFORE
bankovávaně	bankovávaný	(C) NO PARENT BEFORE
barbarizovávaně	barbarizovávaný	(C) NO PARENT BEFORE
barterovávaně	barterovávaný	(C) NO PARENT BEFORE
betatestovávaně	betatestovávaný	(C) NO PARENT BEFORE
bezplenkovávaně	bezplenkovávaný	(C) NO PARENT BEFORE
bikovávaně	bikovávaný	(C) NO PARENT BEFORE
bluesovávaně	bluesovávaný	(C) NO PARENT BEFORE
bohovávaně	bohovávaný	(C) NO PARENT BEFORE
bohyňovávaně	bohyňovávaný	(C) NO PARENT BEFORE
brandovávaně	brandovávaný	(C) NO PARENT BEFORE
brasírovávaně	brasírovávaný	(C) NO PARENT BEFORE
bublinkovávaně	bublinkovávaný	(C) NO PARENT BEFORE
carvovávaně	carvovávaný	(C) NO PARENT BEFORE
copyrightovávaně	copyrightovávaný	(C) NO PARENT BEFORE
cyklizovávaně	cyklizovávaný	(C) NO PARENT BEFORE
čantovávaně	čantovávaný	(C) NO PARENT BEFORE
čekovávaně	čekovávaný	(C) NO PARENT BEFORE
čórovávaně	čórovávaný	(C) NO PARENT BEFORE
čunkovávaně	čunkovávaný	(C) NO PARENT BEFORE
dealkoholizovávaně	dealkoholizovávaný	(C) NO PARENT BEFORE
dealovávaně	dealovávaný	(C) NO PARENT BEFORE
deeskalovávaně	deeskalovávaný	(C) NO PARENT BEFORE
defibrilovávaně	defibrilovávaný	(C) NO PARENT BEFORE
dekomunizovávaně	dekomunizovávaný	(C) NO PARENT BEFORE
dekoncentrovávaně	dekoncentrovávaný	(C) NO PARENT BEFORE
demytologizovávaně	demytologizovávaný	(C) NO PARENT BEFORE
denudovávaně	denudovávaný	(C) NO PARENT BEFORE
denuklearizovávaně	denuklearizovávaný	(C) NO PARENT BEFORE
depenalizovávaně	depenalizovávaný	(C) NO PARENT BEFORE
depigmentovávaně	depigmentovávaný	(C) NO PARENT BEFORE
depreciovávaně	depreciovávaný	(C) NO PARENT BEFORE
derniérovávaně	derniérovávaný	(C) NO PARENT BEFORE
desakralizovávaně	desakralizovávaný	(C) NO PARENT BEFORE
destalinizovávaně	destalinizovávaný	(C) NO PARENT BEFORE
developovávaně	developovávaný	(C) NO PARENT BEFORE
diabolisovávaně	diabolisovávaný	(C) NO PARENT BEFORE
dialektizovávaně	dialektizovávaný	(C) NO PARENT BEFORE
dichotomizovávaně	dichotomizovávaný	(C) NO PARENT BEFORE
diskretizovávaně	diskretizovávaný	(C) NO PARENT BEFORE
dobalovávaně	dobalovávaný	(C) NO PARENT BEFORE
doblogovávaně	doblogovávaný	(C) NO PARENT BEFORE
dobubnovávaně	dobubnovávaný	(C) NO PARENT BEFORE
dobuzovávaně	dobuzovávaný	(C) NO PARENT BEFORE
dockovávaně	dockovávaný	(C) NO PARENT BEFORE
dodekorovávaně	dodekorovávaný	(C) NO PARENT BEFORE
dodiskutovávaně	dodiskutovávaný	(C) NO PARENT BEFORE
dodotovávaně	dodotovávaný	(C) NO PARENT BEFORE
dodrancovávaně	dodrancovávaný	(C) NO PARENT BEFORE
dofantazírovávaně	dofantazírovávaný	(C) NO PARENT BEFORE
dofixovávaně	dofixovávaný	(C) NO PARENT BEFORE
doháčkovávaně	doháčkovávaný	(C) NO PARENT BEFORE
dointonovávaně	dointonovávaný	(C) NO PARENT BEFORE
dojmenovávaně	dojmenovávaný	(C) NO PARENT BEFORE
dokanalizovávaně	dokanalizovávaný	(C) NO PARENT BEFORE
dokapitalizovávaně	dokapitalizovávaný	(C) NO PARENT BEFORE
dokombinovávaně	dokombinovávaný	(C) NO PARENT BEFORE
domanévrovávaně	domanévrovávaný	(C) NO PARENT BEFORE
domapovávaně	domapovávaný	(C) NO PARENT BEFORE
domilovávaně	domilovávaný	(C) NO PARENT BEFORE
doobchodovávaně	doobchodovávaný	(C) NO PARENT BEFORE
doopravovávaně	doopravovávaný	(C) NO PARENT BEFORE
dopichovávaně	dopichovávaný	(C) NO PARENT BEFORE
doplynofikovávaně	doplynofikovávaný	(C) NO PARENT BEFORE
doporcovávaně	doporcovávaný	(C) NO PARENT BEFORE
doradovávaně	doradovávaný	(C) NO PARENT BEFORE
doreformovávaně	doreformovávaný	(C) NO PARENT BEFORE
dosádrovávaně	dosádrovávaný	(C) NO PARENT BEFORE
doslavovávaně	doslavovávaný	(C) NO PARENT BEFORE
dospalovávaně	dospalovávaný	(C) NO PARENT BEFORE
dospárovávaně	dospárovávaný	(C) NO PARENT BEFORE
dosportovávaně	dosportovávaný	(C) NO PARENT BEFORE
dosprchovávaně	dosprchovávaný	(C) NO PARENT BEFORE
dostahovávaně	dostahovávaný	(C) NO PARENT BEFORE
dostopovávaně	dostopovávaný	(C) NO PARENT BEFORE
dosurfovávaně	dosurfovávaný	(C) NO PARENT BEFORE
dosvěcovávaně	dosvěcovávaný	(C) NO PARENT BEFORE
dotestovávaně	dotestovávaný	(C) NO PARENT BEFORE
dotěžovávaně	dotěžovávaný	(C) NO PARENT BEFORE
doupravovávaně	doupravovávaný	(C) NO PARENT BEFORE
douzovávaně	douzovávaný	(C) NO PARENT BEFORE
doválcovávaně	doválcovávaný	(C) NO PARENT BEFORE
drajvovávaně	drajvovávaný	(C) NO PARENT BEFORE
drezúrovávaně	drezúrovávaný	(C) NO PARENT BEFORE
drnovávaně	drnovávaný	(C) NO PARENT BEFORE
dřepovávaně	dřepovávaný	(C) NO PARENT BEFORE
džoukovávaně	džoukovávaný	(C) NO PARENT BEFORE
edukovávaně	edukovávaný	(C) NO PARENT BEFORE
echovávaně	echovávaný	(C) NO PARENT BEFORE
emblematizovávaně	emblematizovávaný	(C) NO PARENT BEFORE
empatizovávaně	empatizovávaný	(C) NO PARENT BEFORE
epilovávaně	epilovávaný	(C) NO PARENT BEFORE
euforizovávaně	euforizovávaný	(C) NO PARENT BEFORE
europeizovávaně	europeizovávaný	(C) NO PARENT BEFORE
exemplifikovávaně	exemplifikovávaný	(C) NO PARENT BEFORE
exprimovávaně	exprimovávaný	(C) NO PARENT BEFORE
fáborkovávaně	fáborkovávaný	(C) NO PARENT BEFORE
facebookovávaně	facebookovávaný	(C) NO PARENT BEFORE
facilitovávaně	facilitovávaný	(C) NO PARENT BEFORE
fanatizovávaně	fanatizovávaný	(C) NO PARENT BEFORE
festovírovávaně	festovírovávaný	(C) NO PARENT BEFORE
fibrilovávaně	fibrilovávaný	(C) NO PARENT BEFORE
flankovávaně	flankovávaný	(C) NO PARENT BEFORE
fluoridovávaně	fluoridovávaný	(C) NO PARENT BEFORE
fokalizovávaně	fokalizovávaný	(C) NO PARENT BEFORE
folklorizovávaně	folklorizovávaný	(C) NO PARENT BEFORE
frotážovávaně	frotážovávaný	(C) NO PARENT BEFORE
gramatikalizovávaně	gramatikalizovávaný	(C) NO PARENT BEFORE
hajduchovávaně	hajduchovávaný	(C) NO PARENT BEFORE
hajdukovávaně	hajdukovávaný	(C) NO PARENT BEFORE
haškovávaně	haškovávaný	(C) NO PARENT BEFORE
hegemonizovávaně	hegemonizovávaný	(C) NO PARENT BEFORE
hláškovávaně	hláškovávaný	(C) NO PARENT BEFORE
hlávkovávaně	hlávkovávaný	(C) NO PARENT BEFORE
homologizovávaně	homologizovávaný	(C) NO PARENT BEFORE
hybernovávaně	hybernovávaný	(C) NO PARENT BEFORE
hybridizovávaně	hybridizovávaný	(C) NO PARENT BEFORE
hydroizolovávaně	hydroizolovávaný	(C) NO PARENT BEFORE
hyperventilovávaně	hyperventilovávaný	(C) NO PARENT BEFORE
choreografovávaně	choreografovávaný	(C) NO PARENT BEFORE
ilegalizovávaně	ilegalizovávaný	(C) NO PARENT BEFORE
infantilizovávaně	infantilizovávaný	(C) NO PARENT BEFORE
institualizovávaně	institualizovávaný	(C) NO PARENT BEFORE
interiorizovávaně	interiorizovávaný	(C) NO PARENT BEFORE
intimizovávaně	intimizovávaný	(C) NO PARENT BEFORE
intubovávaně	intubovávaný	(C) NO PARENT BEFORE
investigovávaně	investigovávaný	(C) NO PARENT BEFORE
jazzovávaně	jazzovávaný	(C) NO PARENT BEFORE
kabelizovávaně	kabelizovávaný	(C) NO PARENT BEFORE
kapitánovávaně	kapitánovávaný	(C) NO PARENT BEFORE
kastovávaně	kastovávaný	(C) NO PARENT BEFORE
kaučovávaně	kaučovávaný	(C) NO PARENT BEFORE
kelímkovávaně	kelímkovávaný	(C) NO PARENT BEFORE
knockautovávaně	knockautovávaný	(C) NO PARENT BEFORE
komunizovávaně	komunizovávaný	(C) NO PARENT BEFORE
konceptualizovávaně	konceptualizovávaný	(C) NO PARENT BEFORE
kontejnerovávaně	kontejnerovávaný	(C) NO PARENT BEFORE
kontextualizovávaně	kontextualizovávaný	(C) NO PARENT BEFORE
korepetitovávaně	korepetitovávaný	(C) NO PARENT BEFORE
kvantizovávaně	kvantizovávaný	(C) NO PARENT BEFORE
lajkovávaně	lajkovávaný	(C) NO PARENT BEFORE
legendarizovávaně	legendarizovávaný	(C) NO PARENT BEFORE
lídrovávaně	lídrovávaný	(C) NO PARENT BEFORE
lignifikovávaně	lignifikovávaný	(C) NO PARENT BEFORE
lístkovávaně	lístkovávaný	(C) NO PARENT BEFORE
luhovávaně	luhovávaný	(C) NO PARENT BEFORE
lynchovávaně	lynchovávaný	(C) NO PARENT BEFORE
manažovávaně	manažovávaný	(C) NO PARENT BEFORE
maskulinizovávaně	maskulinizovávaný	(C) NO PARENT BEFORE
masterovávaně	masterovávaný	(C) NO PARENT BEFORE
mastrovávaně	mastrovávaný	(C) NO PARENT BEFORE
meadrovávaně	meadrovávaný	(C) NO PARENT BEFORE
mejlovávaně	mejlovávaný	(C) NO PARENT BEFORE
mesmerizovávaně	mesmerizovávaný	(C) NO PARENT BEFORE
meziskladovávaně	meziskladovávaný	(C) NO PARENT BEFORE
mitigovávaně	mitigovávaný	(C) NO PARENT BEFORE
mobilovávaně	mobilovávaný	(C) NO PARENT BEFORE
monetizovávaně	monetizovávaný	(C) NO PARENT BEFORE
mýtizovávaně	mýtizovávaný	(C) NO PARENT BEFORE
nabalíkovávaně	nabalíkovávaný	(C) NO PARENT BEFORE
nabalzámovávaně	nabalzámovávaný	(C) NO PARENT BEFORE
nabatikovávaně	nabatikovávaný	(C) NO PARENT BEFORE
nabodovávaně	nabodovávaný	(C) NO PARENT BEFORE
nabonzovávaně	nabonzovávaný	(C) NO PARENT BEFORE
nabrífovávaně	nabrífovávaný	(C) NO PARENT BEFORE
nabruslovávaně	nabruslovávaný	(C) NO PARENT BEFORE
naburcovávaně	naburcovávaný	(C) NO PARENT BEFORE
nacejchovávaně	nacejchovávaný	(C) NO PARENT BEFORE
načárovávaně	načárovávaný	(C) NO PARENT BEFORE
načunkovávaně	načunkovávaný	(C) NO PARENT BEFORE
nadekorovávaně	nadekorovávaný	(C) NO PARENT BEFORE
nadelegovávaně	nadelegovávaný	(C) NO PARENT BEFORE
nadesignovávaně	nadesignovávaný	(C) NO PARENT BEFORE
nadiskutovávaně	nadiskutovávaný	(C) NO PARENT BEFORE
nadrancovávaně	nadrancovávaný	(C) NO PARENT BEFORE
nadrážkovávaně	nadrážkovávaný	(C) NO PARENT BEFORE
nadrilovávaně	nadrilovávaný	(C) NO PARENT BEFORE
nadstavovávaně	nadstavovávaný	(C) NO PARENT BEFORE
nadstřešovávaně	nadstřešovávaný	(C) NO PARENT BEFORE
nafakturovávaně	nafakturovávaný	(C) NO PARENT BEFORE
nafrézovávaně	nafrézovávaný	(C) NO PARENT BEFORE
nagelovávaně	nagelovávaný	(C) NO PARENT BEFORE
nahláskovávaně	nahláskovávaný	(C) NO PARENT BEFORE
nachromovávaně	nachromovávaný	(C) NO PARENT BEFORE
nainvestovávaně	nainvestovávaný	(C) NO PARENT BEFORE
naježovávaně	naježovávaný	(C) NO PARENT BEFORE
nakalibrovávaně	nakalibrovávaný	(C) NO PARENT BEFORE
nakoncentrovávaně	nakoncentrovávaný	(C) NO PARENT BEFORE
nakondenzovávaně	nakondenzovávaný	(C) NO PARENT BEFORE
nakontraktovávaně	nakontraktovávaný	(C) NO PARENT BEFORE
nakouskovávaně	nakouskovávaný	(C) NO PARENT BEFORE
nakrepovávaně	nakrepovávaný	(C) NO PARENT BEFORE
nalahvovávaně	nalahvovávaný	(C) NO PARENT BEFORE
naleasovávaně	naleasovávaný	(C) NO PARENT BEFORE
nalyžovávaně	nalyžovávaný	(C) NO PARENT BEFORE
nametalizovávaně	nametalizovávaný	(C) NO PARENT BEFORE
namotivovávaně	namotivovávaný	(C) NO PARENT BEFORE
namulčovávaně	namulčovávaný	(C) NO PARENT BEFORE
nanormovávaně	nanormovávaný	(C) NO PARENT BEFORE
naobálkovávaně	naobálkovávaný	(C) NO PARENT BEFORE
naobdivovávaně	naobdivovávaný	(C) NO PARENT BEFORE
naobveselovávaně	naobveselovávaný	(C) NO PARENT BEFORE
naoperovávaně	naoperovávaný	(C) NO PARENT BEFORE
naoslavovávaně	naoslavovávaný	(C) NO PARENT BEFORE
naoxidovávaně	naoxidovávaný	(C) NO PARENT BEFORE
napatinovávaně	napatinovávaný	(C) NO PARENT BEFORE
napenetrovávaně	napenetrovávaný	(C) NO PARENT BEFORE
napiglovávaně	napiglovávaný	(C) NO PARENT BEFORE
napipetovávaně	napipetovávaný	(C) NO PARENT BEFORE
napodepisovávaně	napodepisovávaný	(C) NO PARENT BEFORE
napodmiňovávaně	napodmiňovávaný	(C) NO PARENT BEFORE
napochybovávaně	napochybovávaný	(C) NO PARENT BEFORE
naposilovávaně	naposilovávaný	(C) NO PARENT BEFORE
napoučovávaně	napoučovávaný	(C) NO PARENT BEFORE
napoukazovávaně	napoukazovávaný	(C) NO PARENT BEFORE
napozorovávaně	napozorovávaný	(C) NO PARENT BEFORE
napráškovávaně	napráškovávaný	(C) NO PARENT BEFORE
napreparovávaně	napreparovávaný	(C) NO PARENT BEFORE
naprodukovávaně	naprodukovávaný	(C) NO PARENT BEFORE
napropojovávaně	napropojovávaný	(C) NO PARENT BEFORE
naprotestovávaně	naprotestovávaný	(C) NO PARENT BEFORE
naproužkovávaně	naproužkovávaný	(C) NO PARENT BEFORE
napředstavovávaně	napředstavovávaný	(C) NO PARENT BEFORE
napřevodovávaně	napřevodovávaný	(C) NO PARENT BEFORE
narozčilovávaně	narozčilovávaný	(C) NO PARENT BEFORE
narozdělovávaně	narozdělovávaný	(C) NO PARENT BEFORE
narozumovávaně	narozumovávaný	(C) NO PARENT BEFORE
nashromažďovávaně	nashromažďovávaný	(C) NO PARENT BEFORE
naskládkovávaně	naskládkovávaný	(C) NO PARENT BEFORE
naskriptovávaně	naskriptovávaný	(C) NO PARENT BEFORE
nasněžovávaně	nasněžovávaný	(C) NO PARENT BEFORE
nasoudruhovávaně	nasoudruhovávaný	(C) NO PARENT BEFORE
naspídovávaně	naspídovávaný	(C) NO PARENT BEFORE
nasportovávaně	nasportovávaný	(C) NO PARENT BEFORE
nastimulovávaně	nastimulovávaný	(C) NO PARENT BEFORE
nastrukturovávaně	nastrukturovávaný	(C) NO PARENT BEFORE
nasudovávaně	nasudovávaný	(C) NO PARENT BEFORE
nasugerovávaně	nasugerovávaný	(C) NO PARENT BEFORE
nasužovávaně	nasužovávaný	(C) NO PARENT BEFORE
našamponovávaně	našamponovávaný	(C) NO PARENT BEFORE
naštemovávaně	naštemovávaný	(C) NO PARENT BEFORE
naštěpkovávaně	naštěpkovávaný	(C) NO PARENT BEFORE
naštukovávaně	naštukovávaný	(C) NO PARENT BEFORE
nataktovávaně	nataktovávaný	(C) NO PARENT BEFORE
natemperovávaně	natemperovávaný	(C) NO PARENT BEFORE
natestovávaně	natestovávaný	(C) NO PARENT BEFORE
natónovávaně	natónovávaný	(C) NO PARENT BEFORE
natrasovávaně	natrasovávaný	(C) NO PARENT BEFORE
natvarovávaně	natvarovávaný	(C) NO PARENT BEFORE
nautahovávaně	nautahovávaný	(C) NO PARENT BEFORE
naúvěrovávaně	naúvěrovávaný	(C) NO PARENT BEFORE
navakcinovávaně	navakcinovávaný	(C) NO PARENT BEFORE
naviksovávaně	naviksovávaný	(C) NO PARENT BEFORE
navočkovávaně	navočkovávaný	(C) NO PARENT BEFORE
navondulovávaně	navondulovávaný	(C) NO PARENT BEFORE
navracovávaně	navracovávaný	(C) NO PARENT BEFORE
navypůjčovávaně	navypůjčovávaný	(C) NO PARENT BEFORE
navysvětlovávaně	navysvětlovávaný	(C) NO PARENT BEFORE
navytahovávaně	navytahovávaný	(C) NO PARENT BEFORE
navyžadovávaně	navyžadovávaný	(C) NO PARENT BEFORE
nažalovávaně	nažalovávaný	(C) NO PARENT BEFORE
negociovávaně	negociovávaný	(C) NO PARENT BEFORE
noclehovávaně	noclehovávaný	(C) NO PARENT BEFORE
obatikovávaně	obatikovávaný	(C) NO PARENT BEFORE
obaťůžkovávaně	obaťůžkovávaný	(C) NO PARENT BEFORE
obestupovávaně	obestupovávaný	(C) NO PARENT BEFORE
obkličkovávaně	obkličkovávaný	(C) NO PARENT BEFORE
obojkovávaně	obojkovávaný	(C) NO PARENT BEFORE
obrejličkovávaně	obrejličkovávaný	(C) NO PARENT BEFORE
obrýsovávaně	obrýsovávaný	(C) NO PARENT BEFORE
obstřikovávaně	obstřikovávaný	(C) NO PARENT BEFORE
obšlapovávaně	obšlapovávaný	(C) NO PARENT BEFORE
obubnovávaně	obubnovávaný	(C) NO PARENT BEFORE
ocertifikovávaně	ocertifikovávaný	(C) NO PARENT BEFORE
ocitronovávaně	ocitronovávaný	(C) NO PARENT BEFORE
očekovávaně	očekovávaný	(C) NO PARENT BEFORE
odargumentovávaně	odargumentovávaný	(C) NO PARENT BEFORE
odbalkanizovávaně	odbalkanizovávaný	(C) NO PARENT BEFORE
odbaštovávaně	odbaštovávaný	(C) NO PARENT BEFORE
odblešovávaně	odblešovávaný	(C) NO PARENT BEFORE
odbreberkovávaně	odbreberkovávaný	(C) NO PARENT BEFORE
odbydlovávaně	odbydlovávaný	(C) NO PARENT BEFORE
oddeklamovávaně	oddeklamovávaný	(C) NO PARENT BEFORE
oddekretovávaně	oddekretovávaný	(C) NO PARENT BEFORE
oddramatizovávaně	oddramatizovávaný	(C) NO PARENT BEFORE
odekorovávaně	odekorovávaný	(C) NO PARENT BEFORE
odentrovávaně	odentrovávaný	(C) NO PARENT BEFORE
odfetovávaně	odfetovávaný	(C) NO PARENT BEFORE
odfinancovávaně	odfinancovávaný	(C) NO PARENT BEFORE
odháčkovávaně	odháčkovávaný	(C) NO PARENT BEFORE
odkomentovávaně	odkomentovávaný	(C) NO PARENT BEFORE
odkorkovávaně	odkorkovávaný	(C) NO PARENT BEFORE
odkrucovávaně	odkrucovávaný	(C) NO PARENT BEFORE
odkurtovávaně	odkurtovávaný	(C) NO PARENT BEFORE
odliberalizovávaně	odliberalizovávaný	(C) NO PARENT BEFORE
odlyžovávaně	odlyžovávaný	(C) NO PARENT BEFORE
odmýtizovávaně	odmýtizovávaný	(C) NO PARENT BEFORE
odorizovávaně	odorizovávaný	(C) NO PARENT BEFORE
odpluhovávaně	odpluhovávaný	(C) NO PARENT BEFORE
odpremiérovávaně	odpremiérovávaný	(C) NO PARENT BEFORE
odprezentovávaně	odprezentovávaný	(C) NO PARENT BEFORE
odprivatizovávaně	odprivatizovávaný	(C) NO PARENT BEFORE
odpružovávaně	odpružovávaný	(C) NO PARENT BEFORE
odputovávaně	odputovávaný	(C) NO PARENT BEFORE
odrátkovávaně	odrátkovávaný	(C) NO PARENT BEFORE
odrázovávaně	odrázovávaný	(C) NO PARENT BEFORE
odredovávaně	odredovávaný	(C) NO PARENT BEFORE
odreferovávaně	odreferovávaný	(C) NO PARENT BEFORE
odregulovávaně	odregulovávaný	(C) NO PARENT BEFORE
odrekreovávaně	odrekreovávaný	(C) NO PARENT BEFORE
odremizovávaně	odremizovávaný	(C) NO PARENT BEFORE
odretušovávaně	odretušovávaný	(C) NO PARENT BEFORE
odřazovávaně	odřazovávaný	(C) NO PARENT BEFORE
odservírovávaně	odservírovávaný	(C) NO PARENT BEFORE
odsexualizovávaně	odsexualizovávaný	(C) NO PARENT BEFORE
odsledovávaně	odsledovávaný	(C) NO PARENT BEFORE
odsmečovávaně	odsmečovávaný	(C) NO PARENT BEFORE
odsportovávaně	odsportovávaný	(C) NO PARENT BEFORE
odstávkovávaně	odstávkovávaný	(C) NO PARENT BEFORE
odstresovávaně	odstresovávaný	(C) NO PARENT BEFORE
odstudovávaně	odstudovávaný	(C) NO PARENT BEFORE
odšlapovávaně	odšlapovávaný	(C) NO PARENT BEFORE
odtestovávaně	odtestovávaný	(C) NO PARENT BEFORE
odtipovávaně	odtipovávaný	(C) NO PARENT BEFORE
odúřadovávaně	odúřadovávaný	(C) NO PARENT BEFORE
odválcovávaně	odválcovávaný	(C) NO PARENT BEFORE
odventilovávaně	odventilovávaný	(C) NO PARENT BEFORE
odzdržovávaně	odzdržovávaný	(C) NO PARENT BEFORE
odztrátovávaně	odztrátovávaný	(C) NO PARENT BEFORE
odzvoňovávaně	odzvoňovávaný	(C) NO PARENT BEFORE
ofáborkovávaně	ofáborkovávaný	(C) NO PARENT BEFORE
ofáborovávaně	ofáborovávaný	(C) NO PARENT BEFORE
oglosovávaně	oglosovávaný	(C) NO PARENT BEFORE
ohonorovávaně	ohonorovávaný	(C) NO PARENT BEFORE
okachličkovávaně	okachličkovávaný	(C) NO PARENT BEFORE
okloboukovávaně	okloboukovávaný	(C) NO PARENT BEFORE
okostýmovávaně	okostýmovávaný	(C) NO PARENT BEFORE
opálkovávaně	opálkovávaný	(C) NO PARENT BEFORE
operacionalizovávaně	operacionalizovávaný	(C) NO PARENT BEFORE
oplošťovávaně	oplošťovávaný	(C) NO PARENT BEFORE
opocovávaně	opocovávaný	(C) NO PARENT BEFORE
oponožkovávaně	oponožkovávaný	(C) NO PARENT BEFORE
oprávkovávaně	oprávkovávaný	(C) NO PARENT BEFORE
opřipomínkovávaně	opřipomínkovávaný	(C) NO PARENT BEFORE
opuntíkovávaně	opuntíkovávaný	(C) NO PARENT BEFORE
opupínkovávaně	opupínkovávaný	(C) NO PARENT BEFORE
osekvenovávaně	osekvenovávaný	(C) NO PARENT BEFORE
oservisovávaně	oservisovávaný	(C) NO PARENT BEFORE
oskórovávaně	oskórovávaný	(C) NO PARENT BEFORE
osondovávaně	osondovávaný	(C) NO PARENT BEFORE
ospurtovávaně	ospurtovávaný	(C) NO PARENT BEFORE
ošéfovávaně	ošéfovávaný	(C) NO PARENT BEFORE
ošvejkovávaně	ošvejkovávaný	(C) NO PARENT BEFORE
otapetovávaně	otapetovávaný	(C) NO PARENT BEFORE
otetovávaně	otetovávaný	(C) NO PARENT BEFORE
outsourcovávaně	outsourcovávaný	(C) NO PARENT BEFORE
ovulovávaně	ovulovávaný	(C) NO PARENT BEFORE
oxygenovávaně	oxygenovávaný	(C) NO PARENT BEFORE
paralizovávaně	paralizovávaný	(C) NO PARENT BEFORE
parfemovávaně	parfemovávaný	(C) NO PARENT BEFORE
pekáčovávaně	pekáčovávaný	(C) NO PARENT BEFORE
performovávaně	performovávaný	(C) NO PARENT BEFORE
perzonifikovávaně	perzonifikovávaný	(C) NO PARENT BEFORE
píďalkovávaně	píďalkovávaný	(C) NO PARENT BEFORE
piglovávaně	piglovávaný	(C) NO PARENT BEFORE
plastinovávaně	plastinovávaný	(C) NO PARENT BEFORE
plodovávaně	plodovávaný	(C) NO PARENT BEFORE
poameričťovávaně	poameričťovávaný	(C) NO PARENT BEFORE
pocentrovávaně	pocentrovávaný	(C) NO PARENT BEFORE
pocestovávaně	pocestovávaný	(C) NO PARENT BEFORE
podměřovávaně	podměřovávaný	(C) NO PARENT BEFORE
podskakovávaně	podskakovávaný	(C) NO PARENT BEFORE
podstřelovávaně	podstřelovávaný	(C) NO PARENT BEFORE
podšprajcovávaně	podšprajcovávaný	(C) NO PARENT BEFORE
pofackovávaně	pofackovávaný	(C) NO PARENT BEFORE
pohecovávaně	pohecovávaný	(C) NO PARENT BEFORE
pokérovávaně	pokérovávaný	(C) NO PARENT BEFORE
pokondolovávaně	pokondolovávaný	(C) NO PARENT BEFORE
pokoštovávaně	pokoštovávaný	(C) NO PARENT BEFORE
pokritizovávaně	pokritizovávaný	(C) NO PARENT BEFORE
pokřesťanšťovávaně	pokřesťanšťovávaný	(C) NO PARENT BEFORE
poloprofesionalizovávaně	poloprofesionalizovávaný	(C) NO PARENT BEFORE
popiskovávaně	popiskovávaný	(C) NO PARENT BEFORE
popracovávaně	popracovávaný	(C) NO PARENT BEFORE
popřehazovávaně	popřehazovávaný	(C) NO PARENT BEFORE
poradcovávaně	poradcovávaný	(C) NO PARENT BEFORE
poradovávaně	poradovávaný	(C) NO PARENT BEFORE
porotovávaně	porotovávaný	(C) NO PARENT BEFORE
poshazovávaně	poshazovávaný	(C) NO PARENT BEFORE
posvařovávaně	posvařovávaný	(C) NO PARENT BEFORE
potapetovávaně	potapetovávaný	(C) NO PARENT BEFORE
potemňovávaně	potemňovávaný	(C) NO PARENT BEFORE
poupravovávaně	poupravovávaný	(C) NO PARENT BEFORE
pověnovávaně	pověnovávaný	(C) NO PARENT BEFORE
povinšovávaně	povinšovávaný	(C) NO PARENT BEFORE
povlakovávaně	povlakovávaný	(C) NO PARENT BEFORE
povrstvovávaně	povrstvovávaný	(C) NO PARENT BEFORE
povyhazovávaně	povyhazovávaný	(C) NO PARENT BEFORE
povyměňovávaně	povyměňovávaný	(C) NO PARENT BEFORE
povyřizovávaně	povyřizovávaný	(C) NO PARENT BEFORE
pozápadňovávaně	pozápadňovávaný	(C) NO PARENT BEFORE
poženšťovávaně	poženšťovávaný	(C) NO PARENT BEFORE
prázdninovávaně	prázdninovávaný	(C) NO PARENT BEFORE
prdelkovávaně	prdelkovávaný	(C) NO PARENT BEFORE
precipitovávaně	precipitovávaný	(C) NO PARENT BEFORE
prelustrovávaně	prelustrovávaný	(C) NO PARENT BEFORE
prioritizovávaně	prioritizovávaný	(C) NO PARENT BEFORE
profilcovávaně	profilcovávaný	(C) NO PARENT BEFORE
profízlovávaně	profízlovávaný	(C) NO PARENT BEFORE
prohospodařovávaně	prohospodařovávaný	(C) NO PARENT BEFORE
projikovávaně	projikovávaný	(C) NO PARENT BEFORE
prokvašovávaně	prokvašovávaný	(C) NO PARENT BEFORE
proluftovávaně	proluftovávaný	(C) NO PARENT BEFORE
proolejovávaně	proolejovávaný	(C) NO PARENT BEFORE
propaběrkovávaně	propaběrkovávaný	(C) NO PARENT BEFORE
propádlovávaně	propádlovávaný	(C) NO PARENT BEFORE
proplečkovávaně	proplečkovávaný	(C) NO PARENT BEFORE
propluhovávaně	propluhovávaný	(C) NO PARENT BEFORE
propocovávaně	propocovávaný	(C) NO PARENT BEFORE
propytlíkovávaně	propytlíkovávaný	(C) NO PARENT BEFORE
prorajtovávaně	prorajtovávaný	(C) NO PARENT BEFORE
prorecitovávaně	prorecitovávaný	(C) NO PARENT BEFORE
prorozkazovávaně	prorozkazovávaný	(C) NO PARENT BEFORE
prorýhovávaně	prorýhovávaný	(C) NO PARENT BEFORE
prosvicovávaně	prosvicovávaný	(C) NO PARENT BEFORE
prosvorkovávaně	prosvorkovávaný	(C) NO PARENT BEFORE
prošroubovávaně	prošroubovávaný	(C) NO PARENT BEFORE
protifinancovávaně	protifinancovávaný	(C) NO PARENT BEFORE
protrénovávaně	protrénovávaný	(C) NO PARENT BEFORE
provařovávaně	provařovávaný	(C) NO PARENT BEFORE
provazovávaně	provazovávaný	(C) NO PARENT BEFORE
proveslovávaně	proveslovávaný	(C) NO PARENT BEFORE
průvodcovávaně	průvodcovávaný	(C) NO PARENT BEFORE
přebásníkovávaně	přebásníkovávaný	(C) NO PARENT BEFORE
přebookovávaně	přebookovávaný	(C) NO PARENT BEFORE
přebruslovávaně	přebruslovávaný	(C) NO PARENT BEFORE
přebuchtovávaně	přebuchtovávaný	(C) NO PARENT BEFORE
předčisťovávaně	předčisťovávaný	(C) NO PARENT BEFORE
předestilovávaně	předestilovávaný	(C) NO PARENT BEFORE
předformulovávaně	předformulovávaný	(C) NO PARENT BEFORE
předikovávaně	předikovávaný	(C) NO PARENT BEFORE
přediktovávaně	přediktovávaný	(C) NO PARENT BEFORE
předinvestovávaně	předinvestovávaný	(C) NO PARENT BEFORE
předkupovávaně	předkupovávaný	(C) NO PARENT BEFORE
předlážďovávaně	předlážďovávaný	(C) NO PARENT BEFORE
předmontovávaně	předmontovávaný	(C) NO PARENT BEFORE
předoktorovávaně	předoktorovávaný	(C) NO PARENT BEFORE
předplacovávaně	předplacovávaný	(C) NO PARENT BEFORE
předpracovávaně	předpracovávaný	(C) NO PARENT BEFORE
předregistrovávaně	předregistrovávaný	(C) NO PARENT BEFORE
předriblovávaně	předriblovávaný	(C) NO PARENT BEFORE
předsušovávaně	předsušovávaný	(C) NO PARENT BEFORE
předvychovávaně	předvychovávaný	(C) NO PARENT BEFORE
přeevidovávaně	přeevidovávaný	(C) NO PARENT BEFORE
přefestivalovávaně	přefestivalovávaný	(C) NO PARENT BEFORE
přefukovávaně	přefukovávaný	(C) NO PARENT BEFORE
přegolfovávaně	přegolfovávaný	(C) NO PARENT BEFORE
přehájkovávaně	přehájkovávaný	(C) NO PARENT BEFORE
přehavlovávaně	přehavlovávaný	(C) NO PARENT BEFORE
přehecovávaně	přehecovávaný	(C) NO PARENT BEFORE
přehernovávaně	přehernovávaný	(C) NO PARENT BEFORE
přehotelovávaně	přehotelovávaný	(C) NO PARENT BEFORE
přehušťovávaně	přehušťovávaný	(C) NO PARENT BEFORE
přehvězdovávaně	přehvězdovávaný	(C) NO PARENT BEFORE
přechytračovávaně	přechytračovávaný	(C) NO PARENT BEFORE
přeinterpretovávaně	přeinterpretovávaný	(C) NO PARENT BEFORE
překalibrovávaně	překalibrovávaný	(C) NO PARENT BEFORE
překoordinovávaně	překoordinovávaný	(C) NO PARENT BEFORE
překoštovávaně	překoštovávaný	(C) NO PARENT BEFORE
překvašovávaně	překvašovávaný	(C) NO PARENT BEFORE
přemarketovávaně	přemarketovávaný	(C) NO PARENT BEFORE
přemedializovávaně	přemedializovávaný	(C) NO PARENT BEFORE
přeobchodovávaně	přeobchodovávaný	(C) NO PARENT BEFORE
přepapouškovávaně	přepapouškovávaný	(C) NO PARENT BEFORE
přeparoubkovávaně	přeparoubkovávaný	(C) NO PARENT BEFORE
přepatrovávaně	přepatrovávaný	(C) NO PARENT BEFORE
přepsovávaně	přepsovávaný	(C) NO PARENT BEFORE
přerámovávaně	přerámovávaný	(C) NO PARENT BEFORE
přereklamovávaně	přereklamovávaný	(C) NO PARENT BEFORE
přerybňovávaně	přerybňovávaný	(C) NO PARENT BEFORE
přeřizovávaně	přeřizovávaný	(C) NO PARENT BEFORE
přesazbovávaně	přesazbovávaný	(C) NO PARENT BEFORE
přesbírkovávaně	přesbírkovávaný	(C) NO PARENT BEFORE
přeseriálovávaně	přeseriálovávaný	(C) NO PARENT BEFORE
přesíťovávaně	přesíťovávaný	(C) NO PARENT BEFORE
přeskladňovávaně	přeskladňovávaný	(C) NO PARENT BEFORE
přesládkovávaně	přesládkovávaný	(C) NO PARENT BEFORE
přesofistikovávaně	přesofistikovávaný	(C) NO PARENT BEFORE
přesportovávaně	přesportovávaný	(C) NO PARENT BEFORE
přesupermarketovávaně	přesupermarketovávaný	(C) NO PARENT BEFORE
přesymbolizovávaně	přesymbolizovávaný	(C) NO PARENT BEFORE
přešroubovávaně	přešroubovávaný	(C) NO PARENT BEFORE
přeštukovávaně	přeštukovávaný	(C) NO PARENT BEFORE
přetetovávaně	přetetovávaný	(C) NO PARENT BEFORE
přetopolánkovávaně	přetopolánkovávaný	(C) NO PARENT BEFORE
převerbovávaně	převerbovávaný	(C) NO PARENT BEFORE
převolovávaně	převolovávaný	(C) NO PARENT BEFORE
(C) NO PARENT BEFORE
převolovávaně	převolovávaný	(C) NO PARENT BEFORE
(C) NO PARENT BEFORE
přezónovávaně	přezónovávaný	(C) NO PARENT BEFORE
přežehlovávaně	přežehlovávaný	(C) NO PARENT BEFORE
přicukrovávaně	přicukrovávaný	(C) NO PARENT BEFORE
přidaňovávaně	přidaňovávaný	(C) NO PARENT BEFORE
přihmuřovávaně	přihmuřovávaný	(C) NO PARENT BEFORE
přihojovávaně	přihojovávaný	(C) NO PARENT BEFORE
přikrčovávaně	přikrčovávaný	(C) NO PARENT BEFORE
přikukovávaně	přikukovávaný	(C) NO PARENT BEFORE
přítelíčkovávaně	přítelíčkovávaný	(C) NO PARENT BEFORE
přivoňovávaně	přivoňovávaný	(C) NO PARENT BEFORE
psychiatrizovávaně	psychiatrizovávaný	(C) NO PARENT BEFORE
psychoanalyzovávaně	psychoanalyzovávaný	(C) NO PARENT BEFORE
pyskovávaně	pyskovávaný	(C) NO PARENT BEFORE
rautovávaně	rautovávaný	(C) NO PARENT BEFORE
reabsorbovávaně	reabsorbovávaný	(C) NO PARENT BEFORE
reambulovávaně	reambulovávaný	(C) NO PARENT BEFORE
rebalancovávaně	rebalancovávaný	(C) NO PARENT BEFORE
recertifikovávaně	recertifikovávaný	(C) NO PARENT BEFORE
redesignovávaně	redesignovávaný	(C) NO PARENT BEFORE
reduplikovávaně	reduplikovávaný	(C) NO PARENT BEFORE
reemitovávaně	reemitovávaný	(C) NO PARENT BEFORE
reformulovávaně	reformulovávaný	(C) NO PARENT BEFORE
regionalizovávaně	regionalizovávaný	(C) NO PARENT BEFORE
rehydratovávaně	rehydratovávaný	(C) NO PARENT BEFORE
rekanalizovávaně	rekanalizovávaný	(C) NO PARENT BEFORE
rekontextualizovávaně	rekontextualizovávaný	(C) NO PARENT BEFORE
relativovávaně	relativovávaný	(C) NO PARENT BEFORE
remastrovávaně	remastrovávaný	(C) NO PARENT BEFORE
remontovávaně	remontovávaný	(C) NO PARENT BEFORE
renacionalizovávaně	renacionalizovávaný	(C) NO PARENT BEFORE
renegociovávaně	renegociovávaný	(C) NO PARENT BEFORE
reoperovávaně	reoperovávaný	(C) NO PARENT BEFORE
reorientovávaně	reorientovávaný	(C) NO PARENT BEFORE
repolarizovávaně	repolarizovávaný	(C) NO PARENT BEFORE
repovávaně	repovávaný	(C) NO PARENT BEFORE
repreparovávaně	repreparovávaný	(C) NO PARENT BEFORE
reprofilovávaně	reprofilovávaný	(C) NO PARENT BEFORE
retinovávaně	retinovávaný	(C) NO PARENT BEFORE
retrofitovávaně	retrofitovávaný	(C) NO PARENT BEFORE
revakcinovávaně	revakcinovávaný	(C) NO PARENT BEFORE
revaskularizovávaně	revaskularizovávaný	(C) NO PARENT BEFORE
rolbovávaně	rolbovávaný	(C) NO PARENT BEFORE
rošovávaně	rošovávaný	(C) NO PARENT BEFORE
rozbojovávaně	rozbojovávaný	(C) NO PARENT BEFORE
rozborovávaně	rozborovávaný	(C) NO PARENT BEFORE
rozcestovávaně	rozcestovávaný	(C) NO PARENT BEFORE
rozcuckovávaně	rozcuckovávaný	(C) NO PARENT BEFORE
rozčepovávaně	rozčepovávaný	(C) NO PARENT BEFORE
rozdrancovávaně	rozdrancovávaný	(C) NO PARENT BEFORE
rozesazovávaně	rozesazovávaný	(C) NO PARENT BEFORE
rozfajrovávaně	rozfajrovávaný	(C) NO PARENT BEFORE
rozhecovávaně	rozhecovávaný	(C) NO PARENT BEFORE
rozchvacovávaně	rozchvacovávaný	(C) NO PARENT BEFORE
rozpádlovávaně	rozpádlovávaný	(C) NO PARENT BEFORE
rozpamatovávaně	rozpamatovávaný	(C) NO PARENT BEFORE
rozpárovávaně	rozpárovávaný	(C) NO PARENT BEFORE
rozpásmovávaně	rozpásmovávaný	(C) NO PARENT BEFORE
rozpěstovávaně	rozpěstovávaný	(C) NO PARENT BEFORE
rozpilovávaně	rozpilovávaný	(C) NO PARENT BEFORE
rozpixelovávaně	rozpixelovávaný	(C) NO PARENT BEFORE
rozplombovávaně	rozplombovávaný	(C) NO PARENT BEFORE
rozpoložkovávaně	rozpoložkovávaný	(C) NO PARENT BEFORE
rozposunovávaně	rozposunovávaný	(C) NO PARENT BEFORE
rozprivatizovávaně	rozprivatizovávaný	(C) NO PARENT BEFORE
rozprostraňovávaně	rozprostraňovávaný	(C) NO PARENT BEFORE
rozprskovávaně	rozprskovávaný	(C) NO PARENT BEFORE
rozpříčkovávaně	rozpříčkovávaný	(C) NO PARENT BEFORE
rozpulzovávaně	rozpulzovávaný	(C) NO PARENT BEFORE
rozpumprdlíkovávaně	rozpumprdlíkovávaný	(C) NO PARENT BEFORE
roztmelovávaně	roztmelovávaný	(C) NO PARENT BEFORE
roztrénovávaně	roztrénovávaný	(C) NO PARENT BEFORE
rutinizovávaně	rutinizovávaný	(C) NO PARENT BEFORE
sabrážovávaně	sabrážovávaný	(C) NO PARENT BEFORE
samolikvidovávaně	samolikvidovávaný	(C) NO PARENT BEFORE
samoočišťovávaně	samoočišťovávaný	(C) NO PARENT BEFORE
samoopylovávaně	samoopylovávaný	(C) NO PARENT BEFORE
samopasovávaně	samopasovávaný	(C) NO PARENT BEFORE
samoprezentovávaně	samoprezentovávaný	(C) NO PARENT BEFORE
samoprivatizovávaně	samoprivatizovávaný	(C) NO PARENT BEFORE
samoprodukovávaně	samoprodukovávaný	(C) NO PARENT BEFORE
samoreprodukovávaně	samoreprodukovávaný	(C) NO PARENT BEFORE
samorozšiřovávaně	samorozšiřovávaný	(C) NO PARENT BEFORE
samospravovávaně	samospravovávaný	(C) NO PARENT BEFORE
samostudovávaně	samostudovávaný	(C) NO PARENT BEFORE
samotitulovávaně	samotitulovávaný	(C) NO PARENT BEFORE
samovyměřovávaně	samovyměřovávaný	(C) NO PARENT BEFORE
samovyšetřovávaně	samovyšetřovávaný	(C) NO PARENT BEFORE
samovzněcovávaně	samovzněcovávaný	(C) NO PARENT BEFORE
samozásobovávaně	samozásobovávaný	(C) NO PARENT BEFORE
samozlikvidovávaně	samozlikvidovávaný	(C) NO PARENT BEFORE
sanitovávaně	sanitovávaný	(C) NO PARENT BEFORE
sbalíkovávaně	sbalíkovávaný	(C) NO PARENT BEFORE
scatovávaně	scatovávaný	(C) NO PARENT BEFORE
scratchovávaně	scratchovávaný	(C) NO PARENT BEFORE
sekuritizovávaně	sekuritizovávaný	(C) NO PARENT BEFORE
senzitizovávaně	senzitizovávaný	(C) NO PARENT BEFORE
serfovávaně	serfovávaný	(C) NO PARENT BEFORE
seštěpkovávaně	seštěpkovávaný	(C) NO PARENT BEFORE
sešvindlovávaně	sešvindlovávaný	(C) NO PARENT BEFORE
sfáčovávaně	sfáčovávaný	(C) NO PARENT BEFORE
sfúzovávaně	sfúzovávaný	(C) NO PARENT BEFORE
shybovávaně	shybovávaný	(C) NO PARENT BEFORE
skipovávaně	skipovávaný	(C) NO PARENT BEFORE
skypovávaně	skypovávaný	(C) NO PARENT BEFORE
skytovávaně	skytovávaný	(C) NO PARENT BEFORE
slalomovávaně	slalomovávaný	(C) NO PARENT BEFORE
slámovávaně	slámovávaný	(C) NO PARENT BEFORE
směnovávaně	směnovávaný	(C) NO PARENT BEFORE
smlčovávaně	smlčovávaný	(C) NO PARENT BEFORE
somatizovávaně	somatizovávaný	(C) NO PARENT BEFORE
sortýrovávaně	sortýrovávaný	(C) NO PARENT BEFORE
soustachírovávaně	soustachírovávaný	(C) NO PARENT BEFORE
spamovávaně	spamovávaný	(C) NO PARENT BEFORE
spasovávaně	spasovávaný	(C) NO PARENT BEFORE
spojkovávaně	spojkovávaný	(C) NO PARENT BEFORE
spolufinacovávaně	spolufinacovávaný	(C) NO PARENT BEFORE
spolunominovávaně	spolunominovávaný	(C) NO PARENT BEFORE
spoluschvalovávaně	spoluschvalovávaný	(C) NO PARENT BEFORE
squatovávaně	squatovávaný	(C) NO PARENT BEFORE
strečovávaně	strečovávaný	(C) NO PARENT BEFORE
strokovávaně	strokovávaný	(C) NO PARENT BEFORE
supervenovávaně	supervenovávaný	(C) NO PARENT BEFORE
sveslovávaně	sveslovávaný	(C) NO PARENT BEFORE
symetrizovávaně	symetrizovávaný	(C) NO PARENT BEFORE
šábovávaně	šábovávaný	(C) NO PARENT BEFORE
širákovávaně	širákovávaný	(C) NO PARENT BEFORE
šmigrustovávaně	šmigrustovávaný	(C) NO PARENT BEFORE
špízovávaně	špízovávaný	(C) NO PARENT BEFORE
tamborírovávaně	tamborírovávaný	(C) NO PARENT BEFORE
tapecírovávaně	tapecírovávaný	(C) NO PARENT BEFORE
tarifikovávaně	tarifikovávaný	(C) NO PARENT BEFORE
tatarovávaně	tatarovávaný	(C) NO PARENT BEFORE
tématizovávaně	tématizovávaný	(C) NO PARENT BEFORE
tempovávaně	tempovávaný	(C) NO PARENT BEFORE
tendrovávaně	tendrovávaný	(C) NO PARENT BEFORE
térovávaně	térovávaný	(C) NO PARENT BEFORE
thesaurovávaně	thesaurovávaný	(C) NO PARENT BEFORE
trejdovávaně	trejdovávaný	(C) NO PARENT BEFORE
tuplovávaně	tuplovávaný	(C) NO PARENT BEFORE
twitterovávaně	twitterovávaný	(C) NO PARENT BEFORE
týčkovávaně	týčkovávaný	(C) NO PARENT BEFORE
týmovávaně	týmovávaný	(C) NO PARENT BEFORE
uargumentovávaně	uargumentovávaný	(C) NO PARENT BEFORE
ubalancovávaně	ubalancovávaný	(C) NO PARENT BEFORE
udrátovávaně	udrátovávaný	(C) NO PARENT BEFORE
uchraňovávaně	uchraňovávaný	(C) NO PARENT BEFORE
ukontrolovávaně	ukontrolovávaný	(C) NO PARENT BEFORE
ukoučovávaně	ukoučovávaný	(C) NO PARENT BEFORE
ulyžovávaně	ulyžovávaný	(C) NO PARENT BEFORE
umanévrovávaně	umanévrovávaný	(C) NO PARENT BEFORE
upádlovávaně	upádlovávaný	(C) NO PARENT BEFORE
upluhovávaně	upluhovávaný	(C) NO PARENT BEFORE
urejdovávaně	urejdovávaný	(C) NO PARENT BEFORE
urežírovávaně	urežírovávaný	(C) NO PARENT BEFORE
urolbovávaně	urolbovávaný	(C) NO PARENT BEFORE
usledovávaně	usledovávaný	(C) NO PARENT BEFORE
usoudcovávaně	usoudcovávaný	(C) NO PARENT BEFORE
usoudruhovávaně	usoudruhovávaný	(C) NO PARENT BEFORE
uštrykovávaně	uštrykovávaný	(C) NO PARENT BEFORE
utaktizovávaně	utaktizovávaný	(C) NO PARENT BEFORE
utilizovávaně	utilizovávaný	(C) NO PARENT BEFORE
uveslovávaně	uveslovávaný	(C) NO PARENT BEFORE
vaničkovávaně	vaničkovávaný	(C) NO PARENT BEFORE
vertikutovávaně	vertikutovávaný	(C) NO PARENT BEFORE
videotelefonovávaně	videotelefonovávaný	(C) NO PARENT BEFORE
vobětovávaně	vobětovávaný	(C) NO PARENT BEFORE
voblažovávaně	voblažovávaný	(C) NO PARENT BEFORE
voblbovávaně	voblbovávaný	(C) NO PARENT BEFORE
vobletovávaně	vobletovávaný	(C) NO PARENT BEFORE
voblizovávaně	voblizovávaný	(C) NO PARENT BEFORE
vobtěžovávaně	vobtěžovávaný	(C) NO PARENT BEFORE
vočumovávaně	vočumovávaný	(C) NO PARENT BEFORE
vodhalovávaně	vodhalovávaný	(C) NO PARENT BEFORE
vodhazovávaně	vodhazovávaný	(C) NO PARENT BEFORE
vodpádlovávaně	vodpádlovávaný	(C) NO PARENT BEFORE
vodpracovávaně	vodpracovávaný	(C) NO PARENT BEFORE
vodpuzovávaně	vodpuzovávaný	(C) NO PARENT BEFORE
vpresovávaně	vpresovávaný	(C) NO PARENT BEFORE
vyartikulovávaně	vyartikulovávaný	(C) NO PARENT BEFORE
vybruslovávaně	vybruslovávaný	(C) NO PARENT BEFORE
vybržďovávaně	vybržďovávaný	(C) NO PARENT BEFORE
vyčenžovávaně	vyčenžovávaný	(C) NO PARENT BEFORE
vydiskutovávaně	vydiskutovávaný	(C) NO PARENT BEFORE
vydokladovávaně	vydokladovávaný	(C) NO PARENT BEFORE
vydotovávaně	vydotovávaný	(C) NO PARENT BEFORE
vyemitovávaně	vyemitovávaný	(C) NO PARENT BEFORE
vyexovávaně	vyexovávaný	(C) NO PARENT BEFORE
vyfabrikovávaně	vyfabrikovávaný	(C) NO PARENT BEFORE
vykonzolovávaně	vykonzolovávaný	(C) NO PARENT BEFORE
vykonzultovávaně	vykonzultovávaný	(C) NO PARENT BEFORE
vyloktovávaně	vyloktovávaný	(C) NO PARENT BEFORE
vymapovávaně	vymapovávaný	(C) NO PARENT BEFORE
vymisťovávaně	vymisťovávaný	(C) NO PARENT BEFORE
vymražovávaně	vymražovávaný	(C) NO PARENT BEFORE
vyoutovávaně	vyoutovávaný	(C) NO PARENT BEFORE
vypádlovávaně	vypádlovávaný	(C) NO PARENT BEFORE
vysádkovávaně	vysádkovávaný	(C) NO PARENT BEFORE
vysamplovávaně	vysamplovávaný	(C) NO PARENT BEFORE
vyslancovávaně	vyslancovávaný	(C) NO PARENT BEFORE
vysprejovávaně	vysprejovávaný	(C) NO PARENT BEFORE
vyšpekovávaně	vyšpekovávaný	(C) NO PARENT BEFORE
vyšťavovávaně	vyšťavovávaný	(C) NO PARENT BEFORE
vyštengrovávaně	vyštengrovávaný	(C) NO PARENT BEFORE
vyšúrovávaně	vyšúrovávaný	(C) NO PARENT BEFORE
vytendrovávaně	vytendrovávaný	(C) NO PARENT BEFORE
vytestovávaně	vytestovávaný	(C) NO PARENT BEFORE
vyzvětšovávaně	vyzvětšovávaný	(C) NO PARENT BEFORE
westernizovávaně	westernizovávaný	(C) NO PARENT BEFORE
zabalíčkovávaně	zabalíčkovávaný	(C) NO PARENT BEFORE
zabalíkovávaně	zabalíkovávaný	(C) NO PARENT BEFORE
zaběžkovávaně	zaběžkovávaný	(C) NO PARENT BEFORE
zadatovávaně	zadatovávaný	(C) NO PARENT BEFORE
zadotovávaně	zadotovávaný	(C) NO PARENT BEFORE
zadrápkovávaně	zadrápkovávaný	(C) NO PARENT BEFORE
zadžemovávaně	zadžemovávaný	(C) NO PARENT BEFORE
zaexhibovávaně	zaexhibovávaný	(C) NO PARENT BEFORE
zahulovávaně	zahulovávaný	(C) NO PARENT BEFORE
zachatovávaně	zachatovávaný	(C) NO PARENT BEFORE
zainstalovávaně	zainstalovávaný	(C) NO PARENT BEFORE
zakapsovávaně	zakapsovávaný	(C) NO PARENT BEFORE
zakoncentrovávaně	zakoncentrovávaný	(C) NO PARENT BEFORE
zakoncipovávaně	zakoncipovávaný	(C) NO PARENT BEFORE
zakonferovávaně	zakonferovávaný	(C) NO PARENT BEFORE
zakonkurovávaně	zakonkurovávaný	(C) NO PARENT BEFORE
zakontrahovávaně	zakontrahovávaný	(C) NO PARENT BEFORE
zakonverzovávaně	zakonverzovávaný	(C) NO PARENT BEFORE
zakoučovávaně	zakoučovávaný	(C) NO PARENT BEFORE
zakreditovávaně	zakreditovávaný	(C) NO PARENT BEFORE
zakůrovávaně	zakůrovávaný	(C) NO PARENT BEFORE
zamotivovávaně	zamotivovávaný	(C) NO PARENT BEFORE
zamulčovávaně	zamulčovávaný	(C) NO PARENT BEFORE
zaobcovávaně	zaobcovávaný	(C) NO PARENT BEFORE
zaoperovávaně	zaoperovávaný	(C) NO PARENT BEFORE
zapachovávaně	zapachovávaný	(C) NO PARENT BEFORE
zapogovávaně	zapogovávaný	(C) NO PARENT BEFORE
zaprezentovávaně	zaprezentovávaný	(C) NO PARENT BEFORE
zapytlovávaně	zapytlovávaný	(C) NO PARENT BEFORE
zarabovávaně	zarabovávaný	(C) NO PARENT BEFORE
zaregulovávaně	zaregulovávaný	(C) NO PARENT BEFORE
zarelaxovávaně	zarelaxovávaný	(C) NO PARENT BEFORE
zarestovávaně	zarestovávaný	(C) NO PARENT BEFORE
zargumentovávaně	zargumentovávaný	(C) NO PARENT BEFORE
zarockovávaně	zarockovávaný	(C) NO PARENT BEFORE
zarotovávaně	zarotovávaný	(C) NO PARENT BEFORE
zasáňkovávaně	zasáňkovávaný	(C) NO PARENT BEFORE
zasejfovávaně	zasejfovávaný	(C) NO PARENT BEFORE
zasjezdovávaně	zasjezdovávaný	(C) NO PARENT BEFORE
zaskládkovávaně	zaskládkovávaný	(C) NO PARENT BEFORE
zasporovávaně	zasporovávaný	(C) NO PARENT BEFORE
zasuplovávaně	zasuplovávaný	(C) NO PARENT BEFORE
zašnorchlovávaně	zašnorchlovávaný	(C) NO PARENT BEFORE
zašopovávaně	zašopovávaný	(C) NO PARENT BEFORE
zašpérovávaně	zašpérovávaný	(C) NO PARENT BEFORE
zašumlovávaně	zašumlovávaný	(C) NO PARENT BEFORE
zatemperovávaně	zatemperovávaný	(C) NO PARENT BEFORE
zateoretizovávaně	zateoretizovávaný	(C) NO PARENT BEFORE
zatrolejovávaně	zatrolejovávaný	(C) NO PARENT BEFORE
zauditovávaně	zauditovávaný	(C) NO PARENT BEFORE
zavetovávaně	zavetovávaný	(C) NO PARENT BEFORE
zavkladovávaně	zavkladovávaný	(C) NO PARENT BEFORE
zazoomovávaně	zazoomovávaný	(C) NO PARENT BEFORE
zazorbovávaně	zazorbovávaný	(C) NO PARENT BEFORE
zbuzerovávaně	zbuzerovávaný	(C) NO PARENT BEFORE
zdemontovávaně	zdemontovávaný	(C) NO PARENT BEFORE
zdirigovávaně	zdirigovávaný	(C) NO PARENT BEFORE
zdominovávaně	zdominovávaný	(C) NO PARENT BEFORE
zdrojovávaně	zdrojovávaný	(C) NO PARENT BEFORE
zdublovávaně	zdublovávaný	(C) NO PARENT BEFORE
zdůvěryhodňovávaně	zdůvěryhodňovávaný	(C) NO PARENT BEFORE
zelektronizovávaně	zelektronizovávaný	(C) NO PARENT BEFORE
zestaršovávaně	zestaršovávaný	(C) NO PARENT BEFORE
zestařovávaně	zestařovávaný	(C) NO PARENT BEFORE
zfiletovávaně	zfiletovávaný	(C) NO PARENT BEFORE
zflikovávaně	zflikovávaný	(C) NO PARENT BEFORE
zfotodokumentovávaně	zfotodokumentovávaný	(C) NO PARENT BEFORE
zfrézovávaně	zfrézovávaný	(C) NO PARENT BEFORE
zgenerálkovávaně	zgenerálkovávaný	(C) NO PARENT BEFORE
zglobalizovávaně	zglobalizovávaný	(C) NO PARENT BEFORE
zchudobňovávaně	zchudobňovávaný	(C) NO PARENT BEFORE
zintelektualizovávaně	zintelektualizovávaný	(C) NO PARENT BEFORE
zjednosměrňovávaně	zjednosměrňovávaný	(C) NO PARENT BEFORE
zjizvovávaně	zjizvovávaný	(C) NO PARENT BEFORE
zkafovávaně	zkafovávaný	(C) NO PARENT BEFORE
zlobbovávaně	zlobbovávaný	(C) NO PARENT BEFORE
zmanažerovávaně	zmanažerovávaný	(C) NO PARENT BEFORE
zmasterovávaně	zmasterovávaný	(C) NO PARENT BEFORE
zmermomocňovávaně	zmermomocňovávaný	(C) NO PARENT BEFORE
zmineralizovávaně	zmineralizovávaný	(C) NO PARENT BEFORE
zmystifikovávaně	zmystifikovávaný	(C) NO PARENT BEFORE
znedůvěryhodňovávaně	znedůvěryhodňovávaný	(C) NO PARENT BEFORE
zneviditelňovávaně	zneviditelňovávaný	(C) NO PARENT BEFORE
zniterňovávaně	zniterňovávaný	(C) NO PARENT BEFORE
znovicírovávaně	znovicírovávaný	(C) NO PARENT BEFORE
znovunastartovávaně	znovunastartovávaný	(C) NO PARENT BEFORE
znovuzabydlovávaně	znovuzabydlovávaný	(C) NO PARENT BEFORE
znovuzbudovávaně	znovuzbudovávaný	(C) NO PARENT BEFORE
zokruhovávaně	zokruhovávaný	(C) NO PARENT BEFORE
zoperovávaně	zoperovávaný	(C) NO PARENT BEFORE
zprocesovávaně	zprocesovávaný	(C) NO PARENT BEFORE
zprodukovávaně	zprodukovávaný	(C) NO PARENT BEFORE
zprojektovávaně	zprojektovávaný	(C) NO PARENT BEFORE
zrekolaudovávaně	zrekolaudovávaný	(C) NO PARENT BEFORE
zremasterovávaně	zremasterovávaný	(C) NO PARENT BEFORE
zremixovávaně	zremixovávaný	(C) NO PARENT BEFORE
zremízovávaně	zremízovávaný	(C) NO PARENT BEFORE
zreponovávaně	zreponovávaný	(C) NO PARENT BEFORE
zresuscitovávaně	zresuscitovávaný	(C) NO PARENT BEFORE
zreturnovávaně	zreturnovávaný	(C) NO PARENT BEFORE
zrevitalizovávaně	zrevitalizovávaný	(C) NO PARENT BEFORE
zrevokovávaně	zrevokovávaný	(C) NO PARENT BEFORE
zrujnovávaně	zrujnovávaný	(C) NO PARENT BEFORE
ztečovávaně	ztečovávaný	(C) NO PARENT BEFORE
ztrátovávaně	ztrátovávaný	(C) NO PARENT BEFORE
zvěrohodňovávaně	zvěrohodňovávaný	(C) NO PARENT BEFORE
