adoptovatel	adoptovat	(C) NO PARENT BEFORE
akceptovatel	akceptovat	(C) NO PARENT BEFORE
animovatel	animovat	(C) NO PARENT BEFORE
aplikovatel	aplikovat	(C) NO PARENT BEFORE
balitel	balit	(C) NO PARENT BEFORE
bìdovatel	bìdovat	(C) NO PARENT BEFORE
biopodnikatel	biopodnikat	(C) NO PARENT BEFORE
biømovatel	biømovat	(C) NO PARENT BEFORE
bodatel	bodat	(C) NO PARENT BEFORE
bulíkovatel	bulíkovat	(C) NO PARENT BEFORE
ceditel	cedit	(C) NO PARENT BEFORE
èerpatel	èerpat	(C) NO PARENT BEFORE
èlenitel	èlenit	(C) NO PARENT BEFORE
darovatel	darovat	(C) NO PARENT BEFORE
definovatel	definovat	(C) NO PARENT BEFORE
dešifrovatel	dešifrovat	(C) NO PARENT BEFORE
dluitel	dluit	(C) NO PARENT BEFORE
dodatel	dodat	(C) NO PARENT BEFORE
dodrovatel	dodrovat	(C) NO PARENT BEFORE
dojednatel	dojednat	(C) NO PARENT BEFORE
dokonèitel	dokonèit	(C) NO PARENT BEFORE
donucovatel	donucovat	(C) NO PARENT BEFORE
doplnitel	doplnit	(C) NO PARENT BEFORE
doporuèitel	doporuèit	(C) NO PARENT BEFORE
dopracovatel	dopracovat	(C) NO PARENT BEFORE
dopravovatel	dopravovat	(C) NO PARENT BEFORE
dosaditel	dosadit	(C) NO PARENT BEFORE
dostavitel	dostavit	(C) NO PARENT BEFORE
douèovatel	douèovat	(C) NO PARENT BEFORE
dozíratel	dozírat	(C) NO PARENT BEFORE
dozorovatel	dozorovat	(C) NO PARENT BEFORE
drásatel	drásat	(C) NO PARENT BEFORE
dusitel	dusit	(C) NO PARENT BEFORE
fedrovatel	fedrovat	(C) NO PARENT BEFORE
financovatel	financovat	(C) NO PARENT BEFORE
formovatel	formovat	(C) NO PARENT BEFORE
hájitel	hájit	(C) NO PARENT BEFORE
hanitel	hanit	(C) NO PARENT BEFORE
harašitel	harašit	(C) NO PARENT BEFORE
hasitel	hasit	(C) NO PARENT BEFORE
hemitel	hemit	(C) NO PARENT BEFORE
hledatel	hledat	(C) NO PARENT BEFORE
hmatatel	hmatat	(C) NO PARENT BEFORE
horovatel	horovat	(C) NO PARENT BEFORE
høímatel	høímat	(C) NO PARENT BEFORE
chlácholitel	chlácholit	(C) NO PARENT BEFORE
chmelitel	chmelit	(C) NO PARENT BEFORE
chrlitel	chrlit	(C) NO PARENT BEFORE
identifikovatel	identifikovat	(C) NO PARENT BEFORE
jednotitel	jednotit	(C) NO PARENT BEFORE
@	jetel	jet	(C) NO PARENT BEFORE
jímatel	jímat	(C) NO PARENT BEFORE
jitøitel	jitøit	(C) NO PARENT BEFORE
klamatel	klamat	(C) NO PARENT BEFORE
kluèitel	kluèit	(C) NO PARENT BEFORE
kódovatel	kódovat	(C) NO PARENT BEFORE
komolitel	komolit	(C) NO PARENT BEFORE
koncipovatel	koncipovat	(C) NO PARENT BEFORE
konejšitel	konejšit	(C) NO PARENT BEFORE
konzumovatel	konzumovat	(C) NO PARENT BEFORE
korumpovatel	korumpovat	(C) NO PARENT BEFORE
kovatel	kovat	(C) NO PARENT BEFORE
kritizovatel	kritizovat	(C) NO PARENT BEFORE
kropitel	kropit	(C) NO PARENT BEFORE
køíitel	køíit	(C) NO PARENT BEFORE
køiovatel	køiovat	(C) NO PARENT BEFORE
kultivovatel	kultivovat	(C) NO PARENT BEFORE
kydatel	kydat	(C) NO PARENT BEFORE
kıvatel	kıvat	(C) NO PARENT BEFORE
lahvovatel	lahvovat	(C) NO PARENT BEFORE
lepitel	lepit	(C) NO PARENT BEFORE
líbatel	líbat	(C) NO PARENT BEFORE
lomitel	lomit	(C) NO PARENT BEFORE
losovatel	losovat	(C) NO PARENT BEFORE
mámitel	mámit	(C) NO PARENT BEFORE
manévrovatel	manévrovat	(C) NO PARENT BEFORE
mapovatel	mapovat	(C) NO PARENT BEFORE
milovatel	milovat	(C) NO PARENT BEFORE
mísitel	mísit	(C) NO PARENT BEFORE
mlitel	mlit	(C) NO PARENT BEFORE
nadìlovatel	nadìlovat	(C) NO PARENT BEFORE
nahlašovatel	nahlašovat	(C) NO PARENT BEFORE
nakazitel	nakazit	(C) NO PARENT BEFORE
nakukovatel	nakukovat	(C) NO PARENT BEFORE
naléhatel	naléhat	(C) NO PARENT BEFORE
napravitel	napravit	(C) NO PARENT BEFORE
nárokovatel	nárokovat	(C) NO PARENT BEFORE
naøizovatel	naøizovat	(C) NO PARENT BEFORE
nastavovatel	nastavovat	(C) NO PARENT BEFORE
nastolitel	nastolit	(C) NO PARENT BEFORE
nastolovatel	nastolovat	(C) NO PARENT BEFORE
nastraitel	nastrait	(C) NO PARENT BEFORE
nauèitel	nauèit	(C) NO PARENT BEFORE
navazovatel	navazovat	(C) NO PARENT BEFORE
navnaïovatel	navnaïovat	(C) NO PARENT BEFORE
nazíratel	nazírat	(C) NO PARENT BEFORE
obèerstvovatel	obèerstvovat	(C) NO PARENT BEFORE
obdarovávatel	obdarovávat	(C) NO PARENT BEFORE
obesílatel	obesílat	(C) NO PARENT BEFORE
obhajovatel	obhajovat	(C) NO PARENT BEFORE
obhospodaøovatel	obhospodaøovat	(C) NO PARENT BEFORE
objímatel	objímat	(C) NO PARENT BEFORE
obklíèitel	obklíèit	(C) NO PARENT BEFORE
obklièovatel	obklièovat	(C) NO PARENT BEFORE
obklopovatel	obklopovat	(C) NO PARENT BEFORE
oblaitel	oblait	(C) NO PARENT BEFORE
oblbovatel	oblbovat	(C) NO PARENT BEFORE
oblibovatel	oblibovat	(C) NO PARENT BEFORE
@	obratel	obrat	(C) NO PARENT BEFORE
obroditel	obrodit	(C) NO PARENT BEFORE
obrozovatel	obrozovat	(C) NO PARENT BEFORE
obrušovatel	obrušovat	(C) NO PARENT BEFORE
obsahovatel	obsahovat	(C) NO PARENT BEFORE
obsazovatel	obsazovat	(C) NO PARENT BEFORE
obstaratel	obstarat	(C) NO PARENT BEFORE
obvinitel	obvinit	(C) NO PARENT BEFORE
ocenitel	ocenit	(C) NO PARENT BEFORE
oèišovatel	oèišovat	(C) NO PARENT BEFORE
oèkovatel	oèkovat	(C) NO PARENT BEFORE
odbahòovatel	odbahòovat	(C) NO PARENT BEFORE
odbavovatel	odbavovat	(C) NO PARENT BEFORE
odbourávatel	odbourávat	(C) NO PARENT BEFORE
odcizitel	odcizit	(C) NO PARENT BEFORE
oddìlitel	oddìlit	(C) NO PARENT BEFORE
odebíratel	odebírat	(C) NO PARENT BEFORE
odeèítatel	odeèítat	(C) NO PARENT BEFORE
odemykatel	odemykat	(C) NO PARENT BEFORE
odepisovatel	odepisovat	(C) NO PARENT BEFORE
odevzdatel	odevzdat	(C) NO PARENT BEFORE
odhlašovatel	odhlašovat	(C) NO PARENT BEFORE
odlehèovatel	odlehèovat	(C) NO PARENT BEFORE
odpovídatel	odpovídat	(C) NO PARENT BEFORE
odpustitel	odpustit	(C) NO PARENT BEFORE
odrazovatel	odrazovat	(C) NO PARENT BEFORE
odsiøovatel	odsiøovat	(C) NO PARENT BEFORE
odstátòovatel	odstátòovat	(C) NO PARENT BEFORE
odstavitel	odstavit	(C) NO PARENT BEFORE
odstraòovatel	odstraòovat	(C) NO PARENT BEFORE
odtuèòovatel	odtuèòovat	(C) NO PARENT BEFORE
oduševòovatel	oduševòovat	(C) NO PARENT BEFORE
odzbrojitel	odzbrojit	(C) NO PARENT BEFORE
odzbrojovatel	odzbrojovat	(C) NO PARENT BEFORE
ohrozitel	ohrozit	(C) NO PARENT BEFORE
ohroovatel	ohroovat	(C) NO PARENT BEFORE
oklešovatel	oklešovat	(C) NO PARENT BEFORE
okupovatel	okupovat	(C) NO PARENT BEFORE
okusitel	okusit	(C) NO PARENT BEFORE
omezitel	omezit	(C) NO PARENT BEFORE
omilostòovatel	omilostòovat	(C) NO PARENT BEFORE
omluvitel	omluvit	(C) NO PARENT BEFORE
opeèovatel	opeèovat	(C) NO PARENT BEFORE
opeèovávatel	opeèovávat	(C) NO PARENT BEFORE
oplocovatel	oplocovat	(C) NO PARENT BEFORE
oplozovatel	oplozovat	(C) NO PARENT BEFORE
opracovatel	opracovat	(C) NO PARENT BEFORE
opylovatel	opylovat	(C) NO PARENT BEFORE
orodovatel	orodovat	(C) NO PARENT BEFORE
osazovatel	osazovat	(C) NO PARENT BEFORE
oslabovatel	oslabovat	(C) NO PARENT BEFORE
oslovitel	oslovit	(C) NO PARENT BEFORE
osmyslovatel	osmyslovat	(C) NO PARENT BEFORE
osvìdèovatel	osvìdèovat	(C) NO PARENT BEFORE
osvìtlovatel	osvìtlovat	(C) NO PARENT BEFORE
osvìovatel	osvìovat	(C) NO PARENT BEFORE
osvojovatel	osvojovat	(C) NO PARENT BEFORE
oteplovatel	oteplovat	(C) NO PARENT BEFORE
otevíratel	otevírat	(C) NO PARENT BEFORE
ovìøitel	ovìøit	(C) NO PARENT BEFORE
ovlivòovatel	ovlivòovat	(C) NO PARENT BEFORE
ozaøovatel	ozaøovat	(C) NO PARENT BEFORE
oznaèovatel	oznaèovat	(C) NO PARENT BEFORE
oebraèovatel	oebraèovat	(C) NO PARENT BEFORE
oivitel	oivit	(C) NO PARENT BEFORE
pachtovatel	pachtovat	(C) NO PARENT BEFORE
pašovatel	pašovat	(C) NO PARENT BEFORE
peèetitel	peèetit	(C) NO PARENT BEFORE
plavitel	plavit	(C) NO PARENT BEFORE
plevelitel	plevelit	(C) NO PARENT BEFORE
plivatel	plivat	(C) NO PARENT BEFORE
plundrovatel	plundrovat	(C) NO PARENT BEFORE
pobádatel	pobádat	(C) NO PARENT BEFORE
pobíratel	pobírat	(C) NO PARENT BEFORE
poèešovatel	poèešovat	(C) NO PARENT BEFORE
podepisovatel	podepisovat	(C) NO PARENT BEFORE
podpoøitel	podpoøit	(C) NO PARENT BEFORE
podstrkovatel	podstrkovat	(C) NO PARENT BEFORE
podvrhovatel	podvrhovat	(C) NO PARENT BEFORE
pohlcovatel	pohlcovat	(C) NO PARENT BEFORE
pohrdatel	pohrdat	(C) NO PARENT BEFORE
pohybovatel	pohybovat	(C) NO PARENT BEFORE
pojmenovávatel	pojmenovávat	(C) NO PARENT BEFORE
pokazitel	pokazit	(C) NO PARENT BEFORE
pokoøovatel	pokoøovat	(C) NO PARENT BEFORE
pokrèovatel	pokrèovat	(C) NO PARENT BEFORE
polepšovatel	polepšovat	(C) NO PARENT BEFORE
polidšovatel	polidšovat	(C) NO PARENT BEFORE
pomìøovatel	pomìøovat	(C) NO PARENT BEFORE
ponoukatel	ponoukat	(C) NO PARENT BEFORE
popravitel	popravit	(C) NO PARENT BEFORE
poruèitel	poruèit	(C) NO PARENT BEFORE
postupovatel	postupovat	(C) NO PARENT BEFORE
posunovatel	posunovat	(C) NO PARENT BEFORE
posvìcovatel	posvìcovat	(C) NO PARENT BEFORE
potìšitel	potìšit	(C) NO PARENT BEFORE
povìøitel	povìøit	(C) NO PARENT BEFORE
povìøovatel	povìøovat	(C) NO PARENT BEFORE
povolovatel	povolovat	(C) NO PARENT BEFORE
povozitel	povozit	(C) NO PARENT BEFORE
povzbuzovatel	povzbuzovat	(C) NO PARENT BEFORE
pozmìòovatel	pozmìòovat	(C) NO PARENT BEFORE
pozùstavitel	pozùstavit	(C) NO PARENT BEFORE
poadovatel	poadovat	(C) NO PARENT BEFORE
poívatel	poívat	(C) NO PARENT BEFORE
praktikovatel	praktikovat	(C) NO PARENT BEFORE
pranıøovatel	pranıøovat	(C) NO PARENT BEFORE
praitel	prait	(C) NO PARENT BEFORE
prezentovatel	prezentovat	(C) NO PARENT BEFORE
probuditel	probudit	(C) NO PARENT BEFORE
proèišovatel	proèišovat	(C) NO PARENT BEFORE
prodatel	prodat	(C) NO PARENT BEFORE
produkovatel	produkovat	(C) NO PARENT BEFORE
prohlašovatel	prohlašovat	(C) NO PARENT BEFORE
projednatel	projednat	(C) NO PARENT BEFORE
projevitel	projevit	(C) NO PARENT BEFORE
prolamovatel	prolamovat	(C) NO PARENT BEFORE
promìòovatel	promìòovat	(C) NO PARENT BEFORE
promlouvatel	promlouvat	(C) NO PARENT BEFORE
propagovatel	propagovat	(C) NO PARENT BEFORE
propojovatel	propojovat	(C) NO PARENT BEFORE
propùjèovatel	propùjèovat	(C) NO PARENT BEFORE
proslovovatel	proslovovat	(C) NO PARENT BEFORE
prošetøovatel	prošetøovat	(C) NO PARENT BEFORE
protìovatel	protìovat	(C) NO PARENT BEFORE
protlaèovatel	protlaèovat	(C) NO PARENT BEFORE
provokovatel	provokovat	(C) NO PARENT BEFORE
proívatel	proívat	(C) NO PARENT BEFORE
pøebíratel	pøebírat	(C) NO PARENT BEFORE
pøedatel	pøedat	(C) NO PARENT BEFORE
pøedcvièitel	pøedcvièit	(C) NO PARENT BEFORE
pøedcvièovatel	pøedcvièovat	(C) NO PARENT BEFORE
pøedèítatel	pøedèítat	(C) NO PARENT BEFORE
pøedepisovatel	pøedepisovat	(C) NO PARENT BEFORE
pøedjímatel	pøedjímat	(C) NO PARENT BEFORE
pøedurèovatel	pøedurèovat	(C) NO PARENT BEFORE
pøedvídatel	pøedvídat	(C) NO PARENT BEFORE
pøedvychovatel	pøedvychovat	(C) NO PARENT BEFORE
pøeformulovávatel	pøeformulovávat	(C) NO PARENT BEFORE
pøehodnocovatel	pøehodnocovat	(C) NO PARENT BEFORE
pøehodnotitel	pøehodnotit	(C) NO PARENT BEFORE
pøechovávatel	pøechovávat	(C) NO PARENT BEFORE
pøejmenovatel	pøejmenovat	(C) NO PARENT BEFORE
pøekroèitel	pøekroèit	(C) NO PARENT BEFORE
pøekrucovatel	pøekrucovat	(C) NO PARENT BEFORE
pøekvapovatel	pøekvapovat	(C) NO PARENT BEFORE
pøemìòovatel	pøemìòovat	(C) NO PARENT BEFORE
pøemísovatel	pøemísovat	(C) NO PARENT BEFORE
pøemnoitel	pøemnoit	(C) NO PARENT BEFORE
pøenositel	pøenosit	(C) NO PARENT BEFORE
pøeposílatel	pøeposílat	(C) NO PARENT BEFORE
pøerozdìlovatel	pøerozdìlovat	(C) NO PARENT BEFORE
pøerušovatel	pøerušovat	(C) NO PARENT BEFORE
pøeskupovatel	pøeskupovat	(C) NO PARENT BEFORE
pøevychovávatel	pøevychovávat	(C) NO PARENT BEFORE
pøezkoumávatel	pøezkoumávat	(C) NO PARENT BEFORE
pøezkušovatel	pøezkušovat	(C) NO PARENT BEFORE
pøevıkatel	pøevıkat	(C) NO PARENT BEFORE
pøibliovatel	pøibliovat	(C) NO PARENT BEFORE
pøièinitel	pøièinit	(C) NO PARENT BEFORE
pøidìlovatel	pøidìlovat	(C) NO PARENT BEFORE
pøidrovatel	pøidrovat	(C) NO PARENT BEFORE
pøikazovatel	pøikazovat	(C) NO PARENT BEFORE
pøikrašlovatel	pøikrašlovat	(C) NO PARENT BEFORE
pøikrášlovatel	pøikrášlovat	(C) NO PARENT BEFORE
pøimlouvatel	pøimlouvat	(C) NO PARENT BEFORE
pøipisovatel	pøipisovat	(C) NO PARENT BEFORE
pøipojovatel	pøipojovat	(C) NO PARENT BEFORE
pøipomínkovatel	pøipomínkovat	(C) NO PARENT BEFORE
pøisvojitel	pøisvojit	(C) NO PARENT BEFORE
@	pøítel	pøít	(C) NO PARENT BEFORE
pøitvoøitel	pøitvoøit	(C) NO PARENT BEFORE
pøizpùsobitel	pøizpùsobit	(C) NO PARENT BEFORE
pøiivovatel	pøiivovat	(C) NO PARENT BEFORE
publikovatel	publikovat	(C) NO PARENT BEFORE
pùsobitel	pùsobit	(C) NO PARENT BEFORE
putovatel	putovat	(C) NO PARENT BEFORE
rabovatel	rabovat	(C) NO PARENT BEFORE
raditel	radit	(C) NO PARENT BEFORE
realizovatel	realizovat	(C) NO PARENT BEFORE
recyklovatel	recyklovat	(C) NO PARENT BEFORE
renovovatel	renovovat	(C) NO PARENT BEFORE
reprodukovatel	reprodukovat	(C) NO PARENT BEFORE
rozcvièovatel	rozcvièovat	(C) NO PARENT BEFORE
rozdìlitel	rozdìlit	(C) NO PARENT BEFORE
rozesmívatel	rozesmívat	(C) NO PARENT BEFORE
rozhlašovatel	rozhlašovat	(C) NO PARENT BEFORE
rozhøešitel	rozhøešit	(C) NO PARENT BEFORE
rozlišovatel	rozlišovat	(C) NO PARENT BEFORE
rozloitel	rozloit	(C) NO PARENT BEFORE
rozmisovatel	rozmisovat	(C) NO PARENT BEFORE
rozohòovatel	rozohòovat	(C) NO PARENT BEFORE
rozprašovatel	rozprašovat	(C) NO PARENT BEFORE
rozsvìcovatel	rozsvìcovat	(C) NO PARENT BEFORE
roztínatel	roztínat	(C) NO PARENT BEFORE
rozveselovatel	rozveselovat	(C) NO PARENT BEFORE
rozvrhovatel	rozvrhovat	(C) NO PARENT BEFORE
samoléèitel	samoléèit	(C) NO PARENT BEFORE
scelovatel	scelovat	(C) NO PARENT BEFORE
sèítatel	sèítat	(C) NO PARENT BEFORE
sdìlitel	sdìlit	(C) NO PARENT BEFORE
sdruovatel	sdruovat	(C) NO PARENT BEFORE
sebeutvrzovatel	sebeutvrzovat	(C) NO PARENT BEFORE
seøizovatel	seøizovat	(C) NO PARENT BEFORE
sestrojitel	sestrojit	(C) NO PARENT BEFORE
sestrojovatel	sestrojovat	(C) NO PARENT BEFORE
seznamovatel	seznamovat	(C) NO PARENT BEFORE
schraòovatel	schraòovat	(C) NO PARENT BEFORE
sjednatel	sjednat	(C) NO PARENT BEFORE
skládkovatel	skládkovat	(C) NO PARENT BEFORE
skupovatel	skupovat	(C) NO PARENT BEFORE
slibovatel	slibovat	(C) NO PARENT BEFORE
smìnitel	smìnit	(C) NO PARENT BEFORE
smìnkovatel	smìnkovat	(C) NO PARENT BEFORE
smìrovatel	smìrovat	(C) NO PARENT BEFORE
smlouvatel	smlouvat	(C) NO PARENT BEFORE
smolitel	smolit	(C) NO PARENT BEFORE
smıvatel	smıvat	(C) NO PARENT BEFORE
snovatel	snovat	(C) NO PARENT BEFORE
souloitel	souloit	(C) NO PARENT BEFORE
soustøeïovatel	soustøeïovat	(C) NO PARENT BEFORE
spolucestovatel	spolucestovat	(C) NO PARENT BEFORE
spolufinancovatel	spolufinancovat	(C) NO PARENT BEFORE
spolunavrhovatel	spolunavrhovat	(C) NO PARENT BEFORE
spoluobjevitel	spoluobjevit	(C) NO PARENT BEFORE
spolupodnikatel	spolupodnikat	(C) NO PARENT BEFORE
spoluprovozovatel	spoluprovozovat	(C) NO PARENT BEFORE
spoluruèitel	spoluruèit	(C) NO PARENT BEFORE
spolutvoøitel	spolutvoøit	(C) NO PARENT BEFORE
spoluvyhlašovatel	spoluvyhlašovat	(C) NO PARENT BEFORE
spoluvystavovatel	spoluvystavovat	(C) NO PARENT BEFORE
spravitel	spravit	(C) NO PARENT BEFORE
srovnávatel	srovnávat	(C) NO PARENT BEFORE
stanovovatel	stanovovat	(C) NO PARENT BEFORE
staratel	starat	(C) NO PARENT BEFORE
stìhovatel	stìhovat	(C) NO PARENT BEFORE
stlaèitel	stlaèit	(C) NO PARENT BEFORE
stmelitel	stmelit	(C) NO PARENT BEFORE
stmelovatel	stmelovat	(C) NO PARENT BEFORE
strašitel	strašit	(C) NO PARENT BEFORE
støeitel	støeit	(C) NO PARENT BEFORE
støíkatel	støíkat	(C) NO PARENT BEFORE
svìdèitel	svìdèit	(C) NO PARENT BEFORE
svìøitel	svìøit	(C) NO PARENT BEFORE
svolatel	svolat	(C) NO PARENT BEFORE
sypatel	sypat	(C) NO PARENT BEFORE
šifrovatel	šifrovat	(C) NO PARENT BEFORE
šikanovatel	šikanovat	(C) NO PARENT BEFORE
šlapatel	šlapat	(C) NO PARENT BEFORE
špiclovatel	špiclovat	(C) NO PARENT BEFORE
špízovatel	špízovat	(C) NO PARENT BEFORE
štìpitel	štìpit	(C) NO PARENT BEFORE
tavitel	tavit	(C) NO PARENT BEFORE
tepatel	tepat	(C) NO PARENT BEFORE
testovatel	testovat	(C) NO PARENT BEFORE
tìitel	tìit	(C) NO PARENT BEFORE
tipovatel	tipovat	(C) NO PARENT BEFORE
tlumitel	tlumit	(C) NO PARENT BEFORE
toèitel	toèit	(C) NO PARENT BEFORE
tøíbitel	tøíbit	(C) NO PARENT BEFORE
tušitel	tušit	(C) NO PARENT BEFORE
tvarovatel	tvarovat	(C) NO PARENT BEFORE
tyèitel	tyèit	(C) NO PARENT BEFORE
tıratel	tırat	(C) NO PARENT BEFORE
uèinitel	uèinit	(C) NO PARENT BEFORE
úètovatel	úètovat	(C) NO PARENT BEFORE
udìlitel	udìlit	(C) NO PARENT BEFORE
udolatel	udolat	(C) NO PARENT BEFORE
uchopitel	uchopit	(C) NO PARENT BEFORE
ujaømovatel	ujaømovat	(C) NO PARENT BEFORE
ukázòovatel	ukázòovat	(C) NO PARENT BEFORE
ukonèitel	ukonèit	(C) NO PARENT BEFORE
ukonèovatel	ukonèovat	(C) NO PARENT BEFORE
ukotvovatel	ukotvovat	(C) NO PARENT BEFORE
ukøiovatel	ukøiovat	(C) NO PARENT BEFORE
ukusovatel	ukusovat	(C) NO PARENT BEFORE
ulamovatel	ulamovat	(C) NO PARENT BEFORE
uloitel	uloit	(C) NO PARENT BEFORE
umíròovatel	umíròovat	(C) NO PARENT BEFORE
umísovatel	umísovat	(C) NO PARENT BEFORE
umlèovatel	umlèovat	(C) NO PARENT BEFORE
umoøitel	umoøit	(C) NO PARENT BEFORE
umoøovatel	umoøovat	(C) NO PARENT BEFORE
umoòovatel	umoòovat	(C) NO PARENT BEFORE
unikatel	unikat	(C) NO PARENT BEFORE
usilovatel	usilovat	(C) NO PARENT BEFORE
uskladòovatel	uskladòovat	(C) NO PARENT BEFORE
usmrcovatel	usmrcovat	(C) NO PARENT BEFORE
usnadòovatel	usnadòovat	(C) NO PARENT BEFORE
uspávatel	uspávat	(C) NO PARENT BEFORE
uspokojitel	uspokojit	(C) NO PARENT BEFORE
ustanovovatel	ustanovovat	(C) NO PARENT BEFORE
ustavovatel	ustavovat	(C) NO PARENT BEFORE
usuzovatel	usuzovat	(C) NO PARENT BEFORE
uštìdøovatel	uštìdøovat	(C) NO PARENT BEFORE
utajitel	utajit	(C) NO PARENT BEFORE
utajovatel	utajovat	(C) NO PARENT BEFORE
utišitel	utišit	(C) NO PARENT BEFORE
utišovatel	utišovat	(C) NO PARENT BEFORE
uvìdomovatel	uvìdomovat	(C) NO PARENT BEFORE
úvìrovatel	úvìrovat	(C) NO PARENT BEFORE
uveøejòovatel	uveøejòovat	(C) NO PARENT BEFORE
uvolòovatel	uvolòovat	(C) NO PARENT BEFORE
uzavíratel	uzavírat	(C) NO PARENT BEFORE
uzemòovatel	uzemòovat	(C) NO PARENT BEFORE
vdechovatel	vdechovat	(C) NO PARENT BEFORE
velkopodnikatel	velkopodnikat	(C) NO PARENT BEFORE
venèitel	venèit	(C) NO PARENT BEFORE
vìnovatel	vìnovat	(C) NO PARENT BEFORE
veršovatel	veršovat	(C) NO PARENT BEFORE
vmìšovatel	vmìšovat	(C) NO PARENT BEFORE
vnucovatel	vnucovat	(C) NO PARENT BEFORE
vodoléèitel	vodoléèit	(C) NO PARENT BEFORE
vršitel	vršit	(C) NO PARENT BEFORE
vybudovatel	vybudovat	(C) NO PARENT BEFORE
vydluitel	vydluit	(C) NO PARENT BEFORE
vyhladitel	vyhladit	(C) NO PARENT BEFORE
vyhledávatel	vyhledávat	(C) NO PARENT BEFORE
vyhodnocovatel	vyhodnocovat	(C) NO PARENT BEFORE
vyhodnotitel	vyhodnotit	(C) NO PARENT BEFORE
vyhovovatel	vyhovovat	(C) NO PARENT BEFORE
vyhıbatel	vyhıbat	(C) NO PARENT BEFORE
vychvalovatel	vychvalovat	(C) NO PARENT BEFORE
vyjasòovatel	vyjasòovat	(C) NO PARENT BEFORE
vyjevovatel	vyjevovat	(C) NO PARENT BEFORE
vykoøenitel	vykoøenit	(C) NO PARENT BEFORE
vykrmovatel	vykrmovat	(C) NO PARENT BEFORE
vykupovatel	vykupovat	(C) NO PARENT BEFORE
vylepovatel	vylepovat	(C) NO PARENT BEFORE
vylizovatel	vylizovat	(C) NO PARENT BEFORE
vymáhatel	vymáhat	(C) NO PARENT BEFORE
vymìòovatel	vymìòovat	(C) NO PARENT BEFORE
vymìøovatel	vymìøovat	(C) NO PARENT BEFORE
vymezitel	vymezit	(C) NO PARENT BEFORE
vymezovatel	vymezovat	(C) NO PARENT BEFORE
vymlouvatel	vymlouvat	(C) NO PARENT BEFORE
vynutitel	vynutit	(C) NO PARENT BEFORE
vyobrazitel	vyobrazit	(C) NO PARENT BEFORE
vypoøádatel	vypoøádat	(C) NO PARENT BEFORE
vyprazdòovatel	vyprazdòovat	(C) NO PARENT BEFORE
vyprošovatel	vyprošovat	(C) NO PARENT BEFORE
vypuditel	vypudit	(C) NO PARENT BEFORE
vyrovnatel	vyrovnat	(C) NO PARENT BEFORE
vyrušitel	vyrušit	(C) NO PARENT BEFORE
vyrušovatel	vyrušovat	(C) NO PARENT BEFORE
vyøizovatel	vyøizovat	(C) NO PARENT BEFORE
vysazovatel	vysazovat	(C) NO PARENT BEFORE
vyslovitel	vyslovit	(C) NO PARENT BEFORE
vysluhovatel	vysluhovat	(C) NO PARENT BEFORE
vyslıchatel	vyslıchat	(C) NO PARENT BEFORE
vystrkovatel	vystrkovat	(C) NO PARENT BEFORE
vyšvihovatel	vyšvihovat	(C) NO PARENT BEFORE
vytìsòovatel	vytìsòovat	(C) NO PARENT BEFORE
vytìovatel	vytìovat	(C) NO PARENT BEFORE
vytrubovatel	vytrubovat	(C) NO PARENT BEFORE
vytvoøitel	vytvoøit	(C) NO PARENT BEFORE
vytyèitel	vytyèit	(C) NO PARENT BEFORE
vytıkatel	vytıkat	(C) NO PARENT BEFORE
vyuèitel	vyuèit	(C) NO PARENT BEFORE
vyuívatel	vyuívat	(C) NO PARENT BEFORE
vyvìšovatel	vyvìšovat	(C) NO PARENT BEFORE
vyvolatel	vyvolat	(C) NO PARENT BEFORE
vyvrhovatel	vyvrhovat	(C) NO PARENT BEFORE
vyvyšovatel	vyvyšovat	(C) NO PARENT BEFORE
vyzaøovatel	vyzaøovat	(C) NO PARENT BEFORE
vyzbrojovatel	vyzbrojovat	(C) NO PARENT BEFORE
vyzraditel	vyzradit	(C) NO PARENT BEFORE
vzdìlávatel	vzdìlávat	(C) NO PARENT BEFORE
vzrušovatel	vzrušovat	(C) NO PARENT BEFORE
zabavovatel	zabavovat	(C) NO PARENT BEFORE
zabezpeèovatel	zabezpeèovat	(C) NO PARENT BEFORE
zabraòovatel	zabraòovat	(C) NO PARENT BEFORE
zaèeròovatel	zaèeròovat	(C) NO PARENT BEFORE
zaèínatel	zaèínat	(C) NO PARENT BEFORE
zahlazovatel	zahlazovat	(C) NO PARENT BEFORE
zachraòovatel	zachraòovat	(C) NO PARENT BEFORE
zakreslovatel	zakreslovat	(C) NO PARENT BEFORE
zakroèitel	zakroèit	(C) NO PARENT BEFORE
zamìòovatel	zamìòovat	(C) NO PARENT BEFORE
zamoøovatel	zamoøovat	(C) NO PARENT BEFORE
zaplevelovatel	zaplevelovat	(C) NO PARENT BEFORE
zaplnitel	zaplnit	(C) NO PARENT BEFORE
zapojovatel	zapojovat	(C) NO PARENT BEFORE
zapuditel	zapudit	(C) NO PARENT BEFORE
zaruèitel	zaruèit	(C) NO PARENT BEFORE
zaøazovatel	zaøazovat	(C) NO PARENT BEFORE
zasahovatel	zasahovat	(C) NO PARENT BEFORE
zastrašovatel	zastrašovat	(C) NO PARENT BEFORE
zastøešovatel	zastøešovat	(C) NO PARENT BEFORE
zaštiovatel	zaštiovat	(C) NO PARENT BEFORE
zatlaèovatel	zatlaèovat	(C) NO PARENT BEFORE
zatracovatel	zatracovat	(C) NO PARENT BEFORE
zatratitel	zatratit	(C) NO PARENT BEFORE
zatykatel	zatykat	(C) NO PARENT BEFORE
zauèovatel	zauèovat	(C) NO PARENT BEFORE
zavinitel	zavinit	(C) NO PARENT BEFORE
zavlaovatel	zavlaovat	(C) NO PARENT BEFORE
završovatel	završovat	(C) NO PARENT BEFORE
zázraèitel	zázraèit	(C) NO PARENT BEFORE
zbošovatel	zbošovat	(C) NO PARENT BEFORE
zbudovatel	zbudovat	(C) NO PARENT BEFORE
zèešovatel	zèešovat	(C) NO PARENT BEFORE
zdùrazòovatel	zdùrazòovat	(C) NO PARENT BEFORE
zdùvìròovatel	zdùvìròovat	(C) NO PARENT BEFORE
zesilovatel	zesilovat	(C) NO PARENT BEFORE
zesvìtšovatel	zesvìtšovat	(C) NO PARENT BEFORE
zevšedòovatel	zevšedòovat	(C) NO PARENT BEFORE
zhasínatel	zhasínat	(C) NO PARENT BEFORE
zhoršovatel	zhoršovat	(C) NO PARENT BEFORE
získatel	získat	(C) NO PARENT BEFORE
zjasòovatel	zjasòovat	(C) NO PARENT BEFORE
zjevitel	zjevit	(C) NO PARENT BEFORE
zjišovatel	zjišovat	(C) NO PARENT BEFORE
zkoumatel	zkoumat	(C) NO PARENT BEFORE
zkrotitel	zkrotit	(C) NO PARENT BEFORE
zkrucovatel	zkrucovat	(C) NO PARENT BEFORE
zkulturòovatel	zkulturòovat	(C) NO PARENT BEFORE
zlehèovatel	zlehèovat	(C) NO PARENT BEFORE
zlevòovatel	zlevòovat	(C) NO PARENT BEFORE
zlobitel	zlobit	(C) NO PARENT BEFORE
zmahatel	zmahat	(C) NO PARENT BEFORE
zmìkèovatel	zmìkèovat	(C) NO PARENT BEFORE
zmíròovatel	zmíròovat	(C) NO PARENT BEFORE
zmnoovatel	zmnoovat	(C) NO PARENT BEFORE
zmrazovatel	zmrazovat	(C) NO PARENT BEFORE
znaèitel	znaèit	(C) NO PARENT BEFORE
znamenatel	znamenat	(C) NO PARENT BEFORE
znárodòovatel	znárodòovat	(C) NO PARENT BEFORE
znehodnocovatel	znehodnocovat	(C) NO PARENT BEFORE
znehodnotitel	znehodnotit	(C) NO PARENT BEFORE
znehybòovatel	znehybòovat	(C) NO PARENT BEFORE
znechucovatel	znechucovat	(C) NO PARENT BEFORE
zneklidòovatel	zneklidòovat	(C) NO PARENT BEFORE
znepøíjemòovatel	znepøíjemòovat	(C) NO PARENT BEFORE
znesvìcovatel	znesvìcovat	(C) NO PARENT BEFORE
zneškodòovatel	zneškodòovat	(C) NO PARENT BEFORE
zneuívatel	zneuívat	(C) NO PARENT BEFORE
znevaovatel	znevaovat	(C) NO PARENT BEFORE
znovuobjevitel	znovuobjevit	(C) NO PARENT BEFORE
zohavitel	zohavit	(C) NO PARENT BEFORE
zosobitel	zosobit	(C) NO PARENT BEFORE
zostuditel	zostudit	(C) NO PARENT BEFORE
zpevòovatel	zpevòovat	(C) NO PARENT BEFORE
zpodobitel	zpodobit	(C) NO PARENT BEFORE
zpodobòovatel	zpodobòovat	(C) NO PARENT BEFORE
zpodobovatel	zpodobovat	(C) NO PARENT BEFORE
zpochybòovatel	zpochybòovat	(C) NO PARENT BEFORE
zpovídatel	zpovídat	(C) NO PARENT BEFORE
zprivatizovatel	zprivatizovat	(C) NO PARENT BEFORE
zpronevìøitel	zpronevìøit	(C) NO PARENT BEFORE
zprostøedkovávatel	zprostøedkovávat	(C) NO PARENT BEFORE
zprovozòovatel	zprovozòovat	(C) NO PARENT BEFORE
zpøístupòovatel	zpøístupòovat	(C) NO PARENT BEFORE
zpùsobitel	zpùsobit	(C) NO PARENT BEFORE
zpytatel	zpytat	(C) NO PARENT BEFORE
zraòovatel	zraòovat	(C) NO PARENT BEFORE
zroditel	zrodit	(C) NO PARENT BEFORE
ztìovatel	ztìovat	(C) NO PARENT BEFORE
ztotoòovatel	ztotoòovat	(C) NO PARENT BEFORE
ztrpèovatel	ztrpèovat	(C) NO PARENT BEFORE
zúroèitel	zúroèit	(C) NO PARENT BEFORE
zvìèòovatel	zvìèòovat	(C) NO PARENT BEFORE
zvelièovatel	zvelièovat	(C) NO PARENT BEFORE
zvídatel	zvídat	(C) NO PARENT BEFORE
zvítìzitel	zvítìzit	(C) NO PARENT BEFORE
ebratel	ebrat	(C) NO PARENT BEFORE
