aeroshow	show#NNXXX-----A----
aerosol	sol#NNI??-----A---?
aerotop	top#NNI??-----A---?
biosen	sen#NNI??-----A---?
biohovězí	hovězí#NNNS?-----A----
bioden	den#NNI??-----A---?
biomodel	model#NNI??-----A---?
biopotřeba	potřeba#NNF??-----A---?
bioshow	show#NNXXX-----A----
bioskot	skot#NNI??-----A---?
biomarket	market#NNI??-----A---?
biofaktor	faktor#NNI??-----A---?
bioagens	agens#NNI??-----A---?
biokout	kout#NNI??-----A---?
biotábor	tábor#NNI??-----A---?
biodobytek	dobytek#NNI??-----A---?
biořízek	řízek#NNI??-----A---?
biokřen	křen#NNI??-----A---?
biotop	top#AAXXX----1A----
biomoc	moc#NNF??-----A---?
biobuřt	buřt#NNI??-----A---?
biodítě	dítě#NNNS?-----A----
bioplazma	plazma#NNF??-----A---?
cyklonosič	nosič#NNI??-----A---?
cykloden	den#NNI??-----A---?
cyklopotřeba	potřeba#NNF??-----A---?
cyklorikša	rikša#NNF??-----A---?
cyklovidlák	vidlák#NNM??-----A---?
cyklovečer	večer#NNI??-----A---?
cykloprůvodce	průvodce#NNI??-----A----
cykloveterán	veterán#NNI??-----A---?
cyklokolos	kolos#NNI??-----A---?
cykloesej	esej#NNF??-----A---?
cyklotábor	tábor#NNI??-----A---?
cyklogigant	gigant#NNI??-----A---?
cyklopěší	pěší#AA???----1?---?
cyklopaťák	paťák#NNM??-----A---?
postblokový	blokový#AA???----??---?
postpunk	punk#NNI??-----A---?
ekovečer	večer#NNI??-----A---?
ekotop	top#AAXXX----1A----
fotomodel	model#NNI??-----A---?
fotovodič	vodič#NNI??-----A---?
fotopásek	pásek#NNI??-----A---?
fotoesej	esej#NNF??-----A---?
fototip	tip#AAXXX----1A----
fotoeditor	editor#NNM??-----A---?
transexpres	expres#Db-------------
turbomotor	turbo#NNN??-----A---?
turbodiesel	turbo#NNN??-----A---?
turbokarta	turbo#AAXXX----1A----
turbofavorit	turbo#NNN??-----A---?
turbofavorit	favorit#NNI??-----A---?
turbopauza	turbo#AAXXX----1A----
ultraradikál	radikál#NNM??-----A---?
megashow	show#NNXXX-----A----
megastar	star#NNFXX-----A----
megastát	stát#NNI??-----?---?
megabecquerel	becquerel#NNI??-----A---?
pidistát	stát#NNI??-----?---?
mimozemšťan	mimo#RR--2----------
mimoglobální	mimo#RR--2----------
polosen	sen#NNI??-----A---?
polomrtvý	mrtvý#A????----??---?
polovodič	vodič#NNI??-----A---?
polosirota	sirota#NNM??-----A---?
polostep	step#NNF??-----A----
půlden	den#NNI??-----A---?
polyhalit	halit#NNI??-----A---?
polyhybrid	hybrid#NNI??-----A---?
multimodel	model#NNI??-----A---?
multivideo	video#AAXXX----1A----
multiadaptér	adaptér#NNI??-----A---?
multitalent	talent#NNI??-----A---?
radiopotřeba	potřeba#Db-------------
radioindikátor	indikátor#NNI??-----A---?
mimoodborný	mimo#RR--2----------
mimokošíkářský	mimo#RR--2----------
mimokřesťanský	mimo#RR--2----------
mimoloutkářský	mimo#RR--2----------
mimomalířský	mimo#RR--2----------
mimonakladatelský	mimo#RR--2----------
mimoodborářský	mimo#RR--2----------
mimopotravinářský	mimo#RR--2----------
mimoevropan	mimo#RR--2----------
krimipříběh	krimi#AAXXX----1A----
mimoverbální	mimo#RR--2----------
mimoodovolací	mimo#RR--2----------
audiometr	audio#AAXXX----1A----
bílozlatohnědý	zlatý#AA???----??---?
celotáborový	tábor#NNI??-----A---?
celovečerní	večer#NNI??-----A---?
cizojazyčný	jazyk#NNI??-----A---?
dalekojdoucí	daleko#Dg-------??---?
dalekozření	daleko#Dg-------??---?
víceprocesní	hodně#Dg-------??---?
víceproudý	hodně#Dg-------??---?
víceventilový	hodně#Dg-------??---?
horkovod	horko#NNN??-----A---?
hornohradební	horní#AA???----??---?
jídlonosič	nosič#NNI??-----A---?
jinojazyčný	jazyk#NNI??-----A---?
kdovíjak	jak#Db-----------?-
kolemstojící	kolem#RR--2----------
lázeňskoléčebný	lázeňský#AA???----??---?
makrojazyk	jazyk#NNI??-----A---?
makroukazatel	ukazatel#NNI??-----A---?
mimobiologický	mimo#RR--2----------
mimobursovní	mimo#RR--2----------
mimocelní	mimo#RR--2----------
mimoglobální	mimo#RR--2----------
mimohospodářský	mimo#RR--2----------
mimoherní	mimo#RR--2----------
mimokonkursní	mimo#RR--2----------
mimolidský	mimo#RR--2----------
mimoliterární	mimo#RR--2----------
mimomzdový	mimo#RR--2----------
mimonárodní	mimo#RR--2----------
mimonovinářský	mimo#RR--2----------
mimoobligační	mimo#RR--2----------
mimooborový	mimo#RR--2----------
mimoodvětvový	mimo#RR--2----------
mimoplanetární	mimo#RR--2----------
mimoprofesní	mimo#RR--2----------
mimoprovozní	mimo#RR--2----------
mimoresortní	mimo#RR--2----------
mimorybářský	mimo#RR--2----------
mimosterlingový	mimo#RR--2----------
mimotrestní	mimo#RR--2----------
mimotřídní	mimo#RR--2----------
mimoústecký	mimo#RR--2----------
modrozlatý	zlatý#AA???----??---?
pětimístný	místo#NNN??-----A---?
samorostlý	růst#V???---??-??I??
samovařič	vařič#NNI??-----A---?
softsexykomedie	soft#AAXXX----1A----
spoluvěřící	věřící#AG???-----?---?
staroběloruský	starý#A????----??---?
staroegyptský	starý#A????----??---?
starokomický	starý#A????----??---?
staroměstký	starý#A????----??---?
svatomartinský	svatý#A????----??---?
thaiboxer	boxer#NNM??-----A---?
tmavězlatý	zlatý#AA???----??---?
velevhod	vhod#Dg-------1?----
videoanarchie	video#AAXXX----1A----
videozařízení	video#AAXXX----1A----
vlhkoměr	vlhko#Dg-------??---?
vnitrostátní	stát#NNI??-----?---?
zlatobýl	zlatý#AA???----??---?
zlatolící	zlatý#AA???----??---?
zlatoústý	zlatý#AA???----??---?
zlatovlasý	zlatý#AA???----??---?
zlatozelenohnědý	zlatý#AA???----??---?
zpětnovazební	vazba#NNF??-----A---?
zvonkohra	zvonek#NNI??-----A---?
artrock	rock#NNIS?-----A----
audioefekt	audio#AAXXX----1A----
audiokniha	audio#AAXXX----1A----
audiomixér	audio#AAXXX----1A----
audiopošta	audio#AAXXX----1A----
audiopřehrávač	audio#AAXXX----1A----
audioprůvodce	audio#AAXXX----1A----
audioprůvodce	průvodce#NNI??-----A----
audiořetěz	audio#AAXXX----1A----
audiosignál	audio#AAXXX----1A----
audiostudio	audio#AAXXX----1A----
audiovstup	audio#AAXXX----1A----
audiovýstup	audio#AAXXX----1A----
audiozařízení	audio#AAXXX----1A----
balíkomat	balík#NNI??-----A---?
betaverze	beta#AAXXX----1A----
bétřídní	třídní#AA???----??---?
bílozelenozlatý	zlatý#AA???----??---?
bílozlatý	zlatý#AA???----??---?
bioberan	beran#NNI??-----A---?
bionosič	nosič#NNI??-----A---?
biosexy	sexy#AAXXX----1A----
bokorys	rys#NNI??-----A---?
bůhvíjak	jak#Db-----------?-
černočervenozlatý	zlatý#AA???----??---?
černoočka	oko#NNN??-----A---?
černooký	oko#NNN??-----A---?
černozlatý	zlatý#AA???----??---?
červenooký	oko#NNN??-----A---?
červenozlatý	zlatý#AA???----??---?
chudokvětý	chudý#A????----??---?
chudozubý	chudý#A????----??---?
countrybál	country#AAXXX----1A----
cykloshow	show#AAXXX----1A----
dalekonosný	daleko#Dg-------??---?
dalekostřelný	daleko#Dg-------??---?
diashow	show#NNXXX-----A----
dílovedoucí	vedoucí#NNM??-----A---?
diskohvězda	disko#AAXXX----1A----
diskokabaret	disko#AAXXX----1A----
diskokomplex	disko#AAXXX----1A----
diskokostým	disko#AAXXX----1A----
diskokrál	disko#AAXXX----1A----
diskometalový	disko#AAXXX----1A----
diskoodpoledne	disko#AAXXX----1A----
diskoodpoledne	odpoledne#NNN??-----A---?
diskoretro	disko#AAXXX----1A----
diskorytmus	disko#AAXXX----1A----
diskoterapie	disko#AAXXX----1A----
divotvorce	div#NNI??-----A---?
divotvorný	div#NNI??-----A---?
duchověda	duch#NNI??-----A---?
elektrovýzbroj	výzbroj#NNF??-----A---?
folkrock	folk#AAXXX----1A----
folkrock	rock#NNIS?-----A----
hnědozlatý	zlatý#AA???----??---?
hornoblatenský	horní#AA???----??---?
hornoegyptský	horní#AA???----??---?
hornomoravský	horní#AA???----??---?
hornooravský	horní#AA???----??---?
hornopočernický	horní#AA???----??---?
hornorakouský	horní#AA???----??---?
hornoroveňský	horní#AA???----??---?
jaksepatří	jak#Db-----------?-
jazykověda	jazyk#NNI??-----A---?
jazykozpyt	jazyk#NNI??-----A---?
jazzband	jazz#AAXXX----1A----
jazzklub	jazz#AAXXX----1A----
jazzrock	jazz#AAXXX----1A----
jazzrock	rock#AAXXX----1A----
jazzuchtivý	jazz#AAXXX----1A----
kapraďorost	růst#V???---??-??I??
klapouchý	ucho#NNF??-----A----
knihvedoucí	vedoucí#NNM??-----A---?
koldokola	kolem#Db-------------
kolkolem	kolem#Db-------------
kolkolem	kolem#Db-------------
krátkodenní	den#NNI??-----A---?
krimifilm	krimi#NNNXX-----A----
krimiparodie	krimi#NNNXX-----A----
krytokořenný	kořen#NNI??-----A---?
lapiduch	duch#NNI??-----A---?
lesostep	step#NNF??-----A----
letorost	růst#V???---??-??I??
mechorost	růst#V???---??-??I??
měděnozlatý	zlatý#AA???----??---?
megamarket	market#NNI??-----A---?
mimoalpský	mimo#RR--2----------
mimoamerický	mimo#RR--2----------
mimobankovní	mimo#RR--2----------
mimobankrotový	mimo#RR--2----------
mimobásnický	mimo#RR--2----------
mimobiblický	mimo#RR--2----------
mimobilanční	mimo#RR--2----------
mimoboční	mimo#RR--2----------
mimobratislavský	mimo#RR--2----------
mimobrněnský	mimo#RR--2----------
mimobroadwayský	mimo#RR--2----------
mimobuněčný	mimo#RR--2----------
mimoburzovní	mimo#RR--2----------
mimočasový	mimo#RR--2----------
mimocenový	mimo#RR--2----------
mimočeský	mimo#RR--2----------
mimocestovní	mimo#RR--2----------
mimocévní	mimo#RR--2----------
mimochod	mimo#RR--2----------
mimochrámový	mimo#RR--2----------
mimocírkevní	mimo#RR--2----------
mimoděk	mimo#RR--2----------
mimoděk	dík#NNI??-----A---?
mimodiskusní	mimo#Db-------------
mimodivadelní	mimo#Db-------------
mimoekonomický	mimo#Db-------------
mimoemisní	mimo#Db-------------
mimoestetický	mimo#Db-------------
mimoetický	mimo#Db-------------
mimoevropský	mimo#Db-------------
mimofakultní	mimo#Db-------------
mimofinanční	mimo#Db-------------
mimofotbalový	mimo#Db-------------
mimogalaktický	mimo#Db-------------
mimogalerijní	mimo#Db-------------
mimohistorický	mimo#Db-------------
mimohnízdní	mimo#Db-------------
mimohokejový	mimo#Db-------------
mimohollywoodský	mimo#Db-------------
mimohotelový	mimo#Db-------------
mimohradecký	mimo#Db-------------
mimohrudní	mimo#Db-------------
mimohudební	mimo#Db-------------
mimohusinecký	mimo#Db-------------
mimohutní	mimo#Db-------------
mimoideologický	mimo#Db-------------
mimoindický	mimo#Db-------------
mimojaderný	mimo#Db-------------
mimojaponský	mimo#Db-------------
mimojaterní	mimo#Db-------------
mimojazykový	mimo#Db-------------
mimojazykový	jazyk#NNI??-----A---?
mimojdoucí	mimo#Db-------------
mimojedoucí	mimo#Db-------------
mimojihlavský	mimo#Db-------------
mimojiné	mimo#Db-------------
mimokladenský	mimo#Db-------------
mimokloubní	mimo#Db-------------
mimoknihovní	mimo#Db-------------
mimokomisní	mimo#Db-------------
mimokomunistický	mimo#Db-------------
mimokonferenční	mimo#Db-------------
mimokonkurzní	mimo#Db-------------
mimokořenový	mimo#Db-------------
mimokořenový	kořen#NNI??-----A---?
mimokorový	mimo#RR--2----------
mimokursový	mimo#RR--2----------
mimoléčebný	mimo#RR--2----------
mimolexikální	mimo#RR--2----------
mimoliberecký	mimo#RR--2----------
mimolimitní	mimo#RR--2----------
mimoliturgický	mimo#RR--2----------
mimologický	mimo#RR--2----------
mimolondýnský	mimo#RR--2----------
mimoměstský	mimo#RR--2----------
mimomotoristický	mimo#RR--2----------
mimomyšlenkový	mimo#RR--2----------
mimoněmecký	mimo#RR--2----------
mimonemocniční	mimo#RR--2----------
mimoobchodní	mimo#RR--2----------
mimoobecní	mimo#RR--2----------
mimoodborový	mimo#RR--2----------
mimoodpovědnostní	mimo#RR--2----------
mimoprávní	mimo#RR--2----------
mimoprocesní	mimo#RR--2----------
mimorezortní	mimo#RR--2----------
mimorodinný	mimo#RR--2----------
mimosporný	mimo#RR--2----------
mimotělesný	mimo#RR--2----------
mimotelevizní	mimo#RR--2----------
mimotoleranční	mimo#RR--2----------
mimovolný	mimo#RR--2----------
místokonsul	místo#Db-------------
místopředseda	místo#Db-------------
místoředitel	místo#Db-------------
místoregent	místo#Db-------------
modrozlatozelený	zlatý#AA???----??---?
mokropředený	mokro#Dg-------?A----
nabíledni	den#NNI??-----A---?
nevímjak	jak#Db-----------?-
nicnetušící	nic#PY--1----------
nicnevyzařující	nic#PY--1----------
okohybný	oko#NNN??-----A---?
okolojdoucí	okolo#RR--2----------
okolostojící	okolo#RR--2----------
okolostojící	stát#V???---??-??I??
orgánotvorný	orgán#NNI??-----A---?
papírodárný	dát#V???---??-?AI??
pětipromilový	promile#NNF??-----A---?
pianoforte	forte#Db-------------
plazmagen	plazma#NNF??-----A---?
polodospělý	dospělý#AA???----??---?
polomrtvý	mrtvý#A????----??---?
polonemocný	nemocný#A????----??---?
poloobrat	obrat#NNI??-----A---?
polosen	sen#NNI??-----A---?
polosirota	sirota#NNF??-----A---?
polostep	step#NNF??-----A----
polosvětlo	světlo#Db-------------
polotajný	tajný#AA???----??---?
polovodič	vodič#NNI??-----A---?
polozraněný	zraněný#AA???----??---?
pophvězda	pop#AAXXX----1A----
popkultura	pop#AAXXX----1A----
popmusic	pop#AAXXX----1A----
popmusic	music#AAXXX----1A----
poprock	pop#AAXXX----1A----
poprock	rock#AAXXX----1A----
popstar	pop#AAXXX----1A----
popstar	star#NNFXX-----A----
prvočinitel	činitel#NNI??-----A---?
punkrock	punk#AAXXX----1A----
punkrock	rock#AAXXX----1A----
radiopotřeba	potřeba#NNF??-----A---?
rudozlatý	zlatý#AA???----??---?
šedooký	oko#NNN??-----A---?
sexyhrátky	sexy#AAXXX----1A----
sexyklip	sexy#AAXXX----1A----
šikmooký	oko#NNN??-----A---?
skorodospělý	dospělý#AA???----??---?
škrtovláda	škrt#NNM??-----A---?
skrznaskrz	skrz#Db-------------
skrznaskrz	skrz#Db-------------
slaboduchý	duch#NNI??-----A---?
slovnědruhový	druh#NNM??-----A---?
směrodatný	dát#V???---??-?AI??
smutnooký	oko#NNN??-----A---?
špekbuřt	buřt#NNI??-----A---?
spolumluvčí	mluvčí#NNM??-----A---?
staroasyrský	starý#A????----??---?
starohory	starý#A????----??---?
staromódní	starý#A????----??---?
staromoravský	starý#A????----??---?
starořeč	starý#A????----??---?
startrekovský	star#NNFXX-----A----
státohrad	stát#NNI??-----?---?
stavbyvedoucí	vedoucí#NNM??-----A---?
strojvedoucí	vedoucí#NNM??-----A---?
superoyal	super#AAXXX----1A----
svatostánek	svatý#A????----??---?
svatováclavský	svatý#A????----??---?
svatvečer	svatý#A????----??---?
svatvečer	večer#Db-------------
světlobojný	světlo#Db-------------
světlobojný	bát#NNI??-----A---?
tajnokřídlý	tajný#AA???----??---?
technotaneční	taneční#AA???----??---?
vápnobojný	bát#NNI??-----A---?
veleduchý	duch#NNI??-----A---?
velikoduchý	duch#NNI??-----A---?
velkoduchý	duch#NNI??-----A---?
vícefotonový	hodně#Db-------------
víceohniskový	hodně#Db-------------
víceramenný	hodně#Db-------------
videoadaptér	video#AAXXX----1A----
videoadaptér	adaptér#NNI??-----A---?
videoaparát	video#AAXXX----1A----
videočip	video#AAXXX----1A----
videodeník	video#AAXXX----1A----
videodigitizér	video#AAXXX----1A----
videodisketa	video#AAXXX----1A----
videodisplej	video#AAXXX----1A----
videodriver	video#AAXXX----1A----
videoeditovat	video#AAXXX----1A----
videoefekt	video#AAXXX----1A----
videoexpres	video#AAXXX----1A----
videoexpres	expres#NNI??-----A---?
videofestival	video#AAXXX----1A----
videofikce	video#AAXXX----1A----
videofilm	video#AAXXX----1A----
videofotoaparát	video#AAXXX----1A----
videohardware	video#AAXXX----1A----
videohit	video#AAXXX----1A----
videohovor	video#AAXXX----1A----
videohra	video#AAXXX----1A----
videoklub	video#AAXXX----1A----
videokomunikace	video#AAXXX----1A----
videokonektor	video#AAXXX----1A----
videokopie	video#AAXXX----1A----
videomikrografie	video#AAXXX----1A----
videomost	video#AAXXX----1A----
videonosič	video#AAXXX----1A----
videonosič	nosič#NNI??-----A---?
videoobvod	video#AAXXX----1A----
videoparty	video#AAXXX----1A----
videopirát	video#AAXXX----1A----
videopořad	video#AAXXX----1A----
videoport	video#AAXXX----1A----
videoportál	video#AAXXX----1A----
videopošta	video#AAXXX----1A----
videopráce	video#AAXXX----1A----
videopřekryv	video#AAXXX----1A----
videopřenos	video#AAXXX----1A----
videopřípad	video#AAXXX----1A----
videopříprava	video#AAXXX----1A----
videoprogram	video#AAXXX----1A----
videopromítačka	video#AAXXX----1A----
videoprvek	video#AAXXX----1A----
videorozhodčí	video#AAXXX----1A----
videorozhodčí	rozhodčí#NNM??-----A---?
videoskop	video#AAXXX----1A----
videospektrální	video#AAXXX----1A----
videospojení	video#AAXXX----1A----
videostřih	video#AAXXX----1A----
videotip	video#AAXXX----1A----
videotip	tip#AAXXX----1A----
videovkus	video#AAXXX----1A----
videovstup	video#AAXXX----1A----
videovýběr	video#AAXXX----1A----
videozáběr	video#AAXXX----1A----
videozpráva	video#AAXXX----1A----
vlakvedoucí	vedoucí#NNM??-----A---?
vnitrodenní	den#NNI??-----A---?
vojevůdce	voj#NNI??-----A---?
volnoběh	volný#A????----??---?
vydřiduch	duch#NNI??-----A---?
vysokobřezí	vysoko#Dg-------??---?
vysokorozený	vysoko#Dg-------??---?
vysokotepelný	teplo#NNN??-----A---?
vzdorokandidát	vzdor#NNI??-----A---?
vzdorokultura	vzdor#NNI??-----A---?
vzdoroprezident	vzdor#NNI??-----A---?
vzdororepublika	vzdor#NNI??-----A---?
vzdorovláda	vzdor#NNI??-----A---?
zelenočervenozlatý	zlatý#AA???----??---?
zelenooký	oko#NNN??-----A---?
zelenozlatý	zlatý#AA???----??---?
zimomorný	zima#NNF??-----A---?
zimovzdorný	zima#NNF??-----A---?
zimovzdorný	vzdor#NNI??-----A---?
zlatobílý	zlatý#AA???----??---?
zlatohorský	zlatý#AA???----??---?
zlatoplavý	zlatý#AA???----??---?
zlatořitný	zlatý#AA???----??---?
zlatorudný	zlatý#AA???----??---?
zlatorudý	zlatý#AA???----??---?
dvoučlenný	člen#NNI??-----?---?
dvouoký	oko#NNN??-----A---?
jednodruhový	druh#NNI??-----A---?
jednoduchý	duch#NNI??-----A---?
jednofaktorový	faktor#NNI??-----A---?
jednojazyčný	jazyk#NNI??-----A---?
bílonachový	bílo#Db-------------
diskomelodie	disko#NNNS?-----A----
divukrásný	div#Db-------------
drátosklo	drát#NNI??-----A---?
jódškrobový	škrob#NNI??-----A---?
mimoabonentní	mimo#RR--2----------
mimoakademický	mimo#RR--2----------
mimoodvolací	mimo#RR--2----------
mimoohniskový	mimo#RR--2----------
mimoolomoucký	mimo#RR--2----------
mimooperní	mimo#RR--2----------
mimoosobní	mimo#RR--2----------
mimoosový	mimo#RR--2----------
mimoostravský	mimo#RR--2----------
mimopánevní	mimo#RR--2----------
mimopardubický	mimo#RR--2----------
mimoparlamentní	mimo#RR--2----------
mimopecní	mimo#RR--2----------
mimoplatový	mimo#RR--2----------
mimoplicní	mimo#RR--2----------
mimoplzeňský	mimo#RR--2----------
mimopočítačový	mimo#RR--2----------
mimopodnikový	mimo#RR--2----------
mimopolicejní	mimo#RR--2----------
mimopolitický	mimo#RR--2----------
mimopoštovní	mimo#RR--2----------
mimopracovní	mimo#RR--2----------
mimoprodejní	mimo#RR--2----------
mimoprodukční	mimo#RR--2----------
mimoprostějovský	mimo#RR--2----------
mimoprostor	mimo#RR--2----------
mimopstruhový	mimo#RR--2----------
mimoracionální	mimo#RR--2----------
mimořádný	mimo#RR--2----------
mimorakouský	mimo#RR--2----------
mimorakovnický	mimo#RR--2----------
mimorámový	mimo#RR--2----------
mimořečový	mimo#RR--2----------
mimoregionální	mimo#RR--2----------
mimorevoluční	mimo#RR--2----------
mimoringový	mimo#RR--2----------
mimořitní	mimo#RR--2----------
mimorozhlasový	mimo#RR--2----------
mimorozpočtový	mimo#RR--2----------
mimorozumový	mimo#RR--2----------
mimosemilský	mimo#RR--2----------
mimosezonní	mimo#RR--2----------
mimosezónní	mimo#RR--2----------
mimosilniční	mimo#RR--2----------
mimoškolní	mimo#RR--2----------
mimoškolský	mimo#RR--2----------
mimoskupinový	mimo#RR--2----------
mimoslovenský	mimo#RR--2----------
mimoslovní	mimo#RR--2----------
mimosměnečný	mimo#RR--2----------
mimosmluvní	mimo#RR--2----------
mimosmyslový	mimo#RR--2----------
mimosoudní	mimo#RR--2----------
mimosoustavový	mimo#RR--2----------
mimošpičkový	mimo#RR--2----------
mimospolečenský	mimo#RR--2----------
mimosportovní	mimo#RR--2----------
mimostátní	mimo#RR--2----------
mimostátní	stát#NNI??-----?---?
mimostaveništní	mimo#Db-------------
mimostranický	mimo#Db-------------
mimostředný	mimo#Db-------------
mimostřevní	mimo#Db-------------
mimosvazový	mimo#Db-------------
mimosvětský	mimo#Db-------------
mimosystémový	mimo#Db-------------
mimotarifní	mimo#Db-------------
mimotělní	mimo#Db-------------
mimotextový	mimo#Db-------------
mimoto	mimo#Db-------------
mimotopný	mimo#Db-------------
mimotropický	mimo#Db-------------
mimoučební	mimo#Db-------------
mimoúčetní	mimo#Db-------------
mimoumělecký	mimo#Db-------------
mimouniverzitní	mimo#Db-------------
mimoúřední	mimo#Db-------------
mimoúrovňový	mimo#Db-------------
mimoústavní	mimo#Db-------------
mimoúvěrový	mimo#Db-------------
mimovědecký	mimo#Db-------------
mimovědní	mimo#Db-------------
mimovegetační	mimo#Db-------------
mimovládní	mimo#Db-------------
mimovojenský	mimo#Db-------------
mimovolní	mimo#Db-------------
mimovýcvikový	mimo#Db-------------
mimovýrobní	mimo#Db-------------
mimovyučovací	mimo#Db-------------
mimozákonný	mimo#Db-------------
mimozaměstnanecký	mimo#Db-------------
mimozáruční	mimo#Db-------------
mimozávodní	mimo#Db-------------
mimozávodový	mimo#Db-------------
mimozemský	mimo#Db-------------
mimozkušenostní	mimo#Db-------------
mimozlínský	mimo#Db-------------
mimozrakový	mimo#Db-------------
minieditor	editor#NNI??-----A---?
miniinterview	interview#NNNXX-----A----
minisen	sen#NNI??-----A---?
minishow	show#NNXXX-----A----
minisoft	soft#NNI??-----A---?
minisporťák	sporťák#NNI??-----A---?
ministát	stát#NNI??-----?---?
minivarhany	varhany#NNFP?-----A---?
optočlen	člen#NNI??-----?---?
organologie	orgán#NNI??-----A---?
prvomájový	máj#NNI??-----A---?
samostatný	stát#V???---??-??I??
samovazba	vazba#NNM??-----A---?
samovolný	volný#A????----??---?
sexykomedie	sexy#AAXXX----1A----
staromilec	starý#A????----??---?
větněčlenský	člen#NNI??-----?---?
víceklínový	hodně#Db-------------
vícekolejnicový	hodně#Db-------------
vícepokojový	hodně#Db-------------
vícesektorový	hodně#Db-------------
videoencyklopedie	video#AAXXX----1A----
vnitrodruhový	druh#NNM??-----A---?
vnitrojazykový	jazyk#NNI??-----A---?
vnitrooční	oko#NNN??-----A---?
vnitrosovětský	sovět#NNI??-----A---?
