abbé 	 abb-é 	 abb-é
absolutno 	 absolut-n-o 	 absolut-n-o
abychom 	 a-by-chom 	 a-by-chom
adami 	 adami 	 adami
adresovat 	 adres-ova-t 	 adres-ova-t
adresu 	 adres-u 	 adres-u
aeromagneticky 	 aero-magnet-ic-k-y 	 aero-magnet-ic-k-y
agnoston 	 agnoston 	 agnoston
agovávat 	 agov-á-v-a-t 	 agov-á-v-a-t
akceptovat 	 akcept-ova-t 	 akcept-ova-t
akcií 	 akci-í 	 akci-í
aktivní 	 akt-iv-n-í 	 akt-iv-n-í
alfou 	 alf-ou 	 alf-ou
aloise 	 alois-e 	 alois-e
američanům 	 američ-an-ům 	 američ-an-ům
amplifikovat 	 ampli-fik-ova-t 	 ampli-fik-ova-t
anderson 	 anderson 	 anderson
aniž 	 aniž 	 aniž
anthony 	 anthony 	 anthony
anticipovat 	 anti-cip-ova-t 	 anti-cip-ova-t
antidatujeme 	 anti-dat-uje-me 	 anti-dat-uje-me
arcilotras 	 arci-lotr-as 	 arci-lotr-as
argaláš 	 argaláš 	 argaláš
aristokratismu 	 aristo-krat-ism-u 	 aristo-krat-ism-u
asistovat 	 asist-ova-t 	 asist-ova-t
atlet 	 atlet 	 atlet
austrálie 	 austrál-i-e 	 austrál-i-e
autobazar 	 aut-o-bazar 	 aut-o-bazar
babulakův 	 babulak-ův 	 babulak-ův
bafnout 	 baf-nou-t 	 baf-nou-t
balgarův 	 balgar-ův 	 balgar-ův
balit 	 bal-i-t 	 bal-i-t
bania 	 bani-a 	 bani-a
barikádovat 	 barik-ád-ova-t 	 barik-ád-ova-t
bartoch 	 bartoch 	 bartoch
basovat 	 bas-ova-t 	 bas-ova-t
batňovic 	 batňovic 	 batňovic
baťa 	 bať-a 	 bať-a
bekem 	 bekem 	 bekem
benediktýnů 	 benedikt-ýn-ů 	 benedikt-ýn-ů
beranit 	 beran-i-t 	 beran-i-t
bez 	 bez 	 bez
bezpečný 	 bezpeč-n-ý 	 bezpeč-n-ý
bezplatnou 	 bez-plat-n-ou 	 bez-plat-n-ou
bečce 	 beč-c-e 	 beč-c-e
bilanční 	 bilanč-n-í 	 bilanč-n-í
bionafty 	 bio-naft-y 	 bio-naft-y
blouznit 	 blouzn-i-t 	 blouzn-i-t
bláznivého 	 blázn-iv-ého 	 blázn-iv-ého
bobek 	 bob-ek 	 bob-ek
body 	 bod-y 	 bod-y
bojovat 	 boj-ova-t 	 boj-ova-t
bojíme 	 boj-í-me 	 boj-í-me
bok 	 bok 	 bok
bolení 	 bol-e-n-í 	 bol-e-n-í
bolest 	 bol-est 	 bol-est
bolívie 	 bolív-i-e 	 bolív-i-e
bombast 	 bombast 	 bombast
bot 	 bot 	 bot
boudou 	 boud-ou 	 boud-ou
boudě 	 boud-ě 	 boud-ě
box 	 box 	 box
boxovat 	 box-ova-t 	 box-ova-t
branka 	 bran-k-a 	 bran-k-a
brend 	 brend 	 brend
brečeli 	 breč-e-l-i 	 breč-e-l-i
briketovat 	 briket-ova-t 	 briket-ova-t
britské 	 brit-sk-é 	 brit-sk-é
broukat 	 brouk-a-t 	 brouk-a-t
brožura 	 brožur-a 	 brožur-a
brummellův 	 brummell-ův 	 brummell-ův
brázdit 	 brázd-i-t 	 brázd-i-t
brýlemi 	 brýl-emi 	 brýl-emi
budova 	 bud-ova 	 bud-ova
budu 	 bud-u 	 bud-u
bujně 	 buj-n-ě 	 buj-n-ě
bušit 	 buš-i-t 	 buš-i-t
byla 	 by-l-a 	 by-l-a
bytu 	 by-t-u 	 by-t-u
bytě 	 by-t-ě 	 by-t-ě
bázlivá 	 bá-z-l-iv-á 	 bá-z-l-iv-á
báša 	 báš-a 	 báš-a
běžného 	 běž-n-ého 	 běž-n-ého
castrogiovanni 	 castrogiovanni 	 castrogiovanni
celkovou 	 cel-k-ov-ou 	 cel-k-ov-ou
celková 	 cel-k-ov-á 	 cel-k-ov-á
celu 	 cel-u 	 cel-u
cenit 	 cen-i-t 	 cen-i-t
cennou 	 cen-n-ou 	 cen-n-ou
cenou 	 cen-ou 	 cen-ou
centru 	 centr-u 	 centr-u
cephalocereus 	 cephalocereus 	 cephalocereus
cepovat 	 cep-ova-t 	 cep-ova-t
cestovní 	 cest-ov-n-í 	 cest-ov-n-í
cesty 	 cest-y 	 cest-y
charakterem 	 charakter-em 	 charakter-em
charakteru 	 charakter-u 	 charakter-u
chcete 	 chc-e-te 	 chc-e-te
chladná 	 chlad-n-á 	 chlad-n-á
chlubí 	 chlub-í 	 chlub-í
chlácholil 	 chláchol-i-l 	 chláchol-i-l
chléb 	 chléb 	 chléb
chmátnout 	 chmát-nou-t 	 chmát-nou-t
chodu 	 chod-u 	 chod-u
chovají 	 chov-aj-í 	 chov-aj-í
chránit 	 chrán-i-t 	 chrán-i-t
chudáci 	 chud-ác-i 	 chud-ác-i
chvilce 	 chvil-c-e 	 chvil-c-e
chvástat 	 chvást-a-t 	 chvást-a-t
chápat 	 cháp-a-t 	 cháp-a-t
cimrmanovština 	 cimrman-ov-št-in-a 	 cimrman-ov-št-in-a
citlivostí 	 cit-l-iv-ost-í 	 cit-l-iv-ost-í
citovaného 	 cit-ova-n-ého 	 cit-ova-n-ého
colubrina 	 colubrin-a 	 colubrin-a
cos 	 c-o-s 	 c-o-s
coulem 	 coul-em 	 coul-em
courama 	 cour-ama 	 cour-ama
couvnout 	 couv-nou-t 	 couv-nou-t
cukru 	 cukr-u 	 cukr-u
cválat 	 cvál-a-t 	 cvál-a-t
cyklu 	 cykl-u 	 cykl-u
cílevědomý 	 cíl-e-věd-om-ý 	 cíl-e-věd-om-ý
dadat 	 dad-a-t 	 dad-a-t
daklar 	 daklar 	 daklar
daly 	 d-a-l-y 	 d-a-l-y
danost 	 d-a-n-ost 	 d-a-n-ost
daru 	 dar-u 	 dar-u
daty 	 dat-y 	 dat-y
deep 	 deep 	 deep
degradovat 	 de-grad-ova-t 	 de-grad-ova-t
deklarována 	 de-klar-ová-n-a 	 de-klar-ová-n-a
deklarováno 	 de-klar-ová-n-o 	 de-klar-ová-n-o
dem 	 dem 	 dem
demokratizovat 	 demo-krat-iz-ova-t 	 demo-krat-iz-ova-t
demoralizovat 	 de-moral-iz-ova-t 	 de-moral-iz-ova-t
denní 	 den-n-í 	 den-n-í
desíti 	 desít-i 	 desít-i
deváté 	 devát-é 	 devát-é
devět 	 devět 	 devět
dewey 	 dewey 	 dewey
dezinfikovat 	 dez-infik-ova-t 	 dez-infik-ova-t
dezinteresovat 	 dez-interes-ova-t 	 dez-interes-ova-t
dezorganizovat 	 dez-organ-iz-ova-t 	 dez-organ-iz-ova-t
dešifrovat 	 de-šifr-ova-t 	 de-šifr-ova-t
diavolo 	 diavolo 	 diavolo
diferovat 	 difer-ova-t 	 difer-ova-t
diky 	 dik-y 	 dik-y
diků 	 dik-ů 	 dik-ů
diplomové 	 diplom-ov-é 	 diplom-ov-é
dlouhodobého 	 dlouh-o-dob-ého 	 dlouh-o-dob-ého
dloužit 	 dlouž-i-t 	 dlouž-i-t
dlužna 	 dluž-n-a 	 dluž-n-a
dlužné 	 dluž-n-é 	 dluž-n-é
dnešek 	 dneš-ek 	 dneš-ek
dno 	 dn-o 	 dn-o
dober 	 do-ber 	 do-ber
dobra 	 dobr-a 	 dobr-a
dobudovat 	 do-bud-ova-t 	 do-bud-ova-t
dobytek 	 do-byt-ek 	 do-byt-ek
dobytí 	 do-by-tí 	 do-by-tí
dobíhají 	 do-bíh-aj-í 	 do-bíh-aj-í
docházela 	 do-cház-e-l-a 	 do-cház-e-l-a
docítil 	 do-cít-i-l 	 do-cít-i-l
dodat 	 do-d-a-t 	 do-d-a-t
dodavatel 	 do-d-a-v-a-tel 	 do-d-a-v-a-tel
dodavatelem 	 do-d-a-v-a-tel-em 	 do-d-a-v-a-tel-em
dodiveně 	 do-div-en-ě 	 do-div-en-ě
dodržovat 	 do-drž-ova-t 	 do-drž-ova-t
dodržování 	 do-drž-ová-n-í 	 do-drž-ová-n-í
dodáno 	 do-d-á-n-o 	 do-d-á-n-o
dodávat 	 do-d-á-v-a-t 	 do-d-á-v-a-t
dodávka 	 do-d-á-v-k-a 	 do-d-á-v-k-a
dohasnout 	 do-has-nou-t 	 do-has-nou-t
dohlídnout 	 do-hlíd-nou-t 	 do-hlíd-nou-t
dohodou 	 do-hod-ou 	 do-hod-ou
dojmů 	 do-jm-ů 	 do-jm-ů
doklady 	 do-klad-y 	 do-klad-y
doklopýtat 	 do-klopýt-a-t 	 do-klopýt-a-t
dokonaleji 	 do-kon-a-l-eji 	 do-kon-a-l-eji
dokonávat 	 do-kon-á-v-a-t 	 do-kon-á-v-a-t
dokončovat 	 do-konč-ova-t 	 do-konč-ova-t
dole 	 dol-e 	 dol-e
doletovat 	 do-let-ova-t 	 do-let-ova-t
doloudat 	 do-loud-a-t 	 do-loud-a-t
domluva 	 do-mluv-a 	 do-mluv-a
domílat 	 do-míl-a-t 	 do-míl-a-t
domýšlet 	 do-mýšl-e-t 	 do-mýšl-e-t
donést 	 do-nés-t 	 do-nés-t
dopisovatel 	 do-pis-ova-tel 	 do-pis-ova-tel
doplacení 	 do-plac-en-í 	 do-plac-en-í
doplnit 	 do-pln-i-t 	 do-pln-i-t
doplácet 	 do-plác-e-t 	 do-plác-e-t
dopomáhat 	 do-po-máh-a-t 	 do-po-máh-a-t
dopravu 	 do-prav-u 	 do-prav-u
dopáleně 	 do-pál-en-ě 	 do-pál-en-ě
dopídit 	 do-píd-i-t 	 do-píd-i-t
dopít 	 do-pí-t 	 do-pí-t
dopřávat 	 do-přá-v-a-t 	 do-přá-v-a-t
dorachtávatelnost 	 do-racht-á-v-a-teln-ost 	 do-racht-á-v-a-teln-ost
dostavil 	 do-stav-i-l 	 do-stav-i-l
dostavili 	 do-stav-i-l-i 	 do-stav-i-l-i
dostaviti 	 do-stav-i-ti 	 do-stav-i-ti
dostačit 	 do-stač-i-t 	 do-stač-i-t
dostrkali 	 do-strk-a-l-i 	 do-strk-a-l-i
dostává 	 do-stá-v-á 	 do-stá-v-á
dostřelit 	 do-střel-i-t 	 do-střel-i-t
dosvědčíme 	 do-s-věd-č-í-me 	 do-s-věd-č-í-me
dotloukat 	 do-tlouk-a-t 	 do-tlouk-a-t
dovedeš 	 do-ved-e-š 	 do-ved-e-š
dovinout 	 do-vi-nou-t 	 do-vi-nou-t
dovláčet 	 do-vláč-e-t 	 do-vláč-e-t
dovolí 	 do-vol-í 	 do-vol-í
dovozem 	 do-voz-em 	 do-voz-em
dovídat 	 do-víd-a-t 	 do-víd-a-t
dozvěděli 	 do-z-věd-ě-l-i 	 do-z-věd-ě-l-i
doštupování 	 do-štup-ová-n-í 	 do-štup-ová-n-í
dožebrat 	 do-žebr-a-t 	 do-žebr-a-t
drobná 	 drob-n-á 	 drob-n-á
druhy 	 druh-y 	 druh-y
družnosti 	 druž-n-ost-i 	 druž-n-ost-i
dráhu 	 dráh-u 	 dráh-u
drápek 	 dráp-ek 	 dráp-ek
drápky 	 dráp-k-y 	 dráp-k-y
dubnové 	 dubn-ov-é 	 dubn-ov-é
duchovně 	 duch-ov-n-ě 	 duch-ov-n-ě
duhový 	 duh-ov-ý 	 duh-ov-ý
duní 	 dun-í 	 dun-í
dušiček 	 duš-iček 	 duš-iček
dvanáct 	 dv-a-náct 	 dv-a-náct
dveře 	 dveř-e 	 dveř-e
dvojit 	 dvoj-i-t 	 dvoj-i-t
dvoustraně 	 dv-ou-stran-ě 	 dv-ou-stran-ě
dává 	 d-á-v-á 	 d-á-v-á
dávána 	 d-á-v-á-n-a 	 d-á-v-á-n-a
díra 	 dír-a 	 dír-a
dívám 	 dív-á-m 	 dív-á-m
dózovat 	 dóz-ova-t 	 dóz-ova-t
dějiny 	 děj-in-y 	 děj-in-y
děkovat 	 děk-ova-t 	 děk-ova-t
dělení 	 děl-en-í 	 děl-en-í
dělostřelec 	 děl-o-střel-ec 	 děl-o-střel-ec
děláme 	 děl-á-me 	 děl-á-me
děti 	 dět-i 	 dět-i
dřeně 	 dřen-ě 	 dřen-ě
dřepnout 	 dřep-nou-t 	 dřep-nou-t
dřevěný 	 dřev-ě-n-ý 	 dřev-ě-n-ý
dřít 	 dř-í-t 	 dř-í-t
dřívko 	 dřív-k-o 	 dřív-k-o
důkladněji 	 dů-klad-n-ěji 	 dů-klad-n-ěji
důležitost 	 dů-lež-it-ost 	 dů-lež-it-ost
důležitá 	 dů-lež-it-á 	 dů-lež-it-á
důvěrnosti 	 dů-věr-n-ost-i 	 dů-věr-n-ost-i
důvěrně 	 dů-věr-n-ě 	 dů-věr-n-ě
důvěře 	 dů-věř-e 	 dů-věř-e
efektů 	 efekt-ů 	 efekt-ů
ekologické 	 eko-log-ick-é 	 eko-log-ick-é
ekologického 	 eko-log-ick-ého 	 eko-log-ick-ého
ekonomech 	 eko-nom-ech 	 eko-nom-ech
ekonomové 	 eko-nom-ov-é 	 eko-nom-ov-é
elidovat 	 elid-ova-t 	 elid-ova-t
epocha 	 epoch-a 	 epoch-a
et 	 et 	 et
eva 	 ev-a 	 ev-a
evropského 	 evrop-sk-ého 	 evrop-sk-ého
ex 	 ex 	 ex
expedovat 	 exped-ova-t 	 exped-ova-t
experiment 	 experi-ment 	 experi-ment
experimentaci 	 experi-ment-ac-i 	 experi-ment-ac-i
exportu 	 ex-port-u 	 ex-port-u
fach 	 fach 	 fach
faktum 	 fakt-um 	 fakt-um
faktury 	 fakt-ur-y 	 fakt-ur-y
farmě 	 farm-ě 	 farm-ě
fastfood 	 fast-food 	 fast-food
firmou 	 firm-ou 	 firm-ou
firmy 	 firm-y 	 firm-y
fluorově 	 fluor-ov-ě 	 fluor-ov-ě
fondy 	 fond-y 	 fond-y
fondů 	 fond-ů 	 fond-ů
formát 	 form-át 	 form-át
formátů 	 form-át-ů 	 form-át-ů
fosforeskovat 	 fosfor-esk-ova-t 	 fosfor-esk-ova-t
fošen 	 fošen 	 fošen
franciska 	 francisk-a 	 francisk-a
frotýrovat 	 frot-ýr-ova-t 	 frot-ýr-ova-t
ft 	 f-t 	 f-t
gel 	 gel 	 gel
geraldu 	 gerald-u 	 gerald-u
graessneriji 	 graessneriji 	 graessneriji
greenwalda 	 green-wald-a 	 green-wald-a
greenwaldovi 	 green-wald-ovi 	 green-wald-ovi
hafat 	 haf-a-t 	 haf-a-t
halou 	 hal-ou 	 hal-ou
halu 	 hal-u 	 hal-u
haly 	 hal-y 	 hal-y
hamonit 	 hamon-i-t 	 hamon-i-t
hamounit 	 hamoun-i-t 	 hamoun-i-t
harant 	 harant 	 harant
havarovat 	 havar-ova-t 	 havar-ova-t
heep 	 heep 	 heep
hegelianism 	 hegelian-ism 	 hegelian-ism
herní 	 her-n-í 	 her-n-í
hlad 	 hlad 	 hlad
hladce 	 hlad-c-e 	 hlad-c-e
hladový 	 hlad-ov-ý 	 hlad-ov-ý
hladí 	 hlad-í 	 hlad-í
hlasy 	 hlas-y 	 hlas-y
hlavu 	 hlav-u 	 hlav-u
hledám 	 hled-á-m 	 hled-á-m
hluk 	 hluk 	 hluk
hlučný 	 hluč-n-ý 	 hluč-n-ý
hlášeno 	 hláš-en-o 	 hláš-en-o
hmatat 	 hmat-a-t 	 hmat-a-t
hmotnostech 	 hmot-n-ost-ech 	 hmot-n-ost-ech
hmotnosti 	 hmot-n-ost-i 	 hmot-n-ost-i
hnedle 	 hned-le 	 hned-le
hnízda 	 hnízd-a 	 hnízd-a
hoch 	 hoch 	 hoch
hodnotu 	 hod-n-ot-u 	 hod-n-ot-u
hojně 	 hoj-n-ě 	 hoj-n-ě
holanďan 	 holanď-an 	 holanď-an
honkat 	 honk-a-t 	 honk-a-t
honoráře 	 honor-ář-e 	 honor-ář-e
horoucně 	 hor-ou-c-n-ě 	 hor-ou-c-n-ě
horovat 	 hor-ova-t 	 hor-ova-t
horách 	 hor-ách 	 hor-ách
horálek 	 horálek 	 horálek
hospody 	 hospod-y 	 hospod-y
hospodě 	 hospod-ě 	 hospod-ě
hotelů 	 hotel-ů 	 hotel-ů
houževnatá 	 houžev-n-at-á 	 houžev-n-at-á
hovět 	 hov-ě-t 	 hov-ě-t
hradec 	 hrad-ec 	 hrad-ec
hrdostí 	 hrd-ost-í 	 hrd-ost-í
hroznou 	 hrozn-ou 	 hrozn-ou
hrozí 	 hroz-í 	 hroz-í
hrála 	 hrá-l-a 	 hrá-l-a
hrálo 	 hrá-l-o 	 hrá-l-o
hubovat 	 hub-ova-t 	 hub-ova-t
huby 	 hub-y 	 hub-y
hudby 	 hud-b-y 	 hud-b-y
hudební 	 hud-eb-n-í 	 hud-eb-n-í
hudebníci 	 hud-eb-níc-i 	 hud-eb-níc-i
hulit 	 hul-i-t 	 hul-i-t
humbuk 	 humbuk 	 humbuk
huti 	 hut-i 	 hut-i
huť 	 huť 	 huť
hygiena 	 hygien-a 	 hygien-a
hádat 	 hád-a-t 	 hád-a-t
hřebec 	 hřeb-ec 	 hřeb-ec
hřešit 	 hřeš-i-t 	 hřeš-i-t
hřmět 	 hřm-ě-t 	 hřm-ě-t
hřížit 	 hříž-i-t 	 hříž-i-t
ian 	 ian 	 ian
imitovat 	 imit-ova-t 	 imit-ova-t
improvizovat 	 im-prov-iz-ova-t 	 im-prov-iz-ova-t
inaugurován 	 inaugur-ová-n 	 inaugur-ová-n
index 	 index 	 index
informovat 	 in-form-ova-t 	 in-form-ova-t
informován 	 in-form-ová-n 	 in-form-ová-n
informuje 	 in-form-uje 	 in-form-uje
inherovat 	 inher-ova-t 	 inher-ova-t
inkriminované 	 in-krimin-ova-n-é 	 in-krimin-ova-n-é
inovace 	 inov-ace 	 inov-ace
inspirovat 	 in-spir-ova-t 	 in-spir-ova-t
instrumentovat 	 instrument-ova-t 	 instrument-ova-t
instrumentů 	 instru-ment-ů 	 instru-ment-ů
interesovat 	 interes-ova-t 	 interes-ova-t
investovalo 	 in-vest-ova-l-o 	 in-vest-ova-l-o
irena 	 iren-a 	 iren-a
iron 	 iron 	 iron
jaa 	 jaa 	 jaa
jací 	 jac-í 	 jac-í
jakost 	 jak-ost 	 jak-ost
jakže 	 jak-že 	 jak-že
jan 	 jan 	 jan
janků 	 jan-k-ů 	 jan-k-ů
javelin 	 javelin 	 javelin
jděte 	 jd-ě-te 	 jd-ě-te
jediný 	 jedin-ý 	 jedin-ý
jedině 	 jedin-ě 	 jedin-ě
jednak 	 jednak 	 jednak
jednali 	 jedn-a-l-i 	 jedn-a-l-i
jednalo 	 jedn-a-l-o 	 jedn-a-l-o
jedno 	 jedn-o 	 jedn-o
jednom 	 jedn-o-m 	 jedn-o-m
jednomu 	 jedn-o-mu 	 jedn-o-mu
jednorázové 	 jedn-o-ráz-ov-é 	 jedn-o-ráz-ov-é
jednota 	 jedn-ot-a 	 jedn-ot-a
jednotlivina 	 jedn-ot-liv-in-a 	 jedn-ot-liv-in-a
jednotlivými 	 jedn-ot-liv-ými 	 jedn-ot-liv-ými
jednotný 	 jedn-ot-n-ý 	 jedn-ot-n-ý
jednotě 	 jedn-ot-ě 	 jedn-ot-ě
jednou 	 jedn-ou 	 jedn-ou
jela 	 je-l-a 	 je-l-a
jenjen 	 jen-jen 	 jen-jen
jenže 	 jen-že 	 jen-že
jeskyni 	 jeskyn-i 	 jeskyn-i
jethro 	 jethro 	 jethro
jevil 	 jev-i-l 	 jev-i-l
ješitnost 	 ješit-n-ost 	 ješit-n-ost
ježatý 	 jež-at-ý 	 jež-at-ý
jiker 	 jiker 	 jiker
jiní 	 jin-í 	 jin-í
jistota 	 jist-ot-a 	 jist-ot-a
john 	 john 	 john
joint 	 joint 	 joint
jádře 	 jádř-e 	 jádř-e
kajutu 	 kajut-u 	 kajut-u
kaktusů 	 kaktus-ů 	 kaktus-ů
kalkulovat 	 kalk-ul-ova-t 	 kalk-ul-ova-t
kamera 	 kamera 	 kamera
kamionů 	 kamion-ů 	 kamion-ů
kanadského 	 kanad-sk-ého 	 kanad-sk-ého
kanonizovat 	 kanon-iz-ova-t 	 kanon-iz-ova-t
kapitální 	 kapitál-n-í 	 kapitál-n-í
kapitána 	 kapitán-a 	 kapitán-a
kapsu 	 kaps-u 	 kaps-u
kasernovat 	 kasern-ova-t 	 kasern-ova-t
kaše 	 kaš-e 	 kaš-e
kefurt 	 kefurt 	 kefurt
kina 	 kin-a 	 kin-a
klausův 	 klaus-ův 	 klaus-ův
klepat 	 klep-a-t 	 klep-a-t
klečela 	 kleč-e-l-a 	 kleč-e-l-a
klidná 	 klid-n-á 	 klid-n-á
klouznout 	 klouz-nou-t 	 klouz-nou-t
kluk 	 kluk 	 kluk
klást 	 klás-t 	 klás-t
koledovat 	 koled-ova-t 	 koled-ova-t
koleno 	 kolen-o 	 kolen-o
kolébat 	 koléb-a-t 	 koléb-a-t
kolísat 	 kolís-a-t 	 kolís-a-t
kompetence 	 kompetenc-e 	 kompetenc-e
koncert 	 koncert 	 koncert
koncertem 	 koncert-em 	 koncert-em
koncertu 	 koncert-u 	 koncert-u
koncertě 	 koncert-ě 	 koncert-ě
koncertů 	 koncert-ů 	 koncert-ů
kondenzátor 	 kondenz-átor 	 kondenz-átor
kondolovat 	 kondol-ova-t 	 kondol-ova-t
konečná 	 koneč-n-á 	 koneč-n-á
konfederovat 	 kon-feder-ova-t 	 kon-feder-ova-t
konkretizovat 	 kon-kret-iz-ova-t 	 kon-kret-iz-ova-t
konstatování 	 kon-stat-ová-n-í 	 kon-stat-ová-n-í
kontaminovat 	 kon-tamin-ova-t 	 kon-tamin-ova-t
kontrolovaná 	 kontrol-ova-n-á 	 kontrol-ova-n-á
konvenovat 	 konven-ova-t 	 konven-ova-t
kopce 	 kop-c-e 	 kop-c-e
kopl 	 kop-l 	 kop-l
kopnout 	 kop-nou-t 	 kop-nou-t
kopulovat 	 kopul-ova-t 	 kopul-ova-t
korat 	 kor-a-t 	 kor-a-t
korovatět 	 kor-ov-at-ě-t 	 kor-ov-at-ě-t
koukají 	 kouk-aj-í 	 kouk-aj-í
koupací 	 koup-ac-í 	 koup-ac-í
koupi 	 koup-i 	 koup-i
kouta 	 kout-a 	 kout-a
kožené 	 kož-en-é 	 kož-en-é
kraj 	 kraj 	 kraj
krakově 	 krakov-ě 	 krakov-ě
krb 	 krb 	 krb
kriminální 	 krimin-ál-n-í 	 krimin-ál-n-í
kristapána 	 krist-a-pán-a 	 krist-a-pán-a
kritikou 	 krit-ik-ou 	 krit-ik-ou
krk 	 krk 	 krk
kroužila 	 krouž-i-l-a 	 krouž-i-l-a
krumlesco 	 krumlesco 	 krumlesco
krumlova 	 krumlov-a 	 krumlov-a
krušanov 	 kruš-an-ov 	 kruš-an-ov
krvavět 	 krv-av-ě-t 	 krv-av-ě-t
krylová 	 kryl-ov-á 	 kryl-ov-á
krám 	 krám 	 krám
kráse 	 krás-e 	 krás-e
krátkodobé 	 krát-k-o-dob-é 	 krát-k-o-dob-é
kráva 	 kráv-a 	 kráv-a
kteří 	 kteř-í 	 kteř-í
kudrnatět 	 kudr-n-at-ě-t 	 kudr-n-at-ě-t
kufr 	 kufr 	 kufr
kunovice 	 kun-ovic-e 	 kun-ovic-e
kupkovat 	 kup-k-ova-t 	 kup-k-ova-t
kuponové 	 kupon-ov-é 	 kupon-ov-é
kusů 	 kus-ů 	 kus-ů
kušovat 	 kuš-ova-t 	 kuš-ova-t
kvalitou 	 kval-it-ou 	 kval-it-ou
kvasit 	 kvas-i-t 	 kvas-i-t
květnu 	 květ-n-u 	 květ-n-u
kydat 	 kyd-a-t 	 kyd-a-t
kysnout 	 kys-nou-t 	 kys-nou-t
kyčel 	 kyčel 	 kyčel
kédr 	 kédr 	 kédr
křepčit 	 křep-č-i-t 	 křep-č-i-t
křestním 	 křest-n-í-m 	 křest-n-í-m
křižovatce 	 křiž-ovat-c-e 	 křiž-ovat-c-e
kříž 	 kříž 	 kříž
kšeft 	 kšeft 	 kšeft
kšeftu 	 kšeft-u 	 kšeft-u
lamentovat 	 lament-ova-t 	 lament-ova-t
le 	 le 	 le
ledna 	 led-n-a 	 led-n-a
lehce 	 leh-c-e 	 leh-c-e
lehko 	 leh-k-o 	 leh-k-o
lepí 	 lep-í 	 lep-í
lesa 	 les-a 	 les-a
letadlech 	 let-a-dl-ech 	 let-a-dl-ech
letiště 	 let-išt-ě 	 let-išt-ě
letouny 	 let-oun-y 	 let-oun-y
letošní 	 letoš-n-í 	 letoš-n-í
letí 	 let-í 	 let-í
letíš 	 let-í-š 	 let-í-š
ligni 	 ligni 	 ligni
lihem 	 lih-em 	 lih-em
limitováno 	 limit-ová-n-o 	 limit-ová-n-o
linkovat 	 lin-k-ova-t 	 lin-k-ova-t
listech 	 list-ech 	 list-ech
listu 	 list-u 	 list-u
londýně 	 londýn-ě 	 londýn-ě
loni 	 lon-i 	 lon-i
lotsenovu 	 lotsen-ov-u 	 lotsen-ov-u
ložnicový 	 lož-nic-ov-ý 	 lož-nic-ov-ý
lumpačit 	 lump-ač-i-t 	 lump-ač-i-t
lupa 	 lup-a 	 lup-a
látky 	 lát-k-y 	 lát-k-y
lázní 	 lázn-í 	 lázn-í
léky 	 lék-y 	 lék-y
lékárně 	 lék-ár-n-ě 	 lék-ár-n-ě
léta 	 lét-a 	 lét-a
léčbě 	 léč-b-ě 	 léč-b-ě
líbezně 	 líb-ez-n-ě 	 líb-ez-n-ě
lítosti 	 lít-ost-i 	 lít-ost-i
lóži 	 lóž-i 	 lóž-i
makrokonvertor 	 makro-kon-ver-t-or 	 makro-kon-ver-t-or
malém 	 mal-ém 	 mal-ém
mamlasovi 	 maml-as-ovi 	 maml-as-ovi
manažerovi 	 manažer-ovi 	 manažer-ovi
manšestrovém 	 manšestr-ov-ém 	 manšestr-ov-ém
manšestrový 	 manšestr-ov-ý 	 manšestr-ov-ý
manželů 	 manžel-ů 	 manžel-ů
marco 	 marc-o 	 marc-o
marně 	 mar-n-ě 	 mar-n-ě
martina 	 martin-a 	 martin-a
maršrútu 	 maršrút-u 	 maršrút-u
mast 	 mast 	 mast
mekat 	 mek-a-t 	 mek-a-t
melodie 	 melod-i-e 	 melod-i-e
mepha 	 meph-a 	 meph-a
mezku 	 mezk-u 	 mezk-u
meč 	 meč 	 meč
meškat 	 mešk-a-t 	 mešk-a-t
mhouřit 	 mhouř-i-t 	 mhouř-i-t
mil 	 mil 	 mil
milionů 	 mili-on-ů 	 mili-on-ů
milo 	 mil-o 	 mil-o
milost 	 mil-ost 	 mil-ost
milování 	 mil-ová-n-í 	 mil-ová-n-í
milá 	 mil-á 	 mil-á
mimoškolními 	 mimo-škol-n-ími 	 mimo-škol-n-ími
ministerstva 	 minister-stv-a 	 minister-stv-a
ministři 	 ministř-i 	 ministř-i
mixovat 	 mix-ova-t 	 mix-ova-t
mjasisčev 	 mjasisčev 	 mjasisčev
mladě 	 mlad-ě 	 mlad-ě
mluvila 	 mluv-i-l-a 	 mluv-i-l-a
mládí 	 mlád-í 	 mlád-í
mlátí 	 mlát-í 	 mlát-í
mnichově 	 mnichov-ě 	 mnichov-ě
mnohými 	 mnoh-ými 	 mnoh-ými
mocná 	 moc-n-á 	 moc-n-á
model 	 model 	 model
modrou 	 modr-ou 	 modr-ou
mohutnět 	 moh-ut-n-ě-t 	 moh-ut-n-ě-t
moje 	 moj-e 	 moj-e
mokro 	 mok-r-o 	 mok-r-o
monopol 	 mono-pol 	 mono-pol
montáž 	 mont-áž 	 mont-áž
monument 	 monument 	 monument
moravského 	 morav-sk-ého 	 morav-sk-ého
more 	 more 	 more
motole 	 motol-e 	 motol-e
motorů 	 motor-ů 	 motor-ů
movis 	 movis 	 movis
mrcho 	 mrch-o 	 mrch-o
mrtvé 	 mr-tv-é 	 mr-tv-é
musela 	 mus-e-l-a 	 mus-e-l-a
muselo 	 mus-e-l-o 	 mus-e-l-o
mučírna 	 muč-írn-a 	 muč-írn-a
mužný 	 muž-n-ý 	 muž-n-ý
mužů 	 muž-ů 	 muž-ů
mykat 	 myk-a-t 	 myk-a-t
mylná 	 myl-n-á 	 myl-n-á
myslím 	 mysl-í-m 	 mysl-í-m
média 	 médi-a 	 médi-a
míra 	 mír-a 	 mír-a
místní 	 míst-n-í 	 míst-n-í
místných 	 míst-n-ých 	 míst-n-ých
místo 	 míst-o 	 míst-o
míře 	 míř-e 	 míř-e
mířit 	 míř-i-t 	 míř-i-t
míří 	 míř-í 	 míř-í
mědit 	 měd-i-t 	 měd-i-t
měněn 	 měn-ěn 	 měn-ěn
městu 	 měst-u 	 měst-u
nabídla 	 na-bíd-l-a 	 na-bíd-l-a
nabídnout 	 na-bíd-nou-t 	 na-bíd-nou-t
nachlemtat 	 na-chlemt-a-t 	 na-chlemt-a-t
nachomýtnout 	 na-chomýt-nou-t 	 na-chomýt-nou-t
nacházet 	 na-cház-e-t 	 na-cház-e-t
nacizovávatelnost 	 na-ciz-ová-v-a-teln-ost 	 na-ciz-ová-v-a-teln-ost
nacpávat 	 na-cp-á-v-a-t 	 na-cp-á-v-a-t
nadbíhat 	 nad-bíh-a-t 	 nad-bíh-a-t
nadklánět 	 nad-klán-ě-t 	 nad-klán-ě-t
nadout 	 na-dou-t 	 na-dou-t
nadpočetné 	 nad-po-čet-n-é 	 nad-po-čet-n-é
nadychovat 	 na-dych-ova-t 	 na-dych-ova-t
nadčlověctví 	 nad-člověc-tv-í 	 nad-člověc-tv-í
naflákat 	 na-flák-a-t 	 na-flák-a-t
nahlížíme 	 na-hlíž-í-me 	 na-hlíž-í-me
nahradit 	 na-hrad-i-t 	 na-hrad-i-t
nahrávat 	 na-hrá-v-a-t 	 na-hrá-v-a-t
najezdit 	 na-jezd-i-t 	 na-jezd-i-t
nakolkovat 	 na-kol-k-ova-t 	 na-kol-k-ova-t
nakouřit 	 na-kouř-i-t 	 na-kouř-i-t
nakupit 	 na-kup-i-t 	 na-kup-i-t
nakřivovat 	 na-křiv-ova-t 	 na-křiv-ova-t
naleznout 	 na-lez-nou-t 	 na-lez-nou-t
naleštit 	 na-lešt-i-t 	 na-lešt-i-t
nalopotit 	 na-lopot-i-t 	 na-lopot-i-t
naloupat 	 na-loup-a-t 	 na-loup-a-t
namítá 	 na-mít-á 	 na-mít-á
nanášet 	 na-náš-e-t 	 na-náš-e-t
napadat 	 na-pad-a-t 	 na-pad-a-t
napajcovávání 	 na-pajc-ová-v-á-n-í 	 na-pajc-ová-v-á-n-í
naparádit 	 na-parád-i-t 	 na-parád-i-t
naplivnout 	 na-pliv-nou-t 	 na-pliv-nou-t
napojil 	 na-poj-i-l 	 na-poj-i-l
naprosto 	 na-prost-o 	 na-prost-o
napsali 	 na-ps-a-l-i 	 na-ps-a-l-i
napínalo 	 na-pín-a-l-o 	 na-pín-a-l-o
napěnit 	 na-pěn-i-t 	 na-pěn-i-t
narobit 	 na-rob-i-t 	 na-rob-i-t
narodilo 	 na-rod-i-l-o 	 na-rod-i-l-o
naruší 	 na-ruš-í 	 na-ruš-í
nasbíral 	 na-s-bír-a-l 	 na-s-bír-a-l
nasekat 	 na-sek-a-t 	 na-sek-a-t
naskicovat 	 na-skic-ova-t 	 na-skic-ova-t
nasnídat 	 na-s-níd-a-t 	 na-s-níd-a-t
naspořit 	 na-spoř-i-t 	 na-spoř-i-t
nastrouhat 	 na-strouh-a-t 	 na-strouh-a-t
nastrčil 	 na-strč-i-l 	 na-strč-i-l
nasázet 	 na-sáz-e-t 	 na-sáz-e-t
natínat 	 na-tín-a-t 	 na-tín-a-t
navagónovávatelnost 	 na-vagón-ová-v-a-teln-ost 	 na-vagón-ová-v-a-teln-ost
naveskrz 	 na-ve-skrz 	 na-ve-skrz
navnadit 	 na-vnad-i-t 	 na-vnad-i-t
navolat 	 na-vol-a-t 	 na-vol-a-t
navozuje 	 na-voz-uje 	 na-voz-uje
navrtat 	 na-vrt-a-t 	 na-vrt-a-t
navrátit 	 na-vrát-i-t 	 na-vrát-i-t
navyprávět 	 na-vy-práv-ě-t 	 na-vy-práv-ě-t
navát 	 na-vá-t 	 na-vá-t
načal 	 na-č-a-l 	 na-č-a-l
načesávat 	 na-čes-á-v-a-t 	 na-čes-á-v-a-t
nařezávat 	 na-řez-á-v-a-t 	 na-řez-á-v-a-t
naštvat 	 na-štv-a-t 	 na-štv-a-t
našvihat 	 na-švih-a-t 	 na-švih-a-t
naťapat 	 na-ťap-a-t 	 na-ťap-a-t
neb 	 neb 	 neb
neboj 	 ne-boj 	 ne-boj
nebrat 	 ne-br-a-t 	 ne-br-a-t
nechtěj 	 ne-cht-ě-j 	 ne-cht-ě-j
nechuť 	 ne-chuť 	 ne-chuť
nechává 	 nech-á-v-á 	 nech-á-v-á
nedat 	 ne-d-a-t 	 ne-d-a-t
nedaří 	 ne-dař-í 	 ne-dař-í
nedoceňuje 	 ne-do-ceň-uje 	 ne-do-ceň-uje
nedutnout 	 ne-dut-nou-t 	 ne-dut-nou-t
nedávají 	 ne-d-á-v-aj-í 	 ne-d-á-v-aj-í
nedávna 	 ne-dávn-a 	 ne-dávn-a
neexistovalo 	 ne-exist-ova-l-o 	 ne-exist-ova-l-o
nehmotného 	 ne-hmot-n-ého 	 ne-hmot-n-ého
nehodlám 	 ne-hodl-á-m 	 ne-hodl-á-m
nehty 	 neht-y 	 neht-y
nejdříve 	 nej-dřív-e 	 nej-dřív-e
nejlahodnější 	 nej-lahod-n-ěj-š-í 	 nej-lahod-n-ěj-š-í
nejmenší 	 nej-men-š-í 	 nej-men-š-í
nejprve 	 nej-prv-e 	 nej-prv-e
nejvzácnější 	 nej-vzácn-ějš-í 	 nej-vzácn-ějš-í
nekompetentní 	 ne-kompet-ent-n-í 	 ne-kompet-ent-n-í
nekoupil 	 ne-koup-i-l 	 ne-koup-i-l
nekrytý 	 ne-kry-t-ý 	 ne-kry-t-ý
nelidské 	 ne-lid-sk-é 	 ne-lid-sk-é
nemluvně 	 ne-mluv-n-ě 	 ne-mluv-n-ě
nemocný 	 ne-moc-n-ý 	 ne-moc-n-ý
nemohli 	 ne-moh-l-i 	 ne-moh-l-i
nemožné 	 ne-mož-n-é 	 ne-mož-n-é
nemůže 	 ne-můž-e 	 ne-můž-e
nenahradí 	 ne-na-hrad-í 	 ne-na-hrad-í
nenech 	 ne-nech 	 ne-nech
nenápadně 	 ne-ná-pad-n-ě 	 ne-ná-pad-n-ě
neodvažujeme 	 ne-od-važ-uje-me 	 ne-od-važ-uje-me
neohrabané 	 ne-o-hrab-a-n-é 	 ne-o-hrab-a-n-é
neplatila 	 ne-plat-i-l-a 	 ne-plat-i-l-a
nepobíral 	 ne-po-bír-a-l 	 ne-po-bír-a-l
nepohnutě 	 ne-po-h-nu-t-ě 	 ne-po-h-nu-t-ě
nepohodnout 	 ne-po-hod-nou-t 	 ne-po-hod-nou-t
nepomohou 	 ne-po-moh-ou 	 ne-po-moh-ou
neposkytnul 	 ne-po-skyt-nu-l 	 ne-po-skyt-nu-l
neposlední 	 ne-po-sled-n-í 	 ne-po-sled-n-í
nepracoval 	 ne-prac-ova-l 	 ne-prac-ova-l
neprodělá 	 ne-pro-děl-á 	 ne-pro-děl-á
neprokáže 	 ne-pro-káž-e 	 ne-pro-káž-e
nepružné 	 ne-pruž-n-é 	 ne-pruž-n-é
nepřehlédněte 	 ne-pře-hléd-n-ě-te 	 ne-pře-hléd-n-ě-te
nepřesných 	 ne-přesn-ých 	 ne-přesn-ých
nepřijdou 	 ne-při-jd-ou 	 ne-při-jd-ou
nepřipraví 	 ne-při-prav-í 	 ne-při-prav-í
nepřišla 	 ne-při-š-l-a 	 ne-při-š-l-a
neroztříštěná 	 ne-roz-tříšt-ěn-á 	 ne-roz-tříšt-ěn-á
nerušili 	 ne-ruš-i-l-i 	 ne-ruš-i-l-i
nervóznět 	 nerv-óz-n-ě-t 	 nerv-óz-n-ě-t
nesena 	 nes-en-a 	 nes-en-a
nesesedl 	 ne-se-sed-l 	 ne-se-sed-l
neshoří 	 ne-s-hoř-í 	 ne-s-hoř-í
neskromně 	 ne-s-krom-n-ě 	 ne-s-krom-n-ě
nesmírná 	 ne-s-mír-n-á 	 ne-s-mír-n-á
nesnesitelna 	 ne-s-nes-i-teln-a 	 ne-s-nes-i-teln-a
nesprávné 	 ne-s-práv-n-é 	 ne-s-práv-n-é
neudělal 	 ne-u-děl-a-l 	 ne-u-děl-a-l
neukáže 	 ne-u-káž-e 	 ne-u-káž-e
neuměla 	 ne-um-ě-l-a 	 ne-um-ě-l-a
neupije 	 ne-u-pi-je 	 ne-u-pi-je
neuteče 	 ne-u-teč-e 	 ne-u-teč-e
neuznává 	 ne-u-zn-á-v-á 	 ne-u-zn-á-v-á
nevhodnost 	 ne-v-hod-n-ost 	 ne-v-hod-n-ost
nevinen 	 ne-vin-en 	 ne-vin-en
nevrley 	 nevrley 	 nevrley
nevrátila 	 ne-vrát-i-l-a 	 ne-vrát-i-l-a
nevyhnutelné 	 ne-vy-h-nu-teln-é 	 ne-vy-h-nu-teln-é
nevypařila 	 ne-vy-pař-i-l-a 	 ne-vy-pař-i-l-a
nevysvětlíš 	 ne-vy-svět-l-í-š 	 ne-vy-svět-l-í-š
nevyznám 	 ne-vy-zn-á-m 	 ne-vy-zn-á-m
neváhají 	 ne-váh-aj-í 	 ne-váh-aj-í
nevážili 	 ne-váž-i-l-i 	 ne-váž-i-l-i
nezahořeli 	 ne-za-hoř-e-l-i 	 ne-za-hoř-e-l-i
nezaoblená 	 ne-za-obl-en-á 	 ne-za-obl-en-á
nezapsané 	 ne-za-ps-a-n-é 	 ne-za-ps-a-n-é
nezapíchnul 	 ne-za-pích-nu-l 	 ne-za-pích-nu-l
nezavolali 	 ne-za-vol-a-l-i 	 ne-za-vol-a-l-i
nezbytné 	 ne-z-by-t-n-é 	 ne-z-by-t-n-é
nezbytnými 	 ne-z-by-t-n-ými 	 ne-z-by-t-n-ými
nezlob 	 ne-zlob 	 ne-zlob
nezískáme 	 ne-získ-á-me 	 ne-získ-á-me
nečervená 	 ne-červen-á 	 ne-červen-á
nečinnosti 	 ne-čin-n-ost-i 	 ne-čin-n-ost-i
neříkejte 	 ne-řík-ej-te 	 ne-řík-ej-te
neškodné 	 ne-škod-n-é 	 ne-škod-n-é
neštěstí 	 ne-štěst-í 	 ne-štěst-í
nijetzscheovi 	 nijetzsche-ovi 	 nijetzsche-ovi
noetika 	 noet-ik-a 	 noet-ik-a
nohou 	 noh-ou 	 noh-ou
norbert 	 norbert 	 norbert
normovat 	 norm-ova-t 	 norm-ova-t
normám 	 norm-ám 	 norm-ám
nosatá 	 nos-at-á 	 nos-at-á
nosaté 	 nos-at-é 	 nos-at-é
novinám 	 nov-in-á-m 	 nov-in-á-m
novočerkasku 	 novočerkask-u 	 novočerkask-u
nová 	 nov-á 	 nov-á
novými 	 nov-ými 	 nov-ými
nula 	 nul-a 	 nul-a
nuly 	 nul-y 	 nul-y
nutným 	 nut-n-ým 	 nut-n-ým
nykláku 	 nyklák-u 	 nyklák-u
náborové 	 ná-bor-ov-é 	 ná-bor-ov-é
nájemné 	 ná-jem-n-é 	 ná-jem-n-é
náležela 	 ná-lež-e-l-a 	 ná-lež-e-l-a
náleží 	 ná-lež-í 	 ná-lež-í
náměty 	 ná-mět-y 	 ná-mět-y
nápad 	 ná-pad 	 ná-pad
nápadná 	 ná-pad-n-á 	 ná-pad-n-á
nástroj 	 ná-stroj 	 ná-stroj
návod 	 ná-vod 	 ná-vod
návody 	 ná-vod-y 	 ná-vod-y
návštěva 	 návštěv-a 	 návštěv-a
návštěvou 	 návštěv-ou 	 návštěv-ou
názory 	 ná-zor-y 	 ná-zor-y
nítit 	 nít-i-t 	 nít-i-t
ně 	 n-ě 	 n-ě
někde 	 ně-kd-e 	 ně-kd-e
němá 	 něm-á 	 něm-á
němé 	 něm-é 	 něm-é
oba 	 ob-a 	 ob-a
obalu 	 o-bal-u 	 o-bal-u
obchod 	 ob-chod 	 ob-chod
obchodům 	 ob-chod-ům 	 ob-chod-ům
obcházet 	 ob-cház-e-t 	 ob-cház-e-t
obci 	 obc-i 	 obc-i
obdobné 	 ob-dob-n-é 	 ob-dob-n-é
obelstil 	 obe-lst-i-l 	 obe-lst-i-l
obetkat 	 obe-tk-a-t 	 obe-tk-a-t
obeznámit 	 obe-znám-i-t 	 obe-znám-i-t
objem 	 ob-jem 	 ob-jem
obklíčit 	 ob-klíč-i-t 	 ob-klíč-i-t
oblastech 	 oblast-ech 	 oblast-ech
oblizovat 	 ob-liz-ova-t 	 ob-liz-ova-t
obléknout 	 ob-lék-nou-t 	 ob-lék-nou-t
oblízat 	 ob-líz-a-t 	 ob-líz-a-t
obnitkovat 	 ob-nit-k-ova-t 	 ob-nit-k-ova-t
obnovovat 	 ob-nov-ova-t 	 ob-nov-ova-t
oborat 	 ob-or-a-t 	 ob-or-a-t
obr 	 obr 	 obr
obrali 	 o-br-a-l-i 	 o-br-a-l-i
obrodit 	 ob-rod-i-t 	 ob-rod-i-t
obsahují 	 ob-sah-uj-í 	 ob-sah-uj-í
obtahovat 	 ob-tah-ova-t 	 ob-tah-ova-t
obtisknout 	 ob-tisk-nou-t 	 ob-tisk-nou-t
obtěžkávat 	 ob-těž-k-á-v-a-t 	 ob-těž-k-á-v-a-t
obyčejné 	 obyčej-n-é 	 obyčej-n-é
obílit 	 o-bíl-i-t 	 o-bíl-i-t
občanského 	 obč-an-sk-ého 	 obč-an-sk-ého
oběda 	 oběd-a 	 oběd-a
oběsil 	 oběs-i-l 	 oběs-i-l
obětuje 	 obět-uje 	 obět-uje
obživit 	 ob-živ-i-t 	 ob-živ-i-t
ocejchovat 	 o-cejch-ova-t 	 o-cejch-ova-t
oceli 	 ocel-i 	 ocel-i
ocenzurovávanost 	 o-cenzur-ová-v-a-n-ost 	 o-cenzur-ová-v-a-n-ost
ochmatat 	 o-chmat-a-t 	 o-chmat-a-t
ochrannému 	 o-chran-n-ému 	 o-chran-n-ému
ochraně 	 o-chran-ě 	 o-chran-ě
octovat 	 oct-ova-t 	 oct-ova-t
odbelhávat 	 od-belh-á-v-a-t 	 od-belh-á-v-a-t
odborném 	 od-bor-n-ém 	 od-bor-n-ém
odběratel 	 od-běr-a-tel 	 od-běr-a-tel
odběratelem 	 od-běr-a-tel-em 	 od-běr-a-tel-em
odběru 	 od-běr-u 	 od-běr-u
odchlípnout 	 od-chlíp-nou-t 	 od-chlíp-nou-t
odchvátat 	 od-chvát-a-t 	 od-chvát-a-t
odchylka 	 od-chyl-k-a 	 od-chyl-k-a
odcházet 	 od-cház-e-t 	 od-cház-e-t
odchází 	 od-cház-í 	 od-cház-í
odcloňovat 	 od-cloň-ova-t 	 od-cloň-ova-t
odcválat 	 od-cvál-a-t 	 od-cvál-a-t
oddanosti 	 od-d-a-n-ost-i 	 od-d-a-n-ost-i
oddat 	 od-d-a-t 	 od-d-a-t
oddati 	 od-d-a-ti 	 od-d-a-ti
oddechnout 	 od-dech-nou-t 	 od-dech-nou-t
oddrolit 	 od-drol-i-t 	 od-drol-i-t
oddychovat 	 od-dych-ova-t 	 od-dych-ova-t
oddávat 	 od-d-á-v-a-t 	 od-d-á-v-a-t
odehnat 	 ode-hn-a-t 	 ode-hn-a-t
odehrávají 	 ode-hrá-v-aj-í 	 ode-hrá-v-aj-í
odepřela 	 ode-př-e-l-a 	 ode-př-e-l-a
odervat 	 ode-rv-a-t 	 ode-rv-a-t
odeslaném 	 ode-sl-a-n-ém 	 ode-sl-a-n-ém
odesílat 	 ode-síl-a-t 	 ode-síl-a-t
odečítat 	 ode-čít-a-t 	 ode-čít-a-t
odfrčet 	 od-frč-e-t 	 od-frč-e-t
odhad 	 od-had 	 od-had
odhadu 	 od-had-u 	 od-had-u
odkapat 	 od-kap-a-t 	 od-kap-a-t
odklad 	 od-klad 	 od-klad
odkladem 	 od-klad-em 	 od-klad-em
odkladu 	 od-klad-u 	 od-klad-u
odklusat 	 od-klus-a-t 	 od-klus-a-t
odkopnout 	 od-kop-nou-t 	 od-kop-nou-t
odkrvovat 	 od-krv-ova-t 	 od-krv-ova-t
odlevovat 	 od-lev-ova-t 	 od-lev-ova-t
odloupat 	 od-loup-a-t 	 od-loup-a-t
odloupávat 	 od-loup-á-v-a-t 	 od-loup-á-v-a-t
odloženou 	 od-lož-en-ou 	 od-lož-en-ou
odložení 	 od-lož-en-í 	 od-lož-en-í
odlévání 	 od-lév-á-n-í 	 od-lév-á-n-í
odmlčela 	 od-mlč-e-l-a 	 od-mlč-e-l-a
odmítnout 	 od-mít-nou-t 	 od-mít-nou-t
odměňujeme 	 od-měň-uje-me 	 od-měň-uje-me
odměřovat 	 od-měř-ova-t 	 od-měř-ova-t
odnoží 	 od-nož-í 	 od-nož-í
odpisovaného 	 od-pis-ova-n-ého 	 od-pis-ova-n-ého
odpomoci 	 od-po-moc-i 	 od-po-moc-i
odpovídat 	 od-po-víd-a-t 	 od-po-víd-a-t
odpovědnost 	 od-po-věd-n-ost 	 od-po-věd-n-ost
odpověď 	 od-po-věď 	 od-po-věď
odpřáhnout 	 od-přáh-nou-t 	 od-přáh-nou-t
odrazuje 	 od-raz-uje 	 od-raz-uje
odsoudcovat 	 od-soud-c-ova-t 	 od-soud-c-ova-t
odspěchat 	 od-spěch-a-t 	 od-spěch-a-t
odsrkávat 	 od-srk-á-v-a-t 	 od-srk-á-v-a-t
odstartovat 	 od-start-ova-t 	 od-start-ova-t
odstranit 	 od-stran-i-t 	 od-stran-i-t
odstrašovat 	 od-straš-ova-t 	 od-straš-ova-t
odstrkávat 	 od-strk-á-v-a-t 	 od-strk-á-v-a-t
odstříknout 	 od-střík-nou-t 	 od-střík-nou-t
odsunovat 	 od-sun-ova-t 	 od-sun-ova-t
odtlouci 	 od-tlouc-i 	 od-tlouc-i
odtrhat 	 od-trh-a-t 	 od-trh-a-t
odtrhávat 	 od-trh-á-v-a-t 	 od-trh-á-v-a-t
odtrojmocnit 	 od-troj-moc-n-i-t 	 od-troj-moc-n-i-t
odtáhne 	 od-táh-ne 	 od-táh-ne
oduševnit 	 o-duš-ev-n-i-t 	 o-duš-ev-n-i-t
odvařit 	 od-vař-i-t 	 od-vař-i-t
odvažuješ 	 od-važ-uje-š 	 od-važ-uje-š
odvedeného 	 od-ved-en-ého 	 od-ved-en-ého
odvelet 	 od-vel-e-t 	 od-vel-e-t
odříkat 	 od-řík-a-t 	 od-řík-a-t
odřít 	 o-dř-í-t 	 o-dř-í-t
odštěpovat 	 od-štěp-ova-t 	 od-štěp-ova-t
odžít 	 od-ží-t 	 od-ží-t
oh 	 oh 	 oh
ohlodat 	 o-hlod-a-t 	 o-hlod-a-t
ohluchnout 	 o-hluch-nou-t 	 o-hluch-nou-t
ohlušit 	 o-hluš-i-t 	 o-hluš-i-t
ohromně 	 o-hrom-n-ě 	 o-hrom-n-ě
ojínět 	 o-jín-ě-t 	 o-jín-ě-t
oken 	 oken 	 oken
okolkovat 	 o-kol-k-ova-t 	 o-kol-k-ova-t
okozlit 	 o-koz-l-i-t 	 o-koz-l-i-t
okrajovým 	 o-kraj-ov-ým 	 o-kraj-ov-ým
okresní 	 okres-n-í 	 okres-n-í
oktrojovat 	 oktroj-ova-t 	 oktroj-ova-t
olfen 	 olfen 	 olfen
oloupil 	 o-loup-i-l 	 o-loup-i-l
omdlívat 	 o-mdl-í-v-a-t 	 o-mdl-í-v-a-t
omezování 	 o-mez-ová-n-í 	 o-mez-ová-n-í
omlouval 	 o-mlouv-a-l 	 o-mlouv-a-l
omílat 	 o-míl-a-t 	 o-míl-a-t
omítce 	 o-mít-c-e 	 o-mít-c-e
omžít 	 o-mž-í-t 	 o-mž-í-t
onen 	 on-en 	 on-en
opadávat 	 o-pad-á-v-a-t 	 o-pad-á-v-a-t
opancéřovat 	 o-pancéř-ova-t 	 o-pancéř-ova-t
opatrností 	 o-patr-n-ost-í 	 o-patr-n-ost-í
opatrný 	 o-patr-n-ý 	 o-patr-n-ý
opelichat 	 o-pelich-a-t 	 o-pelich-a-t
oplodňovat 	 o-plod-ň-ova-t 	 o-plod-ň-ova-t
opotřebovat 	 o-po-třeb-ova-t 	 o-po-třeb-ova-t
opouštějí 	 o-poušt-ěj-í 	 o-poušt-ěj-í
opouštěl 	 o-poušt-ě-l 	 o-poušt-ě-l
opršet 	 o-prš-e-t 	 o-prš-e-t
oranžista 	 oranž-ist-a 	 oranž-ist-a
orientální 	 orient-ál-n-í 	 orient-ál-n-í
orijentovaná 	 orijent-ova-n-á 	 orijent-ova-n-á
orlí 	 orl-í 	 orl-í
oroubovat 	 o-roub-ova-t 	 o-roub-ova-t
orážet 	 o-ráž-e-t 	 o-ráž-e-t
osazovat 	 o-saz-ova-t 	 o-saz-ova-t
osednout 	 o-sed-nou-t 	 o-sed-nou-t
osekat 	 o-sek-a-t 	 o-sek-a-t
osekávat 	 o-sek-á-v-a-t 	 o-sek-á-v-a-t
oskar 	 oskar 	 oskar
oslabit 	 o-slab-i-t 	 o-slab-i-t
oslepit 	 o-slep-i-t 	 o-slep-i-t
oslintat 	 o-slint-a-t 	 o-slint-a-t
osmnácté 	 osm-náct-é 	 osm-náct-é
ostravské 	 ostrav-sk-é 	 ostrav-sk-é
ostravy 	 ostrav-y 	 ostrav-y
ostrouhat 	 o-strouh-a-t 	 o-strouh-a-t
ostřihovat 	 o-střih-ova-t 	 o-střih-ova-t
ostřit 	 ostř-i-t 	 ostř-i-t
osudně 	 osud-n-ě 	 osud-n-ě
osušovanost 	 o-suš-ova-n-ost 	 o-suš-ova-n-ost
osvobození 	 o-svoboz-en-í 	 o-svoboz-en-í
osvěcovat 	 o-svěc-ova-t 	 o-svěc-ova-t
osvědčovat 	 o-svědč-ova-t 	 o-svědč-ova-t
otevřel 	 ote-vř-e-l 	 ote-vř-e-l
otevřely 	 ote-vř-e-l-y 	 ote-vř-e-l-y
otevřena 	 ote-vř-en-a 	 ote-vř-en-a
otevřít 	 ote-vř-í-t 	 ote-vř-í-t
otravovat 	 o-trav-ova-t 	 o-trav-ova-t
otvírá 	 ot-vír-á 	 ot-vír-á
otěhotnět 	 o-těhot-n-ě-t 	 o-těhot-n-ě-t
ovadnout 	 o-vad-nou-t 	 o-vad-nou-t
ovládnout 	 o-vlád-nou-t 	 o-vlád-nou-t
ovládání 	 o-vlád-á-n-í 	 o-vlád-á-n-í
ovít 	 o-ví-t 	 o-ví-t
ověnčil 	 o-věn-č-i-l 	 o-věn-č-i-l
ověřit 	 o-věř-i-t 	 o-věř-i-t
ozdobovat 	 o-z-dob-ova-t 	 o-z-dob-ova-t
oznobovat 	 o-znob-ova-t 	 o-znob-ova-t
ozvalo 	 o-zv-a-l-o 	 o-zv-a-l-o
očenichat 	 o-čenich-a-t 	 o-čenich-a-t
očima 	 oč-ima 	 oč-ima
ošukat 	 ošuk-a-t 	 ošuk-a-t
ošvindlovat 	 o-švindl-ova-t 	 o-švindl-ova-t
ošívat 	 o-ší-v-a-t 	 o-ší-v-a-t
ožvykovat 	 o-žvyk-ova-t 	 o-žvyk-ova-t
paběrkovat 	 pa-běr-k-ova-t 	 pa-běr-k-ova-t
padesát 	 pa-desát 	 pa-desát
pageův 	 page-ův 	 page-ův
pakovat 	 pak-ova-t 	 pak-ova-t
palba 	 pal-b-a 	 pal-b-a
palermě 	 palerm-ě 	 palerm-ě
panoval 	 pan-ova-l 	 pan-ova-l
papouškovat 	 papouš-k-ova-t 	 papouš-k-ova-t
parasoudně 	 para-soud-n-ě 	 para-soud-n-ě
parodovat 	 parod-ova-t 	 parod-ova-t
pas 	 pas 	 pas
pasírovat 	 pasír-ova-t 	 pasír-ova-t
patlat 	 patl-a-t 	 patl-a-t
patroni 	 patr-on-i 	 patr-on-i
patřil 	 patř-i-l 	 patř-i-l
patřily 	 patř-i-l-y 	 patř-i-l-y
pavel 	 pavel 	 pavel
pařit 	 pař-i-t 	 pař-i-t
paříž 	 paříž 	 paříž
pelichat 	 pelich-a-t 	 pelich-a-t
peníz 	 peníz 	 peníz
perfektně 	 per-fekt-n-ě 	 per-fekt-n-ě
pestřit 	 pestř-i-t 	 pestř-i-t
petrolejově 	 petrolej-ov-ě 	 petrolej-ov-ě
peřině 	 peř-in-ě 	 peř-in-ě
pf 	 p-f 	 p-f
pfeffermann 	 pfeffer-mann 	 pfeffer-mann
piston 	 piston 	 piston
pižlat 	 pižl-a-t 	 pižl-a-t
placení 	 plac-en-í 	 plac-en-í
platné 	 plat-n-é 	 plat-n-é
plavky 	 plav-k-y 	 plav-k-y
plemenit 	 plemen-i-t 	 plemen-i-t
plesknout 	 plesk-nou-t 	 plesk-nou-t
plisovat 	 plis-ova-t 	 plis-ova-t
plivat 	 pliv-a-t 	 pliv-a-t
plnohodnotné 	 pln-o-hod-n-ot-n-é 	 pln-o-hod-n-ot-n-é
plnou 	 pln-ou 	 pln-ou
plnění 	 pln-ěn-í 	 pln-ěn-í
plyn 	 plyn 	 plyn
plynulé 	 ply-nu-l-é 	 ply-nu-l-é
plánech 	 plán-ech 	 plán-ech
plánu 	 plán-u 	 plán-u
plátcem 	 plát-c-em 	 plát-c-em
plátci 	 plát-c-i 	 plát-c-i
plíce 	 plíc-e 	 plíc-e
pobídnout 	 po-bíd-nou-t 	 po-bíd-nou-t
pobíjet 	 po-bíj-e-t 	 po-bíj-e-t
pobírali 	 po-bír-a-l-i 	 po-bír-a-l-i
pochutnal 	 po-chut-n-a-l 	 po-chut-n-a-l
pochutnatelný 	 po-chut-n-a-teln-ý 	 po-chut-n-a-teln-ý
pochválena 	 po-chvál-en-a 	 po-chvál-en-a
pochyba 	 po-chyb-a 	 po-chyb-a
pochybnostech 	 po-chyb-n-ost-ech 	 po-chyb-n-ost-ech
pochytávat 	 po-chyt-á-v-a-t 	 po-chyt-á-v-a-t
podařilo 	 po-dař-i-l-o 	 po-dař-i-l-o
podaří 	 po-dař-í 	 po-dař-í
poddolovat 	 pod-dol-ova-t 	 pod-dol-ova-t
podepsat 	 pode-ps-a-t 	 pode-ps-a-t
podivila 	 po-div-i-l-a 	 po-div-i-l-a
podivně 	 po-div-n-ě 	 po-div-n-ě
podivuhodné 	 po-div-u-hod-n-é 	 po-div-u-hod-n-é
podklesat 	 pod-kles-a-t 	 pod-kles-a-t
podlec 	 podl-ec 	 podl-ec
podlitina 	 pod-li-t-in-a 	 pod-li-t-in-a
podléhat 	 pod-léh-a-t 	 pod-léh-a-t
podmínit 	 pod-mín-i-t 	 pod-mín-i-t
podmínkami 	 pod-mín-k-ami 	 pod-mín-k-ami
podmíněny 	 pod-mín-ěn-y 	 pod-mín-ěn-y
podmítnout 	 pod-mít-nou-t 	 pod-mít-nou-t
podnětu 	 pod-nět-u 	 pod-nět-u
podobalo 	 po-dob-a-l-o 	 po-dob-a-l-o
podobě 	 po-dob-ě 	 po-dob-ě
podpírala 	 pod-pír-a-l-a 	 pod-pír-a-l-a
podružstevnit 	 po-druž-stev-n-i-t 	 po-druž-stev-n-i-t
podráždění 	 po-drážd-ěn-í 	 po-drážd-ěn-í
podstupovat 	 pod-stup-ova-t 	 pod-stup-ova-t
podtít 	 pod-t-í-t 	 pod-t-í-t
podupovat 	 po-dup-ova-t 	 po-dup-ova-t
podupávat 	 po-dup-á-v-a-t 	 po-dup-á-v-a-t
podvazovat 	 pod-vaz-ova-t 	 pod-vaz-ova-t
podílíte 	 po-díl-í-te 	 po-díl-í-te
podívala 	 po-dív-a-l-a 	 po-dív-a-l-a
podívali 	 po-dív-a-l-i 	 po-dív-a-l-i
podělí 	 po-děl-í 	 po-děl-í
podřazovat 	 pod-řaz-ova-t 	 pod-řaz-ova-t
podřeknout 	 pod-řek-nou-t 	 pod-řek-nou-t
pohaněné 	 po-han-ě-n-é 	 po-han-ě-n-é
pohlavkoval 	 po-hlav-k-ova-l 	 po-hlav-k-ova-l
pohlídnout 	 po-hlíd-nou-t 	 po-hlíd-nou-t
pohlíželo 	 po-hlíž-e-l-o 	 po-hlíž-e-l-o
pohnuly 	 po-h-nu-l-y 	 po-h-nu-l-y
pohoda 	 po-hod-a 	 po-hod-a
pohryzovat 	 po-hryz-ova-t 	 po-hryz-ova-t
pohrůžku 	 po-hrůž-k-u 	 po-hrůž-k-u
pohyboval 	 po-hyb-ova-l 	 po-hyb-ova-l
pohřešit 	 po-hřeš-i-t 	 po-hřeš-i-t
pojaty 	 po-j-a-t-y 	 po-j-a-t-y
pojedu 	 po-jed-u 	 po-jed-u
pojídat 	 po-jíd-a-t 	 po-jíd-a-t
pojímá 	 po-jím-á 	 po-jím-á
pojímání 	 po-jím-á-n-í 	 po-jím-á-n-í
pojísti 	 po-jíst-i 	 po-jíst-i
poklad 	 po-klad 	 po-klad
poklade 	 po-klad-e 	 po-klad-e
pokladny 	 po-klad-n-y 	 po-klad-n-y
poklepat 	 po-klep-a-t 	 po-klep-a-t
poklesnout 	 po-kles-nou-t 	 po-kles-nou-t
poklást 	 po-klás-t 	 po-klás-t
pokoj 	 po-koj 	 po-koj
pokosit 	 po-kos-i-t 	 po-kos-i-t
pokračoval 	 po-krač-ova-l 	 po-krač-ova-l
pokračování 	 po-krač-ová-n-í 	 po-krač-ová-n-í
pokroutit 	 po-krout-i-t 	 po-krout-i-t
pokusit 	 po-kus-i-t 	 po-kus-i-t
pokárat 	 po-kár-a-t 	 po-kár-a-t
policajtovat 	 policajt-ova-t 	 policajt-ova-t
položil 	 po-lož-i-l 	 po-lož-i-l
polyvalence 	 poly-valenc-e 	 poly-valenc-e
polít 	 po-lí-t 	 po-lí-t
pomatený 	 po-mat-en-ý 	 po-mat-en-ý
pomazat 	 po-maz-a-t 	 po-maz-a-t
pomodlil 	 po-modl-i-l 	 po-modl-i-l
pomohla 	 po-moh-l-a 	 po-moh-l-a
pomokřit 	 po-mokř-i-t 	 po-mokř-i-t
pomáhám 	 po-máh-á-m 	 po-máh-á-m
pomýlit 	 po-mýl-i-t 	 po-mýl-i-t
ponížit 	 po-níž-i-t 	 po-níž-i-t
poobědvat 	 po-oběd-v-a-t 	 po-oběd-v-a-t
pooddychnout 	 po-od-dych-nou-t 	 po-od-dych-nou-t
poodhalit 	 po-od-hal-i-t 	 po-od-hal-i-t
popište 	 po-piš-te 	 po-piš-te
popkultura 	 pop-kult-ur-a 	 pop-kult-ur-a
poplivat 	 po-pliv-a-t 	 po-pliv-a-t
popoběhnout 	 po-po-běh-nou-t 	 po-po-běh-nou-t
poprašovat 	 po-praš-ova-t 	 po-praš-ova-t
popráškovat 	 po-práš-k-ova-t 	 po-práš-k-ova-t
poptat 	 po-pt-a-t 	 po-pt-a-t
popálil 	 po-pál-i-l 	 po-pál-i-l
popálit 	 po-pál-i-t 	 po-pál-i-t
poradců 	 po-rad-c-ů 	 po-rad-c-ů
poroučel 	 po-rouč-e-l 	 po-rouč-e-l
poroučím 	 po-rouč-í-m 	 po-rouč-í-m
porozhlédnout 	 po-roz-hléd-nou-t 	 po-roz-hléd-nou-t
porubat 	 po-rub-a-t 	 po-rub-a-t
poskočit 	 po-skoč-i-t 	 po-skoč-i-t
poskytováním 	 po-skyt-ová-n-ím 	 po-skyt-ová-n-ím
poslal 	 po-sl-a-l 	 po-sl-a-l
poslouchej 	 po-slouch-ej 	 po-slouch-ej
posmyknout 	 po-s-myk-nou-t 	 po-s-myk-nou-t
posolit 	 po-sol-i-t 	 po-sol-i-t
postačit 	 po-stač-i-t 	 po-stač-i-t
postih 	 po-stih 	 po-stih
postup 	 po-stup 	 po-stup
postupně 	 po-stup-n-ě 	 po-stup-n-ě
postupů 	 po-stup-ů 	 po-stup-ů
postátňovat 	 po-stát-ň-ova-t 	 po-stát-ň-ova-t
postávalo 	 po-stá-v-a-l-o 	 po-stá-v-a-l-o
postříknout 	 po-střík-nou-t 	 po-střík-nou-t
posunovávatelnost 	 po-sun-ová-v-a-teln-ost 	 po-sun-ová-v-a-teln-ost
posuzování 	 po-suz-ová-n-í 	 po-suz-ová-n-í
posuzuje 	 po-suz-uje 	 po-suz-uje
posvítila 	 po-svít-i-l-a 	 po-svít-i-l-a
posílení 	 po-síl-en-í 	 po-síl-en-í
posílá 	 po-síl-á 	 po-síl-á
posílám 	 po-síl-á-m 	 po-síl-á-m
posýpat 	 po-sýp-a-t 	 po-sýp-a-t
potit 	 pot-i-t 	 pot-i-t
potkáme 	 po-tk-á-me 	 po-tk-á-me
potkáte 	 po-tk-á-te 	 po-tk-á-te
potravin 	 po-trav-in 	 po-trav-in
potrhnout 	 po-trh-nou-t 	 po-trh-nou-t
potulují 	 po-tul-uj-í 	 po-tul-uj-í
potvrdili 	 po-tvrd-i-l-i 	 po-tvrd-i-l-i
potěšení 	 po-těš-en-í 	 po-těš-en-í
potěšit 	 po-těš-i-t 	 po-těš-i-t
potěžkat 	 po-těž-k-a-t 	 po-těž-k-a-t
potřební 	 po-třeb-n-í 	 po-třeb-n-í
potřebných 	 po-třeb-n-ých 	 po-třeb-n-ých
poulit 	 poul-i-t 	 poul-i-t
pouzdro 	 pouzdr-o 	 pouzdr-o
poučit 	 po-uč-i-t 	 po-uč-i-t
použije 	 po-u-ži-je 	 po-u-ži-je
použito 	 po-u-ži-t-o 	 po-u-ži-t-o
považovány 	 po-važ-ová-n-y 	 po-važ-ová-n-y
povečeřet 	 po-večeř-e-t 	 po-večeř-e-t
povinny 	 po-vin-n-y 	 po-vin-n-y
povléci 	 po-vléc-i 	 po-vléc-i
povolaný 	 po-vol-an-ý 	 po-vol-an-ý
povolená 	 po-vol-en-á 	 po-vol-en-á
povolují 	 po-vol-uj-í 	 po-vol-uj-í
povylézt 	 po-vy-léz-t 	 po-vy-léz-t
povyskakovat 	 po-vy-skak-ova-t 	 po-vy-skak-ova-t
povzbuzení 	 po-vz-buz-en-í 	 po-vz-buz-en-í
povzdychnout 	 po-vz-dych-nou-t 	 po-vz-dych-nou-t
povznáší 	 po-vz-náš-í 	 po-vz-náš-í
povážíme 	 po-váž-í-me 	 po-váž-í-me
povídka 	 po-víd-k-a 	 po-víd-k-a
pověra 	 po-věr-a 	 po-věr-a
pověste 	 po-věs-te 	 po-věs-te
pověsíme 	 po-věs-í-me 	 po-věs-í-me
pozamykat 	 po-za-myk-a-t 	 po-za-myk-a-t
pozitivně 	 pozit-iv-n-ě 	 pozit-iv-n-ě
pozměňovat 	 po-z-měň-ova-t 	 po-z-měň-ova-t
poznat 	 po-zn-a-t 	 po-zn-a-t
poznatku 	 po-zn-a-t-k-u 	 po-zn-a-t-k-u
poznačit 	 po-znač-i-t 	 po-znač-i-t
poznání 	 po-zn-á-n-í 	 po-zn-á-n-í
pozornost 	 po-zor-n-ost 	 po-zor-n-ost
počasí 	 po-čas-í 	 po-čas-í
počestná 	 po-čest-n-á 	 po-čest-n-á
početí 	 po-č-e-t-í 	 po-č-e-t-í
počistit 	 po-čist-i-t 	 po-čist-i-t
počkal 	 po-čk-a-l 	 po-čk-a-l
počnu 	 po-č-n-u 	 po-č-n-u
počtu 	 po-čt-u 	 po-čt-u
počárat 	 po-čár-a-t 	 po-čár-a-t
počítalo 	 po-čít-a-l-o 	 po-čít-a-l-o
pořadatel 	 po-řad-a-tel 	 po-řad-a-tel
pořadatele 	 po-řad-a-tel-e 	 po-řad-a-tel-e
pořadatelé 	 po-řad-a-tel-é 	 po-řad-a-tel-é
pořadatelů 	 po-řad-a-tel-ů 	 po-řad-a-tel-ů
pořádně 	 po-řád-n-ě 	 po-řád-n-ě
pořádání 	 po-řád-á-n-í 	 po-řád-á-n-í
poškozovat 	 po-škoz-ova-t 	 po-škoz-ova-t
pošla 	 po-š-l-a 	 po-š-l-a
pošlapávat 	 po-šlap-á-v-a-t 	 po-šlap-á-v-a-t
pošle 	 po-šl-e 	 po-šl-e
pošlu 	 po-šl-u 	 po-šl-u
poštu 	 pošt-u 	 pošt-u
poštípat 	 po-štíp-a-t 	 po-štíp-a-t
požadovanou 	 po-žad-ova-n-ou 	 po-žad-ova-n-ou
požádali 	 po-žád-a-l-i 	 po-žád-a-l-i
požáru 	 po-žár-u 	 po-žár-u
pragmatism 	 pragm-at-ism 	 pragm-at-ism
pragmatismus 	 pragm-at-ism-us 	 pragm-at-ism-us
prajzler 	 prajzler 	 prajzler
prasknout 	 prask-nou-t 	 prask-nou-t
praví 	 prav-í 	 prav-í
pravý 	 prav-ý 	 prav-ý
praxí 	 prax-í 	 prax-í
pražského 	 praž-sk-ého 	 praž-sk-ého
prejudikovat 	 pre-ju-dik-ova-t 	 pre-ju-dik-ova-t
press 	 press 	 press
previtský 	 previt-sk-ý 	 previt-sk-ý
prezidentů 	 prezid-ent-ů 	 prezid-ent-ů
probudila 	 pro-bud-i-l-a 	 pro-bud-i-l-a
prodejce 	 pro-d-ej-c-e 	 pro-d-ej-c-e
prodejna 	 pro-d-ej-n-a 	 pro-d-ej-n-a
prodejně 	 pro-d-ej-n-ě 	 pro-d-ej-n-ě
prodlužit 	 pro-dluž-i-t 	 pro-dluž-i-t
prodlužuje 	 pro-dluž-uje 	 pro-dluž-uje
producent 	 pro-duc-ent 	 pro-duc-ent
produkty 	 pro-dukt-y 	 pro-dukt-y
produktů 	 pro-dukt-ů 	 pro-dukt-ů
produševňovat 	 pro-duš-ev-ň-ova-t 	 pro-duš-ev-ň-ova-t
prodával 	 pro-d-á-v-a-l 	 pro-d-á-v-a-l
prodávaná 	 pro-d-á-v-a-n-á 	 pro-d-á-v-a-n-á
prodávaných 	 pro-d-á-v-a-n-ých 	 pro-d-á-v-a-n-ých
prodávám 	 pro-d-á-v-á-m 	 pro-d-á-v-á-m
prodělat 	 pro-děl-a-t 	 pro-děl-a-t
prodělek 	 pro-děl-ek 	 pro-děl-ek
proděláme 	 pro-děl-á-me 	 pro-děl-á-me
proděravět 	 pro-děr-av-ě-t 	 pro-děr-av-ě-t
profesora 	 pro-fes-or-a 	 pro-fes-or-a
profesory 	 pro-fes-or-y 	 pro-fes-or-y
proflákat 	 pro-flák-a-t 	 pro-flák-a-t
profoukávat 	 pro-fouk-á-v-a-t 	 pro-fouk-á-v-a-t
prohlásila 	 pro-hlás-i-l-a 	 pro-hlás-i-l-a
prohlížet 	 pro-hlíž-e-t 	 pro-hlíž-e-t
prohrabat 	 pro-hrab-a-t 	 pro-hrab-a-t
prohrával 	 pro-hrá-v-a-l 	 pro-hrá-v-a-l
projede 	 pro-jed-e 	 pro-jed-e
projekt 	 pro-jekt 	 pro-jekt
projet 	 pro-je-t 	 pro-je-t
prokazují 	 pro-kaz-uj-í 	 pro-kaz-uj-í
prokládkovost 	 pro-klád-k-ov-ost 	 pro-klád-k-ov-ost
prokopávat 	 pro-kop-á-v-a-t 	 pro-kop-á-v-a-t
prokouknout 	 pro-kouk-nou-t 	 pro-kouk-nou-t
prokousnout 	 pro-kous-nou-t 	 pro-kous-nou-t
prokrindapána 	 pro-krind-a-pán-a 	 pro-krind-a-pán-a
prokrvit 	 pro-krv-i-t 	 pro-krv-i-t
prokvétat 	 pro-kvét-a-t 	 pro-kvét-a-t
prolamovat 	 pro-lam-ova-t 	 pro-lam-ova-t
prolévat 	 pro-lé-v-a-t 	 pro-lé-v-a-t
prolívat 	 pro-lí-v-a-t 	 pro-lí-v-a-t
promarnit 	 pro-mar-n-i-t 	 pro-mar-n-i-t
prometání 	 pro-met-á-n-í 	 pro-met-á-n-í
promýkat 	 pro-mýk-a-t 	 pro-mýk-a-t
propachtovat 	 pro-pacht-ova-t 	 pro-pacht-ova-t
propad 	 pro-pad 	 pro-pad
propadl 	 pro-pad-l 	 pro-pad-l
propastné 	 pro-past-n-é 	 pro-past-n-é
proplout 	 pro-plou-t 	 pro-plou-t
propláchnout 	 pro-plách-nou-t 	 pro-plách-nou-t
prorážet 	 pro-ráž-e-t 	 pro-ráž-e-t
prosekat 	 pro-sek-a-t 	 pro-sek-a-t
proset 	 pro-se-t 	 pro-se-t
prosimás 	 prosimás 	 prosimás
proslulá 	 pro-slu-l-á 	 pro-slu-l-á
prospěch 	 pro-spěch 	 pro-spěch
prostorově 	 pro-stor-ov-ě 	 pro-stor-ov-ě
prostrkovat 	 pro-strk-ova-t 	 pro-strk-ova-t
prostředky 	 pro-střed-k-y 	 pro-střed-k-y
prosvítat 	 pro-svít-a-t 	 pro-svít-a-t
prosychat 	 pro-sych-a-t 	 pro-sych-a-t
prosířit 	 pro-síř-i-t 	 pro-síř-i-t
prosýpat 	 pro-sýp-a-t 	 pro-sýp-a-t
protagorovi 	 protagor-ovi 	 protagor-ovi
protahuje 	 pro-tah-uje 	 pro-tah-uje
proteplit 	 pro-tep-l-i-t 	 pro-tep-l-i-t
protivit 	 protiv-i-t 	 protiv-i-t
proto 	 pro-t-o 	 pro-t-o
protokol 	 protokol 	 protokol
protrhat 	 pro-trh-a-t 	 pro-trh-a-t
provedeny 	 pro-ved-en-y 	 pro-ved-en-y
provléci 	 pro-vléc-i 	 pro-vléc-i
provozních 	 pro-voz-n-ích 	 pro-voz-n-ích
provozoval 	 pro-voz-ova-l 	 pro-voz-ova-l
provzdychat 	 pro-vz-dych-a-t 	 pro-vz-dych-a-t
provádíte 	 pro-vád-í-te 	 pro-vád-í-te
provádějí 	 pro-vád-ěj-í 	 pro-vád-ěj-í
prováděný 	 pro-vád-ě-n-ý 	 pro-vád-ě-n-ý
prozařovat 	 pro-zař-ova-t 	 pro-zař-ova-t
prozradit 	 pro-z-rad-i-t 	 pro-z-rad-i-t
pročpak 	 proč-pak 	 proč-pak
prožívat 	 pro-ží-v-a-t 	 pro-ží-v-a-t
prožívám 	 pro-ží-v-á-m 	 pro-ží-v-á-m
prvém 	 prv-ém 	 prv-ém
pryč 	 pryč 	 pryč
pryčně 	 pryč-n-ě 	 pryč-n-ě
práv 	 práv 	 práv
právního 	 práv-n-ího 	 práv-n-ího
právo 	 práv-o 	 práv-o
prázdné 	 prázdn-é 	 prázdn-é
pršelo 	 prš-e-l-o 	 prš-e-l-o
průběh 	 prů-běh 	 prů-běh
průhledy 	 prů-hled-y 	 prů-hled-y
průkazky 	 prů-kaz-k-y 	 prů-kaz-k-y
průmyslově 	 prů-mysl-ov-ě 	 prů-mysl-ov-ě
psali 	 ps-a-l-i 	 ps-a-l-i
pulsovat 	 puls-ova-t 	 puls-ova-t
pumpnout 	 pump-nou-t 	 pump-nou-t
purple 	 purple 	 purple
pustit 	 pust-i-t 	 pust-i-t
pustí 	 pust-í 	 pust-í
pusť 	 pusť 	 pusť
pučálka 	 pučálk-a 	 pučálk-a
pyšnit 	 pyš-n-i-t 	 pyš-n-i-t
pán 	 pán 	 pán
pánové 	 pán-ové 	 pán-ové
párkovat 	 pár-k-ova-t 	 pár-k-ova-t
párovat 	 pár-ova-t 	 pár-ova-t
pásci 	 pásc-i 	 pásc-i
páté 	 pát-é 	 pát-é
páčit 	 páč-i-t 	 páč-i-t
pódiem 	 pódi-em 	 pódi-em
pódiu 	 pódi-u 	 pódi-u
pěstit 	 pěst-i-t 	 pěst-i-t
pětník 	 pět-ník 	 pět-ník
přebásnitelně 	 pře-básn-i-teln-ě 	 pře-básn-i-teln-ě
přeceňovat 	 pře-ceň-ova-t 	 pře-ceň-ova-t
přechodná 	 pře-chod-n-á 	 pře-chod-n-á
předcházet 	 před-cház-e-t 	 před-cház-e-t
předložit 	 před-lož-i-t 	 před-lož-i-t
předlétnout 	 před-lét-nou-t 	 před-lét-nou-t
předměty 	 před-mět-y 	 před-mět-y
předmětů 	 před-mět-ů 	 před-mět-ů
předpisů 	 před-pis-ů 	 před-pis-ů
předražit 	 pře-draž-i-t 	 pře-draž-i-t
předražovat 	 pře-draž-ova-t 	 pře-draž-ova-t
představ 	 před-stav 	 před-stav
představiteli 	 před-stav-i-tel-i 	 před-stav-i-tel-i
představy 	 před-stav-y 	 před-stav-y
předělati 	 pře-děl-a-ti 	 pře-děl-a-ti
přehazoval 	 pře-haz-ova-l 	 pře-haz-ova-l
přehazovat 	 pře-haz-ova-t 	 pře-haz-ova-t
přehled 	 pře-hled 	 pře-hled
přehlušováno 	 pře-hluš-ová-n-o 	 pře-hluš-ová-n-o
přehlédl 	 pře-hléd-l 	 pře-hléd-l
přehnojit 	 pře-hnoj-i-t 	 pře-hnoj-i-t
přehrada 	 pře-hrad-a 	 pře-hrad-a
přehrazovat 	 pře-hraz-ova-t 	 pře-hraz-ova-t
přehryzovat 	 pře-hryz-ova-t 	 pře-hryz-ova-t
přehrát 	 pře-hrá-t 	 pře-hrá-t
přejmenovat 	 pře-jmen-ova-t 	 pře-jmen-ova-t
překacovat 	 pře-kac-ova-t 	 pře-kac-ova-t
překlonit 	 pře-klon-i-t 	 pře-klon-i-t
překontrolovat 	 pře-kontrol-ova-t 	 pře-kontrol-ova-t
překontrolována 	 pře-kontrol-ová-n-a 	 pře-kontrol-ová-n-a
překonávat 	 pře-kon-á-v-a-t 	 pře-kon-á-v-a-t
překrucování 	 pře-kruc-ová-n-í 	 pře-kruc-ová-n-í
překrájet 	 pře-kráj-e-t 	 pře-kráj-e-t
překrýt 	 pře-krý-t 	 pře-krý-t
překvapen 	 pře-kvap-en 	 pře-kvap-en
překvapíme 	 pře-kvap-í-me 	 pře-kvap-í-me
přelhat 	 pře-lh-a-t 	 pře-lh-a-t
přeložte 	 pře-lož-te 	 pře-lož-te
přemalovat 	 pře-mal-ova-t 	 pře-mal-ova-t
přemnohý 	 pře-mnoh-ý 	 pře-mnoh-ý
přemotávat 	 pře-mot-á-v-a-t 	 pře-mot-á-v-a-t
přemístit 	 pře-míst-i-t 	 pře-míst-i-t
přemýšlel 	 pře-mýšl-e-l 	 pře-mýšl-e-l
přeorientovat 	 pře-orient-ova-t 	 pře-orient-ova-t
přeroubovat 	 pře-roub-ova-t 	 pře-roub-ova-t
přesahovaly 	 pře-sah-ova-l-y 	 pře-sah-ova-l-y
přesedět 	 pře-sed-ě-t 	 pře-sed-ě-t
přeslabikovat 	 pře-slabik-ova-t 	 pře-slabik-ova-t
přesléchat 	 pře-sléch-a-t 	 pře-sléch-a-t
přesnost 	 přesn-ost 	 přesn-ost
přestanou 	 pře-sta-n-ou 	 pře-sta-n-ou
přestavovat 	 pře-stav-ova-t 	 pře-stav-ova-t
přestoupnout 	 pře-stoup-nou-t 	 pře-stoup-nou-t
přestřelit 	 pře-střel-i-t 	 pře-střel-i-t
přesunovat 	 pře-sun-ova-t 	 pře-sun-ova-t
přesáhl 	 pře-sáh-l 	 pře-sáh-l
přesáhla 	 pře-sáh-l-a 	 pře-sáh-l-a
přesázet 	 pře-sáz-e-t 	 pře-sáz-e-t
přesýpat 	 pře-sýp-a-t 	 pře-sýp-a-t
přetisknout 	 pře-tisk-nou-t 	 pře-tisk-nou-t
přetrhnout 	 pře-trh-nou-t 	 pře-trh-nou-t
přetřásat 	 pře-třás-a-t 	 pře-třás-a-t
převedeny 	 pře-ved-en-y 	 pře-ved-en-y
převléknout 	 pře-vlék-nou-t 	 pře-vlék-nou-t
převlíkat 	 pře-vlík-a-t 	 pře-vlík-a-t
převodem 	 pře-vod-em 	 pře-vod-em
převádět 	 pře-vád-ě-t 	 pře-vád-ě-t
převálet 	 pře-vál-e-t 	 pře-vál-e-t
převázat 	 pře-váz-a-t 	 pře-váz-a-t
převážně 	 pře-váž-n-ě 	 pře-váž-n-ě
převést 	 pře-vés-t 	 pře-vés-t
převívat 	 pře-ví-v-a-t 	 pře-ví-v-a-t
převýšil 	 pře-výš-i-l 	 pře-výš-i-l
přezdít 	 pře-zd-í-t 	 pře-zd-í-t
přezout 	 pře-zou-t 	 pře-zou-t
přečin 	 pře-čin 	 pře-čin
přečíslovat 	 pře-čísl-ova-t 	 pře-čísl-ova-t
přeříkávat 	 pře-řík-á-v-a-t 	 pře-řík-á-v-a-t
přežití 	 pře-ži-t-í 	 pře-ži-t-í
přibírat 	 při-bír-a-t 	 při-bír-a-t
přicházet 	 při-cház-e-t 	 při-cház-e-t
přihýbat 	 při-hýb-a-t 	 při-hýb-a-t
přijali 	 při-j-a-l-i 	 při-j-a-l-i
přijatelná 	 při-j-a-teln-á 	 při-j-a-teln-á
přijechat 	 při-jech-a-t 	 při-jech-a-t
přijmout 	 při-j-mou-t 	 při-j-mou-t
přijuchat 	 při-juch-a-t 	 při-juch-a-t
přijíždějí 	 při-jížd-ěj-í 	 při-jížd-ěj-í
přiklapnout 	 při-klap-nou-t 	 při-klap-nou-t
přikračovat 	 při-krač-ova-t 	 při-krač-ova-t
přikrádat 	 při-krád-a-t 	 při-krád-a-t
přilepšit 	 při-lep-š-i-t 	 při-lep-š-i-t
přiláká 	 při-lák-á 	 při-lák-á
přilétávat 	 při-lét-á-v-a-t 	 při-lét-á-v-a-t
přilézt 	 při-léz-t 	 při-léz-t
přimáznout 	 při-máz-nou-t 	 při-máz-nou-t
přiměšovat 	 při-měš-ova-t 	 při-měš-ova-t
připadne 	 při-pad-ne 	 při-pad-ne
připochodovat 	 při-po-chod-ova-t 	 při-po-chod-ova-t
připodobit 	 při-po-dob-i-t 	 při-po-dob-i-t
připřáhnout 	 při-přáh-nou-t 	 při-přáh-nou-t
přirazit 	 při-raz-i-t 	 při-raz-i-t
přirovnat 	 při-rov-n-a-t 	 při-rov-n-a-t
přispořit 	 při-spoř-i-t 	 při-spoř-i-t
přistrojit 	 při-stroj-i-t 	 při-stroj-i-t
přistříhat 	 při-stříh-a-t 	 při-stříh-a-t
přisvědčit 	 při-svědč-i-t 	 při-svědč-i-t
přisýpat 	 při-sýp-a-t 	 při-sýp-a-t
přitiskne 	 při-tisk-ne 	 při-tisk-ne
přitiskovat 	 při-tisk-ova-t 	 při-tisk-ova-t
přivařit 	 při-vař-i-t 	 při-vař-i-t
přivážet 	 při-váž-e-t 	 při-váž-e-t
přiznej 	 při-zn-e-j 	 při-zn-e-j
přizpůsobení 	 při-z-pů-sob-en-í 	 při-z-pů-sob-en-í
přičinění 	 při-čin-ěn-í 	 při-čin-ěn-í
přišpendlit 	 při-špendl-i-t 	 při-špendl-i-t
přiživit 	 při-živ-i-t 	 při-živ-i-t
přiživovat 	 při-živ-ova-t 	 při-živ-ova-t
přižínat 	 při-žín-a-t 	 při-žín-a-t
přání 	 přá-n-í 	 přá-n-í
příchod 	 pří-chod 	 pří-chod
přídavky 	 pří-d-a-v-k-y 	 pří-d-a-v-k-y
příjemně 	 pří-jem-n-ě 	 pří-jem-n-ě
příkladně 	 pří-klad-n-ě 	 pří-klad-n-ě
příležitost 	 pří-lež-it-ost 	 pří-lež-it-ost
případné 	 pří-pad-n-é 	 pří-pad-n-é
případu 	 pří-pad-u 	 pří-pad-u
přísaze 	 pří-saz-e 	 pří-saz-e
přísné 	 přísn-é 	 přísn-é
přístupna 	 pří-stup-n-a 	 pří-stup-n-a
přístupy 	 pří-stup-y 	 pří-stup-y
přístřeší 	 pří-střeš-í 	 pří-střeš-í
přítomny 	 pří-t-o-m-n-y 	 pří-t-o-m-n-y
příštipkovat 	 pří-štip-k-ova-t 	 pří-štip-k-ova-t
pšeničné 	 pšen-ič-n-é 	 pšen-ič-n-é
půdní 	 půd-n-í 	 půd-n-í
půdu 	 půd-u 	 půd-u
půjdu 	 pů-jd-u 	 pů-jd-u
půjčte 	 půjč-te 	 půjč-te
původ 	 pů-vod 	 pů-vod
původní 	 pů-vod-n-í 	 pů-vod-n-í
rachotit 	 rach-ot-i-t 	 rach-ot-i-t
racionalism 	 racion-al-ism 	 racion-al-ism
rada 	 rad-a 	 rad-a
radikalizovat 	 radik-al-iz-ova-t 	 radik-al-iz-ova-t
radu 	 rad-u 	 rad-u
raději 	 rad-ěji 	 rad-ěji
rallye 	 rallye 	 rallye
rameni 	 ram-en-i 	 ram-en-i
rasy 	 ras-y 	 ras-y
ravaissona 	 ravaisson-a 	 ravaisson-a
razit 	 raz-i-t 	 raz-i-t
realizovat 	 real-iz-ova-t 	 real-iz-ova-t
redakční 	 redakč-n-í 	 redakč-n-í
referát 	 re-fer-át 	 re-fer-át
reflex 	 re-flex 	 re-flex
regulovat 	 regul-ova-t 	 regul-ova-t
rejda 	 rejd-a 	 rejd-a
rejha 	 rejh-a 	 rejh-a
rejstříku 	 rejstřík-u 	 rejstřík-u
rekord 	 rekord 	 rekord
relativizování 	 relat-iv-izová-n-í 	 relat-iv-izová-n-í
repeal 	 repeal 	 repeal
replikovat 	 re-plik-ova-t 	 re-plik-ova-t
republikou 	 republik-ou 	 republik-ou
resignovat 	 re-sign-ova-t 	 re-sign-ova-t
resp 	 resp 	 resp
revidovat 	 re-vid-ova-t 	 re-vid-ova-t
rezervy 	 re-zerv-y 	 re-zerv-y
reálné 	 reál-n-é 	 reál-n-é
rigolovat 	 rigol-ova-t 	 rigol-ova-t
rodí 	 rod-í 	 rod-í
roh 	 roh 	 roh
rohovatět 	 roh-ov-at-ě-t 	 roh-ov-at-ě-t
rojit 	 roj-i-t 	 roj-i-t
roky 	 rok-y 	 rok-y
rostl 	 rost-l 	 rost-l
rozběhli 	 roz-běh-l-i 	 roz-běh-l-i
rozběhnout 	 roz-běh-nou-t 	 roz-běh-nou-t
rozchlípnout 	 roz-chlíp-nou-t 	 roz-chlíp-nou-t
rozchodit 	 roz-chod-i-t 	 roz-chod-i-t
rozchraptit 	 roz-chrap-t-i-t 	 roz-chrap-t-i-t
rozdivit 	 roz-div-i-t 	 roz-div-i-t
rozdrnčet 	 roz-drnč-e-t 	 roz-drnč-e-t
rozdrolit 	 roz-drol-i-t 	 roz-drol-i-t
rozdrtit 	 roz-drt-i-t 	 roz-drt-i-t
rozdávat 	 roz-d-á-v-a-t 	 roz-d-á-v-a-t
rozdělení 	 roz-děl-en-í 	 roz-děl-en-í
rozdělovat 	 roz-děl-ova-t 	 roz-děl-ova-t
rozecpávat 	 roze-cp-á-v-a-t 	 roze-cp-á-v-a-t
rozehřívat 	 roze-hří-v-a-t 	 roze-hří-v-a-t
rozeskupit 	 roze-skup-i-t 	 roze-skup-i-t
rozestírat 	 roze-stír-a-t 	 roze-stír-a-t
rozestřel 	 roze-stř-e-l 	 roze-stř-e-l
rozestřít 	 roze-stř-í-t 	 roze-stř-í-t
rozesílán 	 roze-síl-á-n 	 roze-síl-á-n
rozevírat 	 roze-vír-a-t 	 roze-vír-a-t
rozhazovat 	 roz-haz-ova-t 	 roz-haz-ova-t
rozhlas 	 roz-hlas 	 roz-hlas
rozhled 	 roz-hled 	 roz-hled
rozhostit 	 roz-host-i-t 	 roz-host-i-t
rozhovoru 	 roz-hovor-u 	 roz-hovor-u
rozhozený 	 roz-hoz-en-ý 	 roz-hoz-en-ý
rozhýbat 	 roz-hýb-a-t 	 roz-hýb-a-t
rozjet 	 roz-je-t 	 roz-je-t
rozjásat 	 roz-jás-a-t 	 roz-jás-a-t
rozjíždět 	 roz-jížd-ě-t 	 roz-jížd-ě-t
rozkazovat 	 roz-kaz-ova-t 	 roz-kaz-ova-t
rozkazu 	 roz-kaz-u 	 roz-kaz-u
rozkloktat 	 roz-klokt-a-t 	 roz-klokt-a-t
rozklížit 	 roz-klíž-i-t 	 roz-klíž-i-t
rozkmotřit 	 roz-kmotř-i-t 	 roz-kmotř-i-t
rozkopávat 	 roz-kop-á-v-a-t 	 roz-kop-á-v-a-t
rozkout 	 roz-kou-t 	 roz-kou-t
rozkročen 	 roz-kroč-en 	 roz-kroč-en
rozleptávat 	 roz-lept-á-v-a-t 	 roz-lept-á-v-a-t
rozlišovat 	 roz-liš-ova-t 	 roz-liš-ova-t
rozložit 	 roz-lož-i-t 	 roz-lož-i-t
rozluky 	 roz-luk-y 	 roz-luk-y
rozluštit 	 roz-lušt-i-t 	 roz-lušt-i-t
rozléhá 	 roz-léh-á 	 roz-léh-á
rozmotat 	 roz-mot-a-t 	 roz-mot-a-t
rozmrzávat 	 roz-mrz-á-v-a-t 	 roz-mrz-á-v-a-t
rozmělnit 	 roz-měl-n-i-t 	 roz-měl-n-i-t
roznýtovat 	 roz-nýt-ova-t 	 roz-nýt-ova-t
rozpažit 	 roz-paž-i-t 	 roz-paž-i-t
rozplýtvat 	 roz-plýtv-a-t 	 roz-plýtv-a-t
rozplývat 	 roz-plý-v-a-t 	 roz-plý-v-a-t
rozporů 	 roz-por-ů 	 roz-por-ů
rozpracovat 	 roz-prac-ova-t 	 roz-prac-ova-t
rozprasknout 	 roz-prask-nou-t 	 roz-prask-nou-t
rozpraskovat 	 roz-prask-ova-t 	 roz-prask-ova-t
rozpíchat 	 roz-pích-a-t 	 roz-pích-a-t
rozpíjet 	 roz-píj-e-t 	 roz-píj-e-t
rozstupovat 	 roz-stup-ova-t 	 roz-stup-ova-t
rozstřihnout 	 roz-střih-nou-t 	 roz-střih-nou-t
rozstříknout 	 roz-střík-nou-t 	 roz-střík-nou-t
rozsáhlou 	 roz-sáh-l-ou 	 roz-sáh-l-ou
roztavit 	 roz-tav-i-t 	 roz-tav-i-t
rozteskňovat 	 roz-tesk-ň-ova-t 	 roz-tesk-ň-ova-t
roztroubit 	 roz-troub-i-t 	 roz-troub-i-t
roztáhnout 	 roz-táh-nou-t 	 roz-táh-nou-t
roztávat 	 roz-tá-v-a-t 	 roz-tá-v-a-t
rozuzlovat 	 roz-uzl-ova-t 	 roz-uzl-ova-t
rozvinovat 	 roz-vi-n-ova-t 	 roz-vi-n-ova-t
rozvlékat 	 roz-vlék-a-t 	 roz-vlék-a-t
rozvlňovat 	 roz-vlň-ova-t 	 roz-vlň-ova-t
rozvojem 	 roz-voj-em 	 roz-voj-em
rozvážil 	 roz-váž-i-l 	 roz-váž-i-l
rozvážně 	 roz-váž-n-ě 	 roz-váž-n-ě
rozvíjeny 	 roz-víj-en-y 	 roz-víj-en-y
rozvětvené 	 roz-větv-en-é 	 roz-větv-en-é
rozvěšovat 	 roz-věš-ova-t 	 roz-věš-ova-t
rozčechrávat 	 roz-čechr-á-v-a-t 	 roz-čechr-á-v-a-t
rozčesat 	 roz-čes-a-t 	 roz-čes-a-t
rozředit 	 roz-řed-i-t 	 roz-řed-i-t
rozšiřování 	 roz-šiř-ová-n-í 	 roz-šiř-ová-n-í
rozškvařit 	 roz-škvař-i-t 	 roz-škvař-i-t
rozškvařovat 	 roz-škvař-ova-t 	 roz-škvař-ova-t
rozšlapávat 	 roz-šlap-á-v-a-t 	 roz-šlap-á-v-a-t
rozšíření 	 roz-šíř-en-í 	 roz-šíř-en-í
rozžvýkat 	 roz-žvýk-a-t 	 roz-žvýk-a-t
rošťák 	 rošť-ák 	 rošť-ák
ruka 	 ruk-a 	 ruk-a
ruku 	 ruk-u 	 ruk-u
ruské 	 rus-k-é 	 rus-k-é
rusové 	 rus-ové 	 rus-ové
russel 	 russel 	 russel
ručkovat 	 ruč-k-ova-t 	 ruč-k-ova-t
ryzost 	 ryz-ost 	 ryz-ost
rád 	 rád 	 rád
rádi 	 rád-i 	 rád-i
ráfovat 	 ráf-ova-t 	 ráf-ova-t
rána 	 rán-a 	 rán-a
ráno 	 rán-o 	 rán-o
rázná 	 ráz-n-á 	 ráz-n-á
různě 	 různ-ě 	 různ-ě
růže 	 růž-e 	 růž-e
sagnac 	 sagnac 	 sagnac
salonku 	 salon-k-u 	 salon-k-u
salutovat 	 salut-ova-t 	 salut-ova-t
salutuju 	 salut-uj-u 	 salut-uj-u
sametově 	 samet-ov-ě 	 samet-ov-ě
samostatnější 	 sam-o-stat-n-ějš-í 	 sam-o-stat-n-ějš-í
samá 	 sam-á 	 sam-á
sazeb 	 saz-eb 	 saz-eb
sbratřit 	 s-bratř-i-t 	 s-bratř-i-t
sbubnovat 	 s-bubn-ova-t 	 s-bubn-ova-t
sbuntován 	 s-bunt-ová-n 	 s-bunt-ová-n
sbírala 	 s-bír-a-l-a 	 s-bír-a-l-a
schovat 	 s-chov-a-t 	 s-chov-a-t
schválit 	 s-chvál-i-t 	 s-chvál-i-t
scienza 	 scienza 	 scienza
scéna 	 scén-a 	 scén-a
sdružil 	 s-druž-i-l 	 s-druž-i-l
sebral 	 se-br-a-l 	 se-br-a-l
secvičit 	 se-cvič-i-t 	 se-cvič-i-t
sedla 	 sed-l-a 	 sed-l-a
sedmé 	 sedm-é 	 sedm-é
seger 	 seger 	 seger
sehrávat 	 se-hrá-v-a-t 	 se-hrá-v-a-t
seknout 	 sek-nou-t 	 sek-nou-t
semílat 	 se-míl-a-t 	 se-míl-a-t
server 	 server 	 server
sesekat 	 se-sek-a-t 	 se-sek-a-t
seskupit 	 se-skup-i-t 	 se-skup-i-t
sesmyknout 	 se-s-myk-nou-t 	 se-s-myk-nou-t
sestrkávat 	 se-strk-á-v-a-t 	 se-strk-á-v-a-t
sestává 	 se-stá-v-á 	 se-stá-v-á
sestříhat 	 se-stříh-a-t 	 se-stříh-a-t
seznamuji 	 se-znam-uj-i 	 se-znam-uj-i
seznámit 	 se-znám-i-t 	 se-znám-i-t
seřizovat 	 se-řiz-ova-t 	 se-řiz-ova-t
seškrabovat 	 se-škrab-ova-t 	 se-škrab-ova-t
shladit 	 s-hlad-i-t 	 s-hlad-i-t
shlídnout 	 s-hlíd-nou-t 	 s-hlíd-nou-t
shodou 	 s-hod-ou 	 s-hod-ou
shora 	 s-hor-a 	 s-hor-a
shrnout 	 s-hr-nou-t 	 s-hr-nou-t
silná 	 sil-n-á 	 sil-n-á
sir 	 sir 	 sir
skasat 	 s-kas-a-t 	 s-kas-a-t
sklouznout 	 s-klouz-nou-t 	 s-klouz-nou-t
skládala 	 s-klád-a-l-a 	 s-klád-a-l-a
skomírat 	 s-ko-mír-a-t 	 s-ko-mír-a-t
skončení 	 s-konč-en-í 	 s-konč-en-í
skroutit 	 s-krout-i-t 	 s-krout-i-t
skáče 	 skáč-e 	 skáč-e
skříň 	 skříň 	 skříň
sladovat 	 slad-ova-t 	 slad-ova-t
slastí 	 slast-í 	 slast-í
slavnostně 	 slav-n-ost-n-ě 	 slav-n-ost-n-ě
sledování 	 sled-ová-n-í 	 sled-ová-n-í
slejvat 	 s-lej-v-a-t 	 s-lej-v-a-t
slepou 	 slep-ou 	 slep-ou
slev 	 s-lev 	 s-lev
slevu 	 s-lev-u 	 s-lev-u
slez 	 s-lez 	 s-lez
slota 	 slot-a 	 slot-a
sloupy 	 sloup-y 	 sloup-y
slovní 	 slov-n-í 	 slov-n-í
slunce 	 slun-c-e 	 slun-c-e
slunit 	 slun-i-t 	 slun-i-t
slušné 	 sluš-n-é 	 sluš-n-é
slyšet 	 slyš-e-t 	 slyš-e-t
slízal 	 s-líz-a-l 	 s-líz-a-l
smekl 	 s-mek-l 	 s-mek-l
smetanový 	 smetan-ov-ý 	 smetan-ov-ý
smiřovat 	 s-miř-ova-t 	 s-miř-ova-t
smířit 	 s-míř-i-t 	 s-míř-i-t
směl 	 smě-l 	 smě-l
směšný 	 směš-n-ý 	 směš-n-ý
snah 	 snah 	 snah
snídaně 	 s-níd-a-n-ě 	 s-níd-a-n-ě
sníh 	 sníh 	 sníh
sobotu 	 sobot-u 	 sobot-u
sobě 	 s-ob-ě 	 s-ob-ě
socializovat 	 soci-al-iz-ova-t 	 soci-al-iz-ova-t
solidnost 	 solid-n-ost 	 solid-n-ost
solidní 	 solid-n-í 	 solid-n-í
sonduje 	 sond-uje 	 sond-uje
souboj 	 sou-boj 	 sou-boj
souborů 	 sou-bor-ů 	 sou-bor-ů
soucitně 	 sou-cit-n-ě 	 sou-cit-n-ě
souhlasný 	 sou-hlas-n-ý 	 sou-hlas-n-ý
souhlasí 	 sou-hlas-í 	 sou-hlas-í
soused 	 sou-sed 	 sou-sed
sousedit 	 sou-sed-i-t 	 sou-sed-i-t
soustava 	 sou-stav-a 	 sou-stav-a
soustružit 	 sou-struž-i-t 	 sou-struž-i-t
soustředit 	 sou-střed-i-t 	 sou-střed-i-t
soutěž 	 sou-těž 	 sou-těž
soutěžit 	 sou-těž-i-t 	 sou-těž-i-t
souvislost 	 sou-vis-l-ost 	 sou-vis-l-ost
současná 	 sou-čas-n-á 	 sou-čas-n-á
současným 	 sou-čas-n-ým 	 sou-čas-n-ým
soužit 	 souž-i-t 	 souž-i-t
spadla 	 s-pad-l-a 	 s-pad-l-a
spadne 	 s-pad-ne 	 s-pad-ne
specializované 	 speci-al-iz-ova-n-é 	 speci-al-iz-ova-n-é
species 	 species 	 species
spekulativní 	 spekul-at-iv-n-í 	 spekul-at-iv-n-í
spis 	 s-pis 	 s-pis
spisovat 	 s-pis-ova-t 	 s-pis-ova-t
splatit 	 s-plat-i-t 	 s-plat-i-t
splašené 	 s-plaš-en-é 	 s-plaš-en-é
splnit 	 s-pln-i-t 	 s-pln-i-t
splněno 	 s-pln-ěn-o 	 s-pln-ěn-o
spokojena 	 s-po-koj-en-a 	 s-po-koj-en-a
spolehliví 	 s-po-leh-liv-í 	 s-po-leh-liv-í
společných 	 spol-eč-n-ých 	 spol-eč-n-ých
spolupodepsat 	 spol-u-pode-ps-a-t 	 spol-u-pode-ps-a-t
spoléhej 	 s-po-léh-ej 	 s-po-léh-ej
sportovní 	 sport-ov-n-í 	 sport-ov-n-í
spotřebitel 	 s-po-třeb-i-tel 	 s-po-třeb-i-tel
spotřebitele 	 s-po-třeb-i-tel-e 	 s-po-třeb-i-tel-e
spoután 	 s-pout-á-n 	 s-pout-á-n
spočítal 	 s-po-čít-a-l 	 s-po-čít-a-l
spočítá 	 s-po-čít-á 	 s-po-čít-á
spravedlivost 	 s-prav-ed-l-iv-ost 	 s-prav-ed-l-iv-ost
sprchnout 	 s-prch-nou-t 	 s-prch-nou-t
spřahovat 	 s-přah-ova-t 	 s-přah-ova-t
srdečně 	 srd-eč-n-ě 	 srd-eč-n-ě
srna 	 srn-a 	 srn-a
srovnatelná 	 s-rov-n-a-teln-á 	 s-rov-n-a-teln-á
srozumitelně 	 s-roz-um-i-teln-ě 	 s-roz-um-i-teln-ě
stabilní 	 stabil-n-í 	 stabil-n-í
stadionu 	 stadion-u 	 stadion-u
stagnuje 	 stagn-uje 	 stagn-uje
stanoven 	 stanov-en 	 stanov-en
stanovení 	 stan-ov-en-í 	 stan-ov-en-í
stanoví 	 stan-ov-í 	 stan-ov-í
starat 	 star-a-t 	 star-a-t
starostí 	 star-ost-í 	 star-ost-í
start 	 start 	 start
staré 	 star-é 	 star-é
stačilo 	 stač-i-l-o 	 stač-i-l-o
staříkovi 	 stař-ík-ovi 	 stař-ík-ovi
staška 	 staš-k-a 	 staš-k-a
steward 	 steward 	 steward
stlačit 	 s-tlač-i-t 	 s-tlač-i-t
stlouci 	 s-tlouc-i 	 s-tlouc-i
stopy 	 stop-y 	 stop-y
stornovat 	 storn-ova-t 	 storn-ova-t
stoupnout 	 stoup-nou-t 	 stoup-nou-t
stoupněte 	 stoup-ně-te 	 stoup-ně-te
stran 	 stran 	 stran
straší 	 straš-í 	 straš-í
stroje 	 stroj-e 	 stroj-e
strong 	 strong 	 strong
stránku 	 strán-k-u 	 strán-k-u
strčit 	 strč-i-t 	 strč-i-t
stuart 	 stuart 	 stuart
student 	 stud-ent 	 stud-ent
studentů 	 stud-ent-ů 	 stud-ent-ů
studenět 	 stud-en-ě-t 	 stud-en-ě-t
studiu 	 stud-i-u 	 stud-i-u
studuje 	 stud-uje 	 stud-uje
stulit 	 s-tul-i-t 	 s-tul-i-t
stupni 	 stup-n-i 	 stup-n-i
stydět 	 styd-ě-t 	 styd-ě-t
stál 	 stá-l 	 stá-l
stála 	 stá-l-a 	 stá-l-a
stálý 	 stál-ý 	 stál-ý
stát 	 stá-t 	 stá-t
stínit 	 stín-i-t 	 stín-i-t
stýkati 	 s-týk-a-ti 	 s-týk-a-ti
střelit 	 střel-i-t 	 střel-i-t
střepávat 	 s-třep-á-v-a-t 	 s-třep-á-v-a-t
stříbrné 	 stříbr-n-é 	 stříbr-n-é
sundavat 	 s-und-a-v-a-t 	 s-und-a-v-a-t
supernova 	 super-nova 	 super-nova
svalnatý 	 sval-nat-ý 	 sval-nat-ý
svalovou 	 sval-ov-ou 	 sval-ov-ou
svedena 	 s-ved-en-a 	 s-ved-en-a
svetr 	 svetr 	 svetr
svlékat 	 s-vlék-a-t 	 s-vlék-a-t
svlékla 	 s-vlék-l-a 	 s-vlék-l-a
svraštil 	 s-vrašt-i-l 	 s-vrašt-i-l
svrtět 	 s-vrt-ě-t 	 s-vrt-ě-t
svítily 	 svít-i-l-y 	 svít-i-l-y
svítí 	 svít-í 	 svít-í
svědkové 	 s-věd-k-ové 	 s-věd-k-ové
světově 	 svět-ov-ě 	 svět-ov-ě
světskému 	 svět-sk-ému 	 svět-sk-ému
světský 	 svět-sk-ý 	 svět-sk-ý
symbol 	 symbol 	 symbol
synchronizovat 	 syn-chron-iz-ova-t 	 syn-chron-iz-ova-t
sypou 	 syp-ou 	 syp-ou
síci 	 síc-i 	 síc-i
sílu 	 síl-u 	 síl-u
sýra 	 sýr-a 	 sýr-a
sžívat 	 s-ží-v-a-t 	 s-ží-v-a-t
tablety 	 tablet-y 	 tablet-y
tahal 	 tah-a-l 	 tah-a-l
tajná 	 taj-n-á 	 taj-n-á
takřečená 	 tak-řeč-en-á 	 tak-řeč-en-á
tančit 	 tanč-i-t 	 tanč-i-t
tasit 	 tas-i-t 	 tas-i-t
technika 	 techn-ik-a 	 techn-ik-a
telat 	 tel-at 	 tel-at
temporalizovatelný 	 tempor-al-izova-teln-ý 	 tempor-al-izova-teln-ý
tenhle 	 t-en-hle 	 t-en-hle
terminologii 	 termino-log-i-i 	 termino-log-i-i
termínovat 	 termín-ova-t 	 termín-ova-t
textil 	 textil 	 textil
textu 	 text-u 	 text-u
tezi 	 tez-i 	 tez-i
thajska 	 thaj-sk-a 	 thaj-sk-a
theodicée 	 theodicée 	 theodicée
tip 	 tip 	 tip
tipnout 	 tip-nou-t 	 tip-nou-t
tipovali 	 tip-ova-l-i 	 tip-ova-l-i
tips 	 tips 	 tips
tipy 	 tip-y 	 tip-y
tisk 	 tisk 	 tisk
tomáš 	 tomáš 	 tomáš
topilo 	 top-i-l-o 	 top-i-l-o
totožný 	 totožn-ý 	 totožn-ý
tou 	 t-ou 	 t-ou
toužit 	 touž-i-t 	 touž-i-t
tradovat 	 trad-ova-t 	 trad-ova-t
tragičnost 	 trag-ič-n-ost 	 trag-ič-n-ost
traktorů 	 traktor-ů 	 traktor-ů
trans 	 trans 	 trans
transplantační 	 trans-plant-ač-n-í 	 trans-plant-ač-n-í
trestat 	 trest-a-t 	 trest-a-t
trní 	 trn-í 	 trn-í
trojí 	 tr-oj-í 	 tr-oj-í
tropy 	 trop-y 	 trop-y
troufat 	 trouf-a-t 	 trouf-a-t
trpělivě 	 trp-ě-l-iv-ě 	 trp-ě-l-iv-ě
trysknout 	 trysk-nou-t 	 trysk-nou-t
trůnu 	 trůn-u 	 trůn-u
tržba 	 trž-b-a 	 trž-b-a
tržním 	 trž-n-ím 	 trž-n-ím
tuhého 	 tuh-ého 	 tuh-ého
tuky 	 tuk-y 	 tuk-y
tulit 	 tul-i-t 	 tul-i-t
tull 	 tull 	 tull
tupit 	 tup-i-t 	 tup-i-t
tupnout 	 tup-nou-t 	 tup-nou-t
tupě 	 tup-ě 	 tup-ě
turci 	 turc-i 	 turc-i
turek 	 turek 	 turek
tužba 	 tuž-b-a 	 tuž-b-a
tužeb 	 tuž-eb 	 tuž-eb
tvor 	 tvor 	 tvor
tvořil 	 tvoř-i-l 	 tvoř-i-l
tvořily 	 tvoř-i-l-y 	 tvoř-i-l-y
tyfem 	 tyf-em 	 tyf-em
typů 	 typ-ů 	 typ-ů
tzv 	 t-z-v 	 t-z-v
táhlo 	 táh-l-o 	 táh-l-o
tázat 	 táz-a-t 	 táz-a-t
tít 	 t-í-t 	 t-í-t
týká 	 týk-á 	 týk-á
týrat 	 týr-a-t 	 týr-a-t
těhotenství 	 těhoten-ství 	 těhoten-ství
tělo 	 těl-o 	 těl-o
těsnat 	 těsn-a-t 	 těsn-a-t
třasknout 	 třask-nou-t 	 třask-nou-t
třepetat 	 třep-et-a-t 	 třep-et-a-t
třiceti 	 tř-i-cet-i 	 tř-i-cet-i
třpytit 	 třpyt-i-t 	 třpyt-i-t
udusit 	 u-dus-i-t 	 u-dus-i-t
udýchanej 	 u-dých-a-n-ej 	 u-dých-a-n-ej
udělání 	 u-děl-á-n-í 	 u-děl-á-n-í
uhasnout 	 u-has-nou-t 	 u-has-nou-t
uhledat 	 u-hled-a-t 	 u-hled-a-t
uhořet 	 u-hoř-e-t 	 u-hoř-e-t
uhražen 	 u-hraž-en 	 u-hraž-en
ujelo 	 u-je-l-o 	 u-je-l-o
ujistit 	 u-jist-i-t 	 u-jist-i-t
ukaž 	 u-kaž 	 u-kaž
ukládá 	 u-klád-á 	 u-klád-á
ukopnout 	 u-kop-nou-t 	 u-kop-nou-t
ukrajovat 	 u-kraj-ova-t 	 u-kraj-ova-t
ukroutit 	 u-krout-i-t 	 u-krout-i-t
ukvapovat 	 u-kvap-ova-t 	 u-kvap-ova-t
uloupení 	 u-loup-en-í 	 u-loup-en-í
ulovit 	 u-lov-i-t 	 u-lov-i-t
ulíznout 	 u-líz-nou-t 	 u-líz-nou-t
umačkat 	 u-mačk-a-t 	 u-mačk-a-t
umožnily 	 u-možn-i-l-y 	 u-možn-i-l-y
umrtvení 	 u-mr-tv-en-í 	 u-mr-tv-en-í
umučit 	 u-muč-i-t 	 u-muč-i-t
umáznout 	 u-máz-nou-t 	 u-máz-nou-t
umírňovat 	 u-mír-ň-ova-t 	 u-mír-ň-ova-t
umělkovat 	 um-ě-l-k-ova-t 	 um-ě-l-k-ova-t
unavujou 	 u-nav-uj-ou 	 u-nav-uj-ou
unese 	 u-nes-e 	 u-nes-e
unožit 	 u-nož-i-t 	 u-nož-i-t
upadlo 	 u-pad-l-o 	 u-pad-l-o
uplatit 	 u-plat-i-t 	 u-plat-i-t
uplatnil 	 u-plat-n-i-l 	 u-plat-n-i-l
uplatněný 	 u-plat-n-ěn-ý 	 u-plat-n-ěn-ý
uplivnout 	 u-pliv-nou-t 	 u-pliv-nou-t
upokojovat 	 u-po-koj-ova-t 	 u-po-koj-ova-t
upozornit 	 u-po-zor-n-i-t 	 u-po-zor-n-i-t
upozorňujeme 	 u-po-zor-ň-uje-me 	 u-po-zor-ň-uje-me
upravená 	 u-prav-en-á 	 u-prav-en-á
upíjet 	 u-píj-e-t 	 u-píj-e-t
urgenci 	 urg-enc-i 	 urg-enc-i
urgencích 	 urgenc-ích 	 urgenc-ích
urgovat 	 urg-ova-t 	 urg-ova-t
urobit 	 u-rob-i-t 	 u-rob-i-t
urousat 	 u-rous-a-t 	 u-rous-a-t
urozená 	 u-roz-en-á 	 u-roz-en-á
určeno 	 u-rč-en-o 	 u-rč-en-o
určenou 	 u-rč-en-ou 	 u-rč-en-ou
určovaly 	 u-rč-ova-l-y 	 u-rč-ova-l-y
usa 	 u-s-a 	 u-s-a
uschovávat 	 u-s-chov-á-v-a-t 	 u-s-chov-á-v-a-t
usd 	 u-s-d 	 u-s-d
usedat 	 u-sed-a-t 	 u-sed-a-t
usedavě 	 u-sed-a-v-ě 	 u-sed-a-v-ě
usednout 	 u-sed-nou-t 	 u-sed-nou-t
usekat 	 u-sek-a-t 	 u-sek-a-t
useknout 	 u-sek-nou-t 	 u-sek-nou-t
usilovně 	 u-sil-ov-n-ě 	 u-sil-ov-n-ě
usiluje 	 u-sil-uje 	 u-sil-uje
uskutečnila 	 u-skuteč-n-i-l-a 	 u-skuteč-n-i-l-a
usmál 	 u-smá-l 	 u-smá-l
uspokojen 	 u-s-po-koj-en 	 u-s-po-koj-en
uspořádat 	 u-s-po-řád-a-t 	 u-s-po-řád-a-t
ustupovat 	 u-stup-ova-t 	 u-stup-ova-t
ustřihnout 	 u-střih-nou-t 	 u-střih-nou-t
usvědčit 	 u-svědč-i-t 	 u-svědč-i-t
utrmácet 	 u-trmác-e-t 	 u-trmác-e-t
utrousit 	 u-trous-i-t 	 u-trous-i-t
utrpěl 	 u-trp-ě-l 	 u-trp-ě-l
utrpět 	 u-trp-ě-t 	 u-trp-ě-t
utvrzovat 	 u-tvrz-ova-t 	 u-tvrz-ova-t
utěšenému 	 u-těš-en-ému 	 u-těš-en-ému
utřel 	 u-tř-e-l 	 u-tř-e-l
uvedenou 	 u-ved-en-ou 	 u-ved-en-ou
uvedených 	 u-ved-en-ých 	 u-ved-en-ých
uvidíte 	 u-vid-í-te 	 u-vid-í-te
uvolnit 	 u-vol-n-i-t 	 u-vol-n-i-t
uvyknout 	 u-vyk-nou-t 	 u-vyk-nou-t
uváděním 	 u-vád-ě-n-ím 	 u-vád-ě-n-ím
uvádět 	 u-vád-ě-t 	 u-vád-ě-t
uzavřeli 	 u-za-vř-e-l-i 	 u-za-vř-e-l-i
uzdravovat 	 u-zdrav-ova-t 	 u-zdrav-ova-t
uznávání 	 u-zn-á-v-á-n-í 	 u-zn-á-v-á-n-í
ušplíchnout 	 u-šplích-nou-t 	 u-šplích-nou-t
uším 	 uš-ím 	 uš-ím
užmoulat 	 u-žmoul-a-t 	 u-žmoul-a-t
užívat 	 u-ží-v-a-t 	 u-ží-v-a-t
užívá 	 u-ží-v-á 	 u-ží-v-á
vadí 	 vad-í 	 vad-í
vank 	 vank 	 vank
vanka 	 van-k-a 	 van-k-a
vaně 	 van-ě 	 van-ě
vašnosti 	 vaš-n-ost-i 	 vaš-n-ost-i
vcházet 	 v-cház-e-t 	 v-cház-e-t
vdechnout 	 v-dech-nou-t 	 v-dech-nou-t
vedou 	 ved-ou 	 ved-ou
vegetovat 	 veget-ova-t 	 veget-ova-t
vejci 	 vej-c-i 	 vej-c-i
vemluvit 	 ve-mluv-i-t 	 ve-mluv-i-t
venkovan 	 ven-k-ov-an 	 ven-k-ov-an
venčit 	 ven-č-i-t 	 ven-č-i-t
vepsat 	 ve-ps-a-t 	 ve-ps-a-t
vesnici 	 ves-nic-i 	 ves-nic-i
vetkat 	 ve-tk-a-t 	 ve-tk-a-t
vetkávat 	 ve-tk-á-v-a-t 	 ve-tk-á-v-a-t
večer 	 večer 	 večer
večera 	 večer-a 	 večer-a
veškeré 	 veš-k-er-é 	 veš-k-er-é
vhazovat 	 v-haz-ova-t 	 v-haz-ova-t
vhodným 	 v-hod-n-ým 	 v-hod-n-ým
vidimovat 	 vidim-ova-t 	 vidim-ova-t
vidíte 	 vid-í-te 	 vid-í-te
viděls 	 vid-ě-l-s 	 vid-ě-l-s
vily 	 vil-y 	 vil-y
virile 	 virile 	 virile
vizum 	 viz-um 	 viz-um
viďte 	 viď-te 	 viď-te
vkluzovávaně 	 v-kluz-ová-v-a-n-ě 	 v-kluz-ová-v-a-n-ě
vladařit 	 vlad-ař-i-t 	 vlad-ař-i-t
vlak 	 vlak 	 vlak
vlastnostech 	 vlast-n-ost-ech 	 vlast-n-ost-ech
vlasů 	 vlas-ů 	 vlas-ů
vlažnět 	 vlaž-n-ě-t 	 vlaž-n-ě-t
vlepovat 	 v-lep-ova-t 	 v-lep-ova-t
vlnu 	 vln-u 	 vln-u
vložit 	 v-lož-i-t 	 v-lož-i-t
vládávatelnost 	 vlád-á-v-a-teln-ost 	 vlád-á-v-a-teln-ost
vlézt 	 v-léz-t 	 v-léz-t
vlítat 	 v-lít-a-t 	 v-lít-a-t
vmyslit 	 v-mysl-i-t 	 v-mysl-i-t
vnitrný 	 v-nitr-n-ý 	 v-nitr-n-ý
vnímat 	 v-ním-a-t 	 v-ním-a-t
vobléknutelný 	 v-ob-lék-nu-teln-ý 	 v-ob-lék-nu-teln-ý
vodotiskem 	 vod-o-tisk-em 	 vod-o-tisk-em
vodou 	 vod-ou 	 vod-ou
vojenskou 	 voj-en-sk-ou 	 voj-en-sk-ou
vojsko 	 voj-sk-o 	 voj-sk-o
volat 	 vol-a-t 	 vol-a-t
volán 	 vol-á-n 	 vol-á-n
vozu 	 voz-u 	 voz-u
vpisovat 	 v-pis-ova-t 	 v-pis-ova-t
vplížit 	 v-plíž-i-t 	 v-plíž-i-t
vproudit 	 v-proud-i-t 	 v-proud-i-t
vpít 	 v-pí-t 	 v-pí-t
vrahům 	 vrah-ům 	 vrah-ům
vraštět 	 vraš-t-ě-t 	 vraš-t-ě-t
vraždi 	 vraž-d-i 	 vraž-d-i
vrcholu 	 vrch-ol-u 	 vrch-ol-u
vrhat 	 vrh-a-t 	 vrh-a-t
vrtat 	 vrt-a-t 	 vrt-a-t
vrzat 	 vrz-a-t 	 vrz-a-t
vrátil 	 vrát-i-l 	 vrát-i-l
vstoupil 	 v-stoup-i-l 	 v-stoup-i-l
vstup 	 v-stup 	 v-stup
vstupné 	 v-stup-n-é 	 v-stup-n-é
vstupného 	 v-stup-n-ého 	 v-stup-n-ého
vstupném 	 v-stup-n-ém 	 v-stup-n-ém
vstupu 	 v-stup-u 	 v-stup-u
vtiskávat 	 v-tisk-á-v-a-t 	 v-tisk-á-v-a-t
vtírá 	 v-tír-á 	 v-tír-á
vyabstrahovat 	 vy-abs-trah-ova-t 	 vy-abs-trah-ova-t
vybafnout 	 vy-baf-nou-t 	 vy-baf-nou-t
vybafčit 	 vy-baf-č-i-t 	 vy-baf-č-i-t
vybojovat 	 vy-boj-ova-t 	 vy-boj-ova-t
vybryndat 	 vy-brynd-a-t 	 vy-brynd-a-t
vybírá 	 vy-bír-á 	 vy-bír-á
vybízí 	 vy-bíz-í 	 vy-bíz-í
vyceňovat 	 vy-ceň-ova-t 	 vy-ceň-ova-t
vychovat 	 vy-chov-a-t 	 vy-chov-a-t
vydechl 	 vy-dech-l 	 vy-dech-l
vydrápat 	 vy-dráp-a-t 	 vy-dráp-a-t
vydráždit 	 vy-drážd-i-t 	 vy-drážd-i-t
vydumat 	 vy-dum-a-t 	 vy-dum-a-t
vydávaje 	 vy-d-á-v-aj-e 	 vy-d-á-v-aj-e
vydávit 	 vy-dáv-i-t 	 vy-dáv-i-t
vydýchnout 	 vy-dých-nou-t 	 vy-dých-nou-t
vyděláme 	 vy-děl-á-me 	 vy-děl-á-me
vyhledávat 	 vy-hled-á-v-a-t 	 vy-hled-á-v-a-t
vyhlásil 	 vy-hlás-i-l 	 vy-hlás-i-l
vyhoblovat 	 vy-hobl-ova-t 	 vy-hobl-ova-t
vyhodnocovat 	 vy-hod-n-oc-ova-t 	 vy-hod-n-oc-ova-t
vyhoří 	 vy-hoř-í 	 vy-hoř-í
vyhranit 	 vy-hran-i-t 	 vy-hran-i-t
vyhraňovat 	 vy-hraň-ova-t 	 vy-hraň-ova-t
vyhrkla 	 vy-hrk-l-a 	 vy-hrk-l-a
vyhrknout 	 vy-hrk-nou-t 	 vy-hrk-nou-t
vyhýbat 	 vy-hýb-a-t 	 vy-hýb-a-t
vyjasněný 	 vy-jas-n-ěn-ý 	 vy-jas-n-ěn-ý
vyjíždět 	 vy-jížd-ě-t 	 vy-jížd-ě-t
vyklopýtat 	 vy-klopýt-a-t 	 vy-klopýt-a-t
vykonané 	 vy-kon-a-n-é 	 vy-kon-a-n-é
vykoupal 	 vy-koup-a-l 	 vy-koup-a-l
vykramařit 	 vy-kram-ař-i-t 	 vy-kram-ař-i-t
vykroutit 	 vy-krout-i-t 	 vy-krout-i-t
vyl 	 vy-l 	 vy-l
vylehčit 	 vy-leh-č-i-t 	 vy-leh-č-i-t
vylisovat 	 vy-lis-ova-t 	 vy-lis-ova-t
vyloučení 	 vy-louč-en-í 	 vy-louč-en-í
vyluhovat 	 vy-luh-ova-t 	 vy-luh-ova-t
vymazat 	 vy-maz-a-t 	 vy-maz-a-t
vymezovat 	 vy-mez-ova-t 	 vy-mez-ova-t
vymořit 	 vy-moř-i-t 	 vy-moř-i-t
vymyšlené 	 vy-myšl-e-n-é 	 vy-myšl-e-n-é
vymítat 	 vy-mít-a-t 	 vy-mít-a-t
vynaložili 	 vy-na-lož-i-l-i 	 vy-na-lož-i-l-i
vynaložit 	 vy-na-lož-i-t 	 vy-na-lož-i-t
vynaloží 	 vy-na-lož-í 	 vy-na-lož-í
vynalézání 	 vy-na-léz-á-n-í 	 vy-na-léz-á-n-í
vyndal 	 vy-nd-a-l 	 vy-nd-a-l
vypadnou 	 vy-pad-n-ou 	 vy-pad-n-ou
vypancéřovat 	 vy-pancéř-ova-t 	 vy-pancéř-ova-t
vypeckovat 	 vy-pec-k-ova-t 	 vy-pec-k-ova-t
vypejkání 	 vy-pejk-á-n-í 	 vy-pejk-á-n-í
vyplaněný 	 vy-plan-ě-n-ý 	 vy-plan-ě-n-ý
vypláchnout 	 vy-plách-nou-t 	 vy-plách-nou-t
vypláznout 	 vy-pláz-nou-t 	 vy-pláz-nou-t
vyplísnit 	 vy-plísn-i-t 	 vy-plísn-i-t
vypojit 	 vy-poj-i-t 	 vy-poj-i-t
vypojovat 	 vy-poj-ova-t 	 vy-poj-ova-t
vyportrétovat 	 vy-portrét-ova-t 	 vy-portrét-ova-t
vypočítávat 	 vy-po-čít-á-v-a-t 	 vy-po-čít-á-v-a-t
vypravili 	 vy-prav-i-l-i 	 vy-prav-i-l-i
vypráví 	 vy-práv-í 	 vy-práv-í
vyprávěli 	 vy-práv-ě-l-i 	 vy-práv-ě-l-i
vypuknout 	 vy-puk-nou-t 	 vy-puk-nou-t
vypátrat 	 vy-pátr-a-t 	 vy-pátr-a-t
vypůjčil 	 vy-půjč-i-l 	 vy-půjč-i-l
vyrazil 	 vy-raz-i-l 	 vy-raz-i-l
vyrobila 	 vy-rob-i-l-a 	 vy-rob-i-l-a
vysazovat 	 vy-saz-ova-t 	 vy-saz-ova-t
vysidlovat 	 vy-sidl-ova-t 	 vy-sidl-ova-t
vyslovený 	 vy-slov-en-ý 	 vy-slov-en-ý
vyslyšeti 	 vy-slyš-e-ti 	 vy-slyš-e-ti
vysmrádnout 	 vy-smrád-nou-t 	 vy-smrád-nou-t
vysmívat 	 vy-smí-v-a-t 	 vy-smí-v-a-t
vyspravit 	 vy-s-prav-i-t 	 vy-s-prav-i-t
vystavil 	 vy-stav-i-l 	 vy-stav-i-l
vystavila 	 vy-stav-i-l-a 	 vy-stav-i-l-a
vystačovaný 	 vy-stač-ova-n-ý 	 vy-stač-ova-n-ý
vystoupení 	 vy-stoup-en-í 	 vy-stoup-en-í
vystoupením 	 vy-stoup-en-ím 	 vy-stoup-en-ím
vystoupit 	 vy-stoup-i-t 	 vy-stoup-i-t
vystrkovat 	 vy-strk-ova-t 	 vy-strk-ova-t
vystupuje 	 vy-stup-uje 	 vy-stup-uje
vystřídalo 	 vy-stříd-a-l-o 	 vy-stříd-a-l-o
vystřídat 	 vy-stříd-a-t 	 vy-stříd-a-t
vystříkat 	 vy-střík-a-t 	 vy-střík-a-t
vysvěcovat 	 vy-svěc-ova-t 	 vy-svěc-ova-t
vysvětlení 	 vy-svět-l-en-í 	 vy-svět-l-en-í
vysvětloval 	 vy-svět-l-ova-l 	 vy-svět-l-ova-l
vytepat 	 vy-tep-a-t 	 vy-tep-a-t
vytištěny 	 vy-tišt-ěn-y 	 vy-tišt-ěn-y
vytlouci 	 vy-tlouc-i 	 vy-tlouc-i
vytočit 	 vy-toč-i-t 	 vy-toč-i-t
vytvořeno 	 vy-tvoř-en-o 	 vy-tvoř-en-o
vytít 	 vy-t-í-t 	 vy-t-í-t
vytížit 	 vy-tíž-i-t 	 vy-tíž-i-t
vytřeštit 	 vy-třešt-i-t 	 vy-třešt-i-t
vyvařit 	 vy-vař-i-t 	 vy-vař-i-t
vyvolávat 	 vy-vol-á-v-a-t 	 vy-vol-á-v-a-t
vyvozovat 	 vy-voz-ova-t 	 vy-voz-ova-t
vyvracela 	 vy-vrac-e-l-a 	 vy-vrac-e-l-a
vyvěsit 	 vy-věs-i-t 	 vy-věs-i-t
vyznají 	 vy-zn-aj-í 	 vy-zn-aj-í
vyzobat 	 vy-zob-a-t 	 vy-zob-a-t
vyzpytovat 	 vy-z-pyt-ova-t 	 vy-z-pyt-ova-t
vyzvracet 	 vy-z-vrac-e-t 	 vy-z-vrac-e-t
vyzářit 	 vy-zář-i-t 	 vy-zář-i-t
vyčichnout 	 vy-čich-nou-t 	 vy-čich-nou-t
vyčinil 	 vy-čin-i-l 	 vy-čin-i-l
vyčištěný 	 vy-čišt-ěn-ý 	 vy-čišt-ěn-ý
vyčpět 	 vy-čp-ě-t 	 vy-čp-ě-t
vyřežu 	 vy-řež-u 	 vy-řež-u
vyříkat 	 vy-řík-a-t 	 vy-řík-a-t
vyšetřilo 	 vy-šetř-i-l-o 	 vy-šetř-i-l-o
vyšetříme 	 vy-šetř-í-me 	 vy-šetř-í-me
vyšpehovat 	 vy-špeh-ova-t 	 vy-špeh-ova-t
vyštěknout 	 vy-štěk-nou-t 	 vy-štěk-nou-t
vyžadonit 	 vy-žad-on-i-t 	 vy-žad-on-i-t
vyžaduje 	 vy-žad-uje 	 vy-žad-uje
vyžehlit 	 vy-žehl-i-t 	 vy-žehl-i-t
vyžehnout 	 vy-žeh-nou-t 	 vy-žeh-nou-t
vyžle 	 vyžle 	 vyžle
vyžvanit 	 vy-žvan-i-t 	 vy-žvan-i-t
vyžíhat 	 vy-žíh-a-t 	 vy-žíh-a-t
vzdorovat 	 vz-dor-ova-t 	 vz-dor-ova-t
vzdálený 	 vz-dál-en-ý 	 vz-dál-en-ý
vzhlížet 	 vz-hlíž-e-t 	 vz-hlíž-e-t
vzlínat 	 vz-lín-a-t 	 vz-lín-a-t
vzlítnout 	 vz-lít-nou-t 	 vz-lít-nou-t
vznikají 	 vz-nik-aj-í 	 vz-nik-aj-í
vznikla 	 vz-nik-l-a 	 vz-nik-l-a
vzniku 	 vz-nik-u 	 vz-nik-u
vzniká 	 vz-nik-á 	 vz-nik-á
vztahů 	 vz-tah-ů 	 vz-tah-ů
vztekle 	 vz-tek-l-e 	 vz-tek-l-e
vzteknout 	 vz-tek-nou-t 	 vz-tek-nou-t
vzteku 	 vz-tek-u 	 vz-tek-u
vzájemná 	 v-zá-jem-n-á 	 v-zá-jem-n-á
vážné 	 váž-n-é 	 váž-n-é
víc 	 víc 	 víc
vítkovického 	 vítk-ovic-k-ého 	 vítk-ovic-k-ého
vítěze 	 vítěz-e 	 vítěz-e
vítězům 	 vítěz-ům 	 vítěz-ům
východního 	 vý-chod-n-ího 	 vý-chod-n-ího
východě 	 vý-chod-ě 	 vý-chod-ě
výherci 	 vý-her-c-i 	 vý-her-c-i
výhled 	 vý-hled 	 vý-hled
výhodou 	 vý-hod-ou 	 vý-hod-ou
výklad 	 vý-klad 	 vý-klad
výmluvnost 	 vý-mluv-n-ost 	 vý-mluv-n-ost
výpočetní 	 vý-po-čet-n-í 	 vý-po-čet-n-í
výrazné 	 vý-raz-n-é 	 vý-raz-n-é
výstavbě 	 vý-stav-b-ě 	 vý-stav-b-ě
výuce 	 vý-uc-e 	 vý-uc-e
vývoj 	 vý-voj 	 vý-voj
vývozu 	 vý-voz-u 	 vý-voz-u
vědec 	 věd-ec 	 věd-ec
vědou 	 věd-ou 	 věd-ou
vědro 	 vědr-o 	 vědr-o
vědí 	 věd-í 	 věd-í
vědět 	 věd-ě-t 	 věd-ě-t
věrnými 	 věr-n-ými 	 věr-n-ými
větrů 	 větr-ů 	 větr-ů
věz 	 věz 	 věz
věznit 	 věz-n-i-t 	 věz-n-i-t
věčné 	 věč-n-é 	 věč-n-é
věřte 	 věř-te 	 věř-te
věříme 	 věř-í-me 	 věř-í-me
všeho 	 vš-eho 	 vš-eho
všeobecně 	 vš-e-obec-n-ě 	 vš-e-obec-n-ě
vševědova 	 vševěd-ov-a 	 vševěd-ov-a
všoupnout 	 v-šoup-nou-t 	 v-šoup-nou-t
vštípit 	 v-štíp-i-t 	 v-štíp-i-t
vštěpuji 	 v-štěp-uj-i 	 v-štěp-uj-i
vůně 	 vůn-ě 	 vůn-ě
wild 	 wild 	 wild
william 	 william 	 william
zabedňovat 	 za-bedň-ova-t 	 za-bedň-ova-t
zabijeme 	 za-bi-je-me 	 za-bi-je-me
zabolet 	 za-bol-e-t 	 za-bol-e-t
zabouřit 	 za-bouř-i-t 	 za-bouř-i-t
zabrousit 	 za-brous-i-t 	 za-brous-i-t
zachmuřen 	 za-chmuř-en 	 za-chmuř-en
zachovávat 	 za-chov-á-v-a-t 	 za-chov-á-v-a-t
zachrániti 	 za-chrán-i-ti 	 za-chrán-i-ti
zachvěla 	 za-chvě-l-a 	 za-chvě-l-a
zacinkat 	 za-cink-a-t 	 za-cink-a-t
zacloňovat 	 za-cloň-ova-t 	 za-cloň-ova-t
zadek 	 zad-ek 	 zad-ek
zadrhl 	 za-drh-l 	 za-drh-l
zadrhnout 	 za-drh-nou-t 	 za-drh-nou-t
zafouknout 	 za-fouk-nou-t 	 za-fouk-nou-t
zahanbit 	 za-han-b-i-t 	 za-han-b-i-t
zahlenit 	 za-hlen-i-t 	 za-hlen-i-t
zahleňovat 	 za-hleň-ova-t 	 za-hleň-ova-t
zahnědnout 	 za-hněd-nou-t 	 za-hněd-nou-t
zahoukat 	 za-houk-a-t 	 za-houk-a-t
zahraničním 	 za-hran-ič-n-ím 	 za-hran-ič-n-ím
zahvízdat 	 za-hvízd-a-t 	 za-hvízd-a-t
zahájila 	 za-háj-i-l-a 	 za-háj-i-l-a
zahřměl 	 za-hřm-ě-l 	 za-hřm-ě-l
zainteresované 	 za-interes-ova-n-é 	 za-interes-ova-n-é
zajatec 	 za-j-at-ec 	 za-j-at-ec
zajistila 	 za-jist-i-l-a 	 za-jist-i-l-a
zajistit 	 za-jist-i-t 	 za-jist-i-t
zajisté 	 za-jist-é 	 za-jist-é
zajištěno 	 za-jišt-ěn-o 	 za-jišt-ěn-o
zajídat 	 za-jíd-a-t 	 za-jíd-a-t
zajímá 	 za-jím-á 	 za-jím-á
zakalit 	 za-kal-i-t 	 za-kal-i-t
zakecat 	 za-kec-a-t 	 za-kec-a-t
zaklapnout 	 za-klap-nou-t 	 za-klap-nou-t
zaklenout 	 za-kle-nou-t 	 za-kle-nou-t
zaklepe 	 za-klep-e 	 za-klep-e
zakomíhat 	 za-komíh-a-t 	 za-komíh-a-t
zakonzervování 	 za-konzerv-ová-n-í 	 za-konzerv-ová-n-í
zakončovat 	 za-konč-ova-t 	 za-konč-ova-t
zakopán 	 za-kop-á-n 	 za-kop-á-n
zakrvavět 	 za-krv-av-ě-t 	 za-krv-av-ě-t
zakrývat 	 za-krý-v-a-t 	 za-krý-v-a-t
zakvílet 	 za-kvíl-e-t 	 za-kvíl-e-t
zalepilo 	 za-lep-i-l-o 	 za-lep-i-l-o
zalidnit 	 za-lid-n-i-t 	 za-lid-n-i-t
zalil 	 za-li-l 	 za-li-l
založený 	 za-lož-en-ý 	 za-lož-en-ý
založil 	 za-lož-i-l 	 za-lož-i-l
založiti 	 za-lož-i-ti 	 za-lož-i-ti
zalykat 	 za-lyk-a-t 	 za-lyk-a-t
zalétat 	 za-lét-a-t 	 za-lét-a-t
zamalovat 	 za-mal-ova-t 	 za-mal-ova-t
zameškat 	 za-mešk-a-t 	 za-mešk-a-t
zameškávat 	 za-mešk-á-v-a-t 	 za-mešk-á-v-a-t
zamručet 	 za-mruč-e-t 	 za-mruč-e-t
zamyslel 	 za-mysl-e-l 	 za-mysl-e-l
zamyšlená 	 za-myšl-e-n-á 	 za-myšl-e-n-á
zamyšlený 	 za-myšl-e-n-ý 	 za-myšl-e-n-ý
zamyšleně 	 za-myšl-e-n-ě 	 za-myšl-e-n-ě
zaměstná 	 za-měst-n-á 	 za-měst-n-á
zaměřovat 	 za-měř-ova-t 	 za-měř-ova-t
zandat 	 za-nd-a-t 	 za-nd-a-t
zanedbávat 	 za-ne-db-á-v-a-t 	 za-ne-db-á-v-a-t
zanést 	 za-nés-t 	 za-nés-t
zanýtovat 	 za-nýt-ova-t 	 za-nýt-ova-t
zaperlit 	 za-perl-i-t 	 za-perl-i-t
zapichovat 	 za-pich-ova-t 	 za-pich-ova-t
zaplacené 	 za-plac-en-é 	 za-plac-en-é
zaplakal 	 za-plak-a-l 	 za-plak-a-l
zaplítat 	 za-plít-a-t 	 za-plít-a-t
zaplítatelnost 	 za-plít-a-teln-ost 	 za-plít-a-teln-ost
zapojit 	 za-poj-i-t 	 za-poj-i-t
zapomnění 	 za-po-mn-ě-n-í 	 za-po-mn-ě-n-í
zapovídat 	 za-po-víd-a-t 	 za-po-víd-a-t
zapošít 	 za-po-ší-t 	 za-po-ší-t
zaprodávat 	 za-pro-d-á-v-a-t 	 za-pro-d-á-v-a-t
zapsal 	 za-ps-a-l 	 za-ps-a-l
zapřádat 	 za-přád-a-t 	 za-přád-a-t
zapůjčovat 	 za-půjč-ova-t 	 za-půjč-ova-t
zardousil 	 za-rdous-i-l 	 za-rdous-i-l
zareagovat 	 za-re-ag-ova-t 	 za-re-ag-ova-t
zaregistrovat 	 za-registr-ova-t 	 za-registr-ova-t
zaručen 	 za-ruč-en 	 za-ruč-en
zaručit 	 za-ruč-i-t 	 za-ruč-i-t
zaručuje 	 za-ruč-uje 	 za-ruč-uje
zarámovány 	 za-rám-ová-n-y 	 za-rám-ová-n-y
zasedli 	 za-sed-l-i 	 za-sed-l-i
zaskřípnout 	 za-skříp-nou-t 	 za-skříp-nou-t
zasmolit 	 za-smol-i-t 	 za-smol-i-t
zasmrádnout 	 za-smrád-nou-t 	 za-smrád-nou-t
zasmyčkování 	 za-smyč-k-ová-n-í 	 za-smyč-k-ová-n-í
zasnoubil 	 za-snoub-i-l 	 za-snoub-i-l
zasršela 	 za-srš-e-l-a 	 za-srš-e-l-a
zastřelili 	 za-střel-i-l-i 	 za-střel-i-l-i
zastřelit 	 za-střel-i-t 	 za-střel-i-t
zastřelovat 	 za-střel-ova-t 	 za-střel-ova-t
zastříhat 	 za-stříh-a-t 	 za-stříh-a-t
zasvinit 	 za-svin-i-t 	 za-svin-i-t
zasílat 	 za-síl-a-t 	 za-síl-a-t
zasívat 	 za-sí-v-a-t 	 za-sí-v-a-t
zatancovat 	 za-tanc-ova-t 	 za-tanc-ova-t
zatelegrafovat 	 za-tele-graf-ova-t 	 za-tele-graf-ova-t
zatkneme 	 za-tk-ne-me 	 za-tk-ne-me
zatracená 	 za-trac-en-á 	 za-trac-en-á
zatratil 	 za-trat-i-l 	 za-trat-i-l
zatroubit 	 za-troub-i-t 	 za-troub-i-t
zatrápený 	 za-tráp-en-ý 	 za-tráp-en-ý
zatčený 	 za-tč-en-ý 	 za-tč-en-ý
zatřpytit 	 za-třpyt-i-t 	 za-třpyt-i-t
zavazuje 	 za-vaz-uje 	 za-vaz-uje
zavlečenou 	 za-vleč-en-ou 	 za-vleč-en-ou
zavléci 	 za-vléc-i 	 za-vléc-i
zavolám 	 za-vol-á-m 	 za-vol-á-m
zavrhovat 	 za-vrh-ova-t 	 za-vrh-ova-t
zavrzat 	 za-vrz-a-t 	 za-vrz-a-t
zavtipkovat 	 za-vtip-k-ova-t 	 za-vtip-k-ova-t
zavzdychnout 	 za-vz-dych-nou-t 	 za-vz-dych-nou-t
zaváhat 	 za-váh-a-t 	 za-váh-a-t
zavést 	 za-vés-t 	 za-vés-t
zavírali 	 za-vír-a-l-i 	 za-vír-a-l-i
zavěšení 	 za-věš-en-í 	 za-věš-en-í
zavřel 	 za-vř-e-l 	 za-vř-e-l
zazimovat 	 za-zim-ova-t 	 za-zim-ova-t
zazátkovat 	 za-zá-tk-ova-t 	 za-zá-tk-ova-t
začišťovat 	 za-čišť-ova-t 	 za-čišť-ova-t
začne 	 za-č-ne 	 za-č-ne
začudit 	 za-čud-i-t 	 za-čud-i-t
začínají 	 za-čín-aj-í 	 za-čín-aj-í
zařadil 	 za-řad-i-l 	 za-řad-i-l
zařazeny 	 za-řaz-en-y 	 za-řaz-en-y
zařizovatel 	 za-řiz-ova-tel 	 za-řiz-ova-tel
zařízením 	 za-říz-en-ím 	 za-říz-en-ím
zaškaredit 	 za-škared-i-t 	 za-škared-i-t
zaštěknout 	 za-štěk-nou-t 	 za-štěk-nou-t
zašustět 	 za-šust-ě-t 	 za-šust-ě-t
zaťal 	 za-ť-a-l 	 za-ť-a-l
zažívat 	 za-ží-v-a-t 	 za-ží-v-a-t
zbarvovat 	 z-barv-ova-t 	 z-barv-ova-t
zbaštit 	 z-bašt-i-t 	 z-bašt-i-t
zbožni 	 z-bož-n-i 	 z-bož-n-i
zbrušovat 	 z-bruš-ova-t 	 z-bruš-ova-t
zbytečné 	 z-by-t-eč-n-é 	 z-by-t-eč-n-é
zchodit 	 z-chod-i-t 	 z-chod-i-t
zchvátit 	 z-chvát-i-t 	 z-chvát-i-t
zcuchat 	 z-cuch-a-t 	 z-cuch-a-t
zdanitelná 	 z-dan-i-teln-á 	 z-dan-i-teln-á
zdechat 	 z-dech-a-t 	 z-dech-a-t
zdeformovat 	 z-de-form-ova-t 	 z-de-form-ova-t
zdegenerovat 	 z-de-gener-ova-t 	 z-de-gener-ova-t
zdobit 	 z-dob-i-t 	 z-dob-i-t
zdokonalit 	 z-do-kon-a-l-i-t 	 z-do-kon-a-l-i-t
zdražovat 	 z-draž-ova-t 	 z-draž-ova-t
zdrchat 	 z-drch-a-t 	 z-drch-a-t
zdrhnout 	 z-drh-nou-t 	 z-drh-nou-t
zdrsnět 	 z-drs-n-ě-t 	 z-drs-n-ě-t
zdržoval 	 z-drž-ova-l 	 z-drž-ova-l
zdít 	 zd-í-t 	 zd-í-t
zdřevnatět 	 z-dřev-n-at-ě-t 	 z-dřev-n-at-ě-t
zemřeli 	 ze-mř-e-l-i 	 ze-mř-e-l-i
zeptá 	 ze-pt-á 	 ze-pt-á
zesilovat 	 ze-sil-ova-t 	 ze-sil-ova-t
zespolečenšťovat 	 ze-spol-eč-en-šť-ova-t 	 ze-spol-eč-en-šť-ova-t
zestárnout 	 ze-stár-nou-t 	 ze-stár-nou-t
zesvětštět 	 ze-svět-št-ě-t 	 ze-svět-št-ě-t
zesílit 	 ze-síl-i-t 	 ze-síl-i-t
zešedivět 	 ze-šed-iv-ě-t 	 ze-šed-iv-ě-t
zešpatnět 	 ze-špat-n-ě-t 	 ze-špat-n-ě-t
zfalšování 	 z-falš-ová-n-í 	 z-falš-ová-n-í
zhanit 	 z-han-i-t 	 z-han-i-t
zhasl 	 z-has-l 	 z-has-l
zhasnou 	 z-has-n-ou 	 z-has-n-ou
zhospodárnit 	 z-hospod-ár-n-i-t 	 z-hospod-ár-n-i-t
zhypnotizovat 	 z-hypn-ot-iz-ova-t 	 z-hypn-ot-iz-ova-t
zimě 	 zim-ě 	 zim-ě
zinventovat 	 z-invent-ova-t 	 z-invent-ova-t
zjednat 	 z-jedn-a-t 	 z-jedn-a-t
zježit 	 z-jež-i-t 	 z-jež-i-t
zjihnout 	 z-jih-nou-t 	 z-jih-nou-t
zjistit 	 z-jist-i-t 	 z-jist-i-t
zjízlivět 	 z-jíz-l-iv-ě-t 	 z-jíz-l-iv-ě-t
zkalit 	 z-kal-i-t 	 z-kal-i-t
zkamenět 	 z-kamen-ě-t 	 z-kamen-ě-t
zkazilo 	 z-kaz-i-l-o 	 z-kaz-i-l-o
zkombinovat 	 z-kombin-ova-t 	 z-kombin-ova-t
zkoušet 	 z-kouš-e-t 	 z-kouš-e-t
zkrácena 	 z-krác-en-a 	 z-krác-en-a
zkrácené 	 z-krác-en-é 	 z-krác-en-é
zkrásnět 	 z-krás-n-ě-t 	 z-krás-n-ě-t
zkusila 	 z-kus-i-l-a 	 z-kus-i-l-a
zkypřet 	 z-kypř-e-t 	 z-kypř-e-t
zlatnout 	 zlat-nou-t 	 zlat-nou-t
zlatovlasé 	 zlat-o-vlas-é 	 zlat-o-vlas-é
zloděj 	 zl-o-děj 	 zl-o-děj
zlézt 	 z-léz-t 	 z-léz-t
zmateného 	 z-mat-en-ého 	 z-mat-en-ého
zmazat 	 z-maz-a-t 	 z-maz-a-t
zmeškat 	 z-mešk-a-t 	 z-mešk-a-t
zmizely 	 z-miz-e-l-y 	 z-miz-e-l-y
zmiňuji 	 z-miň-uj-i 	 z-miň-uj-i
zmodrat 	 z-modr-a-t 	 z-modr-a-t
zmoralizování 	 z-moral-iz-ová-n-í 	 z-moral-iz-ová-n-í
zmrvit 	 z-mrv-i-t 	 z-mrv-i-t
zmuchlat 	 z-muchl-a-t 	 z-muchl-a-t
zmátl 	 z-mát-l 	 z-mát-l
zmírňovat 	 z-mír-ň-ova-t 	 z-mír-ň-ova-t
zmýdelnět 	 z-mýdel-n-ě-t 	 z-mýdel-n-ě-t
zmýlit 	 z-mýl-i-t 	 z-mýl-i-t
znalec 	 zn-a-l-ec 	 zn-a-l-ec
znali 	 zn-a-l-i 	 zn-a-l-i
znamenaly 	 znam-en-a-l-y 	 znam-en-a-l-y
znemravnit 	 z-ne-mrav-n-i-t 	 z-ne-mrav-n-i-t
znesnadňovat 	 z-ne-snad-ň-ova-t 	 z-ne-snad-ň-ova-t
znesvětit 	 z-ne-svět-i-t 	 z-ne-svět-i-t
znešvařena 	 z-ne-švař-en-a 	 z-ne-švař-en-a
znešvařovat 	 z-ne-švař-ova-t 	 z-ne-švař-ova-t
znovu 	 z-nov-u 	 z-nov-u
znásilňovat 	 z-ná-sil-ň-ova-t 	 z-ná-sil-ň-ova-t
znásobit 	 z-násob-i-t 	 z-násob-i-t
znáte 	 zn-á-te 	 zn-á-te
znět 	 zn-ě-t 	 zn-ě-t
zobecnět 	 z-obec-n-ě-t 	 z-obec-n-ě-t
zorat 	 z-or-a-t 	 z-or-a-t
zosobnit 	 z-osob-n-i-t 	 z-osob-n-i-t
zoufnout 	 zouf-nou-t 	 zouf-nou-t
zouvat 	 zou-v-a-t 	 zou-v-a-t
zpatlat 	 z-patl-a-t 	 z-patl-a-t
zplnomocňovat 	 z-pln-o-moc-ň-ova-t 	 z-pln-o-moc-ň-ova-t
zplynit 	 z-plyn-i-t 	 z-plyn-i-t
zpocený 	 z-poc-en-ý 	 z-poc-en-ý
zpohlavkovat 	 z-po-hlav-k-ova-t 	 z-po-hlav-k-ova-t
zprostředkuje 	 z-pro-střed-k-uje 	 z-pro-střed-k-uje
zprůmyslnělost 	 z-prů-mysl-n-ě-l-ost 	 z-prů-mysl-n-ě-l-ost
zpustošit 	 z-pust-oš-i-t 	 z-pust-oš-i-t
zpívá 	 z-pí-v-á 	 z-pí-v-á
zpěčovat 	 zpěč-ova-t 	 zpěč-ova-t
zpřevracovat 	 z-pře-vrac-ova-t 	 z-pře-vrac-ova-t
zpřísnit 	 z-přísn-i-t 	 z-přísn-i-t
zpřísnět 	 z-přísn-ě-t 	 z-přísn-ě-t
zrakový 	 zrak-ov-ý 	 zrak-ov-ý
zrcadle 	 zrc-a-dl-e 	 zrc-a-dl-e
zregenerovat 	 z-re-gener-ova-t 	 z-re-gener-ova-t
zregulovat 	 z-regul-ova-t 	 z-regul-ova-t
zrušeny 	 z-ruš-en-y 	 z-ruš-en-y
zrušení 	 z-ruš-en-í 	 z-ruš-en-í
zrušil 	 z-ruš-i-l 	 z-ruš-i-l
ztenčovat 	 z-ten-č-ova-t 	 z-ten-č-ova-t
ztepat 	 z-tep-a-t 	 z-tep-a-t
ztlouci 	 z-tlouc-i 	 z-tlouc-i
ztotožnit 	 z-to-tož-n-i-t 	 z-to-tož-n-i-t
ztotožňovat 	 z-to-tož-ň-ova-t 	 z-to-tož-ň-ova-t
ztratiti 	 z-trat-i-ti 	 z-trat-i-ti
ztrhat 	 z-trh-a-t 	 z-trh-a-t
ztropí 	 z-trop-í 	 z-trop-í
ztroskotat 	 z-trosk-ot-a-t 	 z-trosk-ot-a-t
ztrátou 	 z-trát-ou 	 z-trát-ou
ztrýznit 	 z-trýzn-i-t 	 z-trýzn-i-t
ztuchnout 	 z-tuch-nou-t 	 z-tuch-nou-t
ztupit 	 z-tup-i-t 	 z-tup-i-t
ztupět 	 z-tup-ě-t 	 z-tup-ě-t
ztéci 	 z-téc-i 	 z-téc-i
ztížená 	 z-tíž-en-á 	 z-tíž-en-á
ztěžovat 	 z-těž-ova-t 	 z-těž-ova-t
zuhelnět 	 z-uhel-n-ě-t 	 z-uhel-n-ě-t
zutrhat 	 z-u-trh-a-t 	 z-u-trh-a-t
zvadaně 	 z-vad-a-n-ě 	 z-vad-a-n-ě
zviklat 	 z-vikl-a-t 	 z-vikl-a-t
zvláčet 	 z-vláč-e-t 	 z-vláč-e-t
zvlášť 	 zvlášť 	 zvlášť
zvolal 	 z-vol-a-l 	 z-vol-a-l
zvolena 	 z-vol-en-a 	 z-vol-en-a
zvoleny 	 z-vol-en-y 	 z-vol-en-y
zvolnit 	 z-vol-n-i-t 	 z-vol-n-i-t
zvroucnit 	 z-vr-ou-c-n-i-t 	 z-vr-ou-c-n-i-t
zvrtnout 	 z-vrt-nou-t 	 z-vrt-nou-t
zvrátit 	 z-vrát-i-t 	 z-vrát-i-t
zvážení 	 z-váž-en-í 	 z-váž-en-í
zvířata 	 zvíř-at-a 	 zvíř-at-a
zvýhodnění 	 z-vý-hod-n-ěn-í 	 z-vý-hod-n-ěn-í
zvýhodňovat 	 z-vý-hod-ň-ova-t 	 z-vý-hod-ň-ova-t
zvýšil 	 z-výš-i-l 	 z-výš-i-l
zvěčnit 	 z-věč-n-i-t 	 z-věč-n-i-t
zády 	 zád-y 	 zád-y
základního 	 zá-klad-n-ího 	 zá-klad-n-ího
zálohy 	 zá-loh-y 	 zá-loh-y
záporný 	 zá-por-n-ý 	 zá-por-n-ý
zásahu 	 zá-sah-u 	 zá-sah-u
zásobení 	 zá-sob-en-í 	 zá-sob-en-í
zástupce 	 zá-stup-c-e 	 zá-stup-c-e
zástupci 	 zá-stup-c-i 	 zá-stup-c-i
zástěrce 	 zá-stěr-c-e 	 zá-stěr-c-e
zástěrka 	 zá-stěr-k-a 	 zá-stěr-k-a
zátočiny 	 zá-toč-in-y 	 zá-toč-in-y
závad 	 zá-vad 	 zá-vad
závadu 	 zá-vad-u 	 zá-vad-u
závod 	 zá-vod 	 zá-vod
zúžit 	 z-úž-i-t 	 z-úž-i-t
zřasovat 	 z-řas-ova-t 	 z-řas-ova-t
zřetelně 	 zř-e-teln-ě 	 zř-e-teln-ě
zšedivět 	 z-šed-iv-ě-t 	 z-šed-iv-ě-t
zůstalo 	 zů-sta-l-o 	 zů-sta-l-o
zůstanou 	 z-ů-sta-n-ou 	 z-ů-sta-n-ou
úchvatná 	 ú-chvat-n-á 	 ú-chvat-n-á
úcta 	 ú-ct-a 	 ú-ct-a
újezdě 	 ú-jezd-ě 	 ú-jezd-ě
újmě 	 ú-jm-ě 	 ú-jm-ě
úmysly 	 ú-mysl-y 	 ú-mysl-y
úplný 	 ú-pln-ý 	 ú-pln-ý
úprava 	 ú-prav-a 	 ú-prav-a
úpravě 	 ú-prav-ě 	 ú-prav-ě
úrodnou 	 ú-rod-n-ou 	 ú-rod-n-ou
úspěšnou 	 ú-spěš-n-ou 	 ú-spěš-n-ou
ústav 	 ú-stav 	 ú-stav
ústit 	 úst-i-t 	 úst-i-t
útrobách 	 útrob-ách 	 útrob-ách
útrpně 	 ú-trp-n-ě 	 ú-trp-n-ě
útulný 	 ú-tul-n-ý 	 ú-tul-n-ý
úvahu 	 ú-vah-u 	 ú-vah-u
úvahy 	 ú-vah-y 	 ú-vah-y
úvěrování 	 ú-věr-ová-n-í 	 ú-věr-ová-n-í
úvěru 	 ú-věr-u 	 ú-věr-u
účasten 	 ú-čast-en 	 ú-čast-en
účastně 	 ú-čast-n-ě 	 ú-čast-n-ě
účelu 	 ú-čel-u 	 ú-čel-u
účetních 	 ú-čet-n-ích 	 ú-čet-n-ích
účinnosti 	 ú-čin-n-ost-i 	 ú-čin-n-ost-i
účinností 	 ú-čin-n-ost-í 	 ú-čin-n-ost-í
účtu 	 ú-čt-u 	 ú-čt-u
účty 	 ú-čt-y 	 ú-čt-y
úřad 	 ú-řad 	 ú-řad
úřadem 	 ú-řad-em 	 ú-řad-em
úřadu 	 ú-řad-u 	 ú-řad-u
čachrovat 	 čachr-ova-t 	 čachr-ova-t
častý 	 čast-ý 	 čast-ý
časy 	 čas-y 	 čas-y
časů 	 čas-ů 	 čas-ů
čerstvého 	 čerstv-ého 	 čerstv-ého
čerti 	 čert-i 	 čert-i
českou 	 čes-k-ou 	 čes-k-ou
českém 	 čes-k-ém 	 čes-k-ém
četné 	 čet-n-é 	 čet-n-é
češtiny 	 češ-t-in-y 	 češ-t-in-y
čich 	 čich 	 čich
čilý 	 čil-ý 	 čil-ý
činit 	 čin-i-t 	 čin-i-t
činorodé 	 čin-o-rod-é 	 čin-o-rod-é
čintamani 	 čintaman-i 	 čintaman-i
čiřit 	 čiř-i-t 	 čiř-i-t
čokoládou 	 čokolád-ou 	 čokolád-ou
čtvrt 	 čtvrt 	 čtvrt
čtvrtletně 	 čtvrt-let-n-ě 	 čtvrt-let-n-ě
čtvrté 	 čtvrt-é 	 čtvrt-é
čuchnul 	 čuch-nu-l 	 čuch-nu-l
čárat 	 čár-a-t 	 čár-a-t
částice 	 část-ic-e 	 část-ic-e
ňákou 	 ňák-ou 	 ňák-ou
řadou 	 řad-ou 	 řad-ou
ředit 	 řed-i-t 	 řed-i-t
ředitel 	 řed-i-tel 	 řed-i-tel
řepkového 	 řep-k-ov-ého 	 řep-k-ov-ého
řešit 	 řeš-i-t 	 řeš-i-t
řád 	 řád 	 řád
řádní 	 řád-n-í 	 řád-n-í
řádně 	 řád-n-ě 	 řád-n-ě
říjet 	 říj-e-t 	 říj-e-t
říkají 	 řík-aj-í 	 řík-aj-í
řízen 	 říz-en 	 říz-en
říznout 	 říz-nou-t 	 říz-nou-t
šanci 	 šanc-i 	 šanc-i
šek 	 šek 	 šek
šem 	 š-em 	 š-em
šeptne 	 šept-ne 	 šept-ne
šeptnout 	 šept-nou-t 	 šept-nou-t
šero 	 šer-o 	 šer-o
šesté 	 šest-é 	 šest-é
šikovně 	 šik-ov-n-ě 	 šik-ov-n-ě
šitinův 	 šitin-ův 	 šitin-ův
škola 	 škol-a 	 škol-a
školu 	 škol-u 	 škol-u
školy 	 škol-y 	 škol-y
školák 	 škol-ák 	 škol-ák
škvrně 	 škvr-n-ě 	 škvr-n-ě
šmankote 	 šmankote 	 šmankote
šmatat 	 šmat-a-t 	 šmat-a-t
šmejkal 	 šmejkal 	 šmejkal
šminkovat 	 šmink-ova-t 	 šmink-ova-t
špaček 	 špaček 	 špaček
špekovávat 	 špek-ová-v-a-t 	 špek-ová-v-a-t
špičatit 	 špič-at-i-t 	 špič-at-i-t
štrachat 	 štrach-a-t 	 štrach-a-t
štít 	 štít 	 štít
štěně 	 štěn-ě 	 štěn-ě
šumperka 	 šumperk-a 	 šumperk-a
šíblová 	 šíbl-ová 	 šíbl-ová
šíří 	 šíř-í 	 šíř-í
šťastná 	 šťast-n-á 	 šťast-n-á
ťápnout 	 ťáp-nou-t 	 ťáp-nou-t
žaludek 	 žaludek 	 žaludek
žejbrovat 	 žejbr-ova-t 	 žejbr-ova-t
železná 	 želez-n-á 	 želez-n-á
žernově 	 žernov-ě 	 žernov-ě
žhavět 	 žh-av-ě-t 	 žh-av-ě-t
živ 	 ži-v 	 ži-v
životě 	 ži-v-ot-ě 	 ži-v-ot-ě
žlutá 	 žlut-á 	 žlut-á
župka 	 žup-k-a 	 žup-k-a
žádné 	 žád-n-é 	 žád-n-é
žádostmi 	 žád-ost-mi 	 žád-ost-mi
