abbé 	 abb-é 	 abb-é
adami 	 adami 	 adami
adresovat 	 adres-ova-t 	 adres-ova-t
adresu 	 adres-u 	 adres-u
agnoston 	 agnoston 	 agnoston
akcií 	 akci-í 	 akci-í
aktivní 	 akt-iv-n-í 	 akt-iv-n-í
alfou 	 alf-ou 	 alf-ou
anderson 	 anderson 	 anderson
aniž 	 aniž 	 aniž
argaláš 	 argaláš 	 argaláš
armáda 	 armád-a 	 armád-a
asistovat 	 asist-ova-t 	 asist-ova-t
atlet 	 atlet 	 atlet
axiomy 	 axiom-y 	 axiom-y
babulakův 	 babulak-ův 	 babulak-ův
badenu 	 baden-u 	 baden-u
bania 	 bani-a 	 bani-a
barona 	 baron-a 	 baron-a
baťa 	 bať-a 	 bať-a
betlémské 	 betlém-sk-é 	 betlém-sk-é
bez 	 bez 	 bez
bezchybný 	 bez-chyb-n-ý 	 bez-chyb-n-ý
bezplatnou 	 bez-plat-n-ou 	 bez-plat-n-ou
bilanční 	 bilanč-n-í 	 bilanč-n-í
blafat 	 blaf-a-t 	 blaf-a-t
bližší 	 bliž-š-í 	 bliž-š-í
bloumat 	 bloum-a-t 	 bloum-a-t
bláznivého 	 blázn-iv-ého 	 blázn-iv-ého
body 	 bod-y 	 bod-y
bojovat 	 boj-ova-t 	 boj-ova-t
bojíme 	 boj-í-me 	 boj-í-me
bok 	 bok 	 bok
bombast 	 bombast 	 bombast
bot 	 bot 	 bot
boudou 	 boud-ou 	 boud-ou
boudě 	 boud-ě 	 boud-ě
box 	 box 	 box
boxovat 	 box-ova-t 	 box-ova-t
brend 	 brend 	 brend
briketovat 	 briket-ova-t 	 briket-ova-t
britští 	 brit-št-í 	 brit-št-í
broukat 	 brouk-a-t 	 brouk-a-t
brožura 	 brožur-a 	 brožur-a
brummellův 	 brummell-ův 	 brummell-ův
buchnout 	 buch-nou-t 	 buch-nou-t
budiáf 	 budiáf 	 budiáf
budova 	 bud-ova 	 bud-ova
budu 	 bud-u 	 bud-u
bulletinu 	 bulletin-u 	 bulletin-u
bums 	 bums 	 bums
bušit 	 buš-i-t 	 buš-i-t
byznys 	 byznys 	 byznys
báša 	 báš-a 	 báš-a
běžného 	 běž-n-ého 	 běž-n-ého
běží 	 běž-í 	 běž-í
břežský 	 břež-sk-ý 	 břež-sk-ý
castrogiovanni 	 castrogiovanni 	 castrogiovanni
celu 	 cel-u 	 cel-u
cenit 	 cen-i-t 	 cen-i-t
cennou 	 cen-n-ou 	 cen-n-ou
cenou 	 cen-ou 	 cen-ou
cenovky 	 cen-ovk-y 	 cen-ovk-y
cephalocereus 	 cephalocereus 	 cephalocereus
cesty 	 cest-y 	 cest-y
chlapy 	 chlap-y 	 chlap-y
chlubí 	 chlub-í 	 chlub-í
chléb 	 chléb 	 chléb
chmátnout 	 chmát-nou-t 	 chmát-nou-t
chodu 	 chod-u 	 chod-u
chovají 	 chov-aj-í 	 chov-aj-í
chráněných 	 chrán-ěn-ých 	 chrán-ěn-ých
chudší 	 chud-š-í 	 chud-š-í
chvástat 	 chvást-a-t 	 chvást-a-t
chybějící 	 chyb-ěj-íc-í 	 chyb-ěj-íc-í
chystá 	 chyst-á 	 chyst-á
chytrý 	 chytr-ý 	 chytr-ý
chápat 	 cháp-a-t 	 cháp-a-t
citovaného 	 cit-ova-n-ého 	 cit-ova-n-ého
colubrina 	 colubrin-a 	 colubrin-a
coulem 	 coul-em 	 coul-em
courama 	 cour-ama 	 cour-ama
cukru 	 cukr-u 	 cukr-u
curyšské 	 curyš-sk-é 	 curyš-sk-é
cválat 	 cvál-a-t 	 cvál-a-t
dadat 	 dad-a-t 	 dad-a-t
dakar 	 dakar 	 dakar
daklar 	 daklar 	 daklar
dana 	 dan-a 	 dan-a
daru 	 dar-u 	 dar-u
daty 	 dat-y 	 dat-y
deep 	 deep 	 deep
dem 	 dem 	 dem
denní 	 den-n-í 	 den-n-í
devizové 	 deviz-ov-é 	 deviz-ov-é
deváté 	 devát-é 	 devát-é
dewey 	 dewey 	 dewey
diferovat 	 difer-ova-t 	 difer-ova-t
diky 	 dik-y 	 dik-y
diků 	 dik-ů 	 dik-ů
divocí 	 div-oc-í 	 div-oc-í
dloužit 	 dlouž-i-t 	 dlouž-i-t
dlužna 	 dluž-n-a 	 dluž-n-a
dlužné 	 dluž-n-é 	 dluž-n-é
dlážka 	 dláž-k-a 	 dláž-k-a
dobra 	 dobr-a 	 dobr-a
docentů 	 docent-ů 	 docent-ů
docházela 	 do-cház-e-l-a 	 do-cház-e-l-a
docítil 	 do-cít-i-l 	 do-cít-i-l
dodržování 	 do-drž-ová-n-í 	 do-drž-ová-n-í
dohasnout 	 do-has-nou-t 	 do-has-nou-t
dohlídnout 	 do-hlíd-nou-t 	 do-hlíd-nou-t
dohodli 	 do-hod-l-i 	 do-hod-l-i
dohromady 	 do-hromad-y 	 do-hromad-y
dokonávat 	 do-kon-á-v-a-t 	 do-kon-á-v-a-t
dole 	 dol-e 	 dol-e
domlouvat 	 do-mlouv-a-t 	 do-mlouv-a-t
domluva 	 do-mluv-a 	 do-mluv-a
domáknout 	 do-mák-nou-t 	 do-mák-nou-t
domílat 	 do-míl-a-t 	 do-míl-a-t
domýšlet 	 do-mýšl-e-t 	 do-mýšl-e-t
dopisovatel 	 do-pis-ova-tel 	 do-pis-ova-tel
doplacení 	 do-plac-en-í 	 do-plac-en-í
doplnit 	 do-pln-i-t 	 do-pln-i-t
doplácet 	 do-plác-e-t 	 do-plác-e-t
dopravu 	 do-prav-u 	 do-prav-u
dopáleně 	 do-pál-en-ě 	 do-pál-en-ě
dopídit 	 do-píd-i-t 	 do-píd-i-t
dopřávat 	 do-přá-v-a-t 	 do-přá-v-a-t
dostavil 	 do-stav-i-l 	 do-stav-i-l
dostavili 	 do-stav-i-l-i 	 do-stav-i-l-i
dostaviti 	 do-stav-i-ti 	 do-stav-i-ti
dostačit 	 do-stač-i-t 	 do-stač-i-t
dostrkali 	 do-strk-a-l-i 	 do-strk-a-l-i
dostávají 	 do-stá-v-aj-í 	 do-stá-v-aj-í
dostává 	 do-stá-v-á 	 do-stá-v-á
dostřelit 	 do-střel-i-t 	 do-střel-i-t
dosvědčíme 	 do-s-věd-č-í-me 	 do-s-věd-č-í-me
dotloukat 	 do-tlouk-a-t 	 do-tlouk-a-t
dovláčet 	 do-vláč-e-t 	 do-vláč-e-t
dovídat 	 do-víd-a-t 	 do-víd-a-t
doznávala 	 do-zn-á-v-a-l-a 	 do-zn-á-v-a-l-a
drobná 	 drob-n-á 	 drob-n-á
drožkář 	 drožk-ář 	 drožk-ář
druhy 	 druh-y 	 druh-y
dráhu 	 dráh-u 	 dráh-u
drápky 	 dráp-k-y 	 dráp-k-y
drátkách 	 drát-k-ách 	 drát-k-ách
duchovně 	 duch-ov-n-ě 	 duch-ov-n-ě
duhový 	 duh-ov-ý 	 duh-ov-ý
duní 	 dun-í 	 dun-í
durajková 	 durajk-ov-á 	 durajk-ov-á
dušiček 	 duš-iček 	 duš-iček
dveře 	 dveř-e 	 dveř-e
dvojit 	 dvoj-i-t 	 dvoj-i-t
dvorku 	 dvor-k-u 	 dvor-k-u
díra 	 dír-a 	 dír-a
dívají 	 dív-aj-í 	 dív-aj-í
dózovat 	 dóz-ova-t 	 dóz-ova-t
dělení 	 děl-en-í 	 děl-en-í
děláme 	 děl-á-me 	 děl-á-me
dřeně 	 dřen-ě 	 dřen-ě
dřepnout 	 dřep-nou-t 	 dřep-nou-t
dřívko 	 dřív-k-o 	 dřív-k-o
důvěrně 	 dů-věr-n-ě 	 dů-věr-n-ě
efektů 	 efekt-ů 	 efekt-ů
ekologické 	 eko-log-ick-é 	 eko-log-ick-é
elidovat 	 elid-ova-t 	 elid-ova-t
et 	 et 	 et
evropského 	 evrop-sk-ého 	 evrop-sk-ého
ex 	 ex 	 ex
expansion 	 expansion 	 expansion
expedovat 	 exped-ova-t 	 exped-ova-t
fach 	 fach 	 fach
faktum 	 fakt-um 	 fakt-um
fakultní 	 fakult-n-í 	 fakult-n-í
falšovat 	 falš-ova-t 	 falš-ova-t
farmě 	 farm-ě 	 farm-ě
fastfood 	 fast-food 	 fast-food
firmou 	 firm-ou 	 firm-ou
firmy 	 firm-y 	 firm-y
fluorově 	 fluor-ov-ě 	 fluor-ov-ě
fondy 	 fond-y 	 fond-y
fondů 	 fond-ů 	 fond-ů
formát 	 form-át 	 form-át
formátů 	 form-át-ů 	 form-át-ů
franciska 	 francisk-a 	 francisk-a
francisku 	 francisk-u 	 francisk-u
funkční 	 funkč-n-í 	 funkč-n-í
gel 	 gel 	 gel
geralda 	 gerald-a 	 gerald-a
geraldu 	 gerald-u 	 gerald-u
glochidy 	 glochid-y 	 glochid-y
graessnerii 	 graessnerii 	 graessnerii
graessneriji 	 graessneriji 	 graessneriji
hafat 	 haf-a-t 	 haf-a-t
halou 	 hal-ou 	 hal-ou
halu 	 hal-u 	 hal-u
haly 	 hal-y 	 hal-y
hamounit 	 hamoun-i-t 	 hamoun-i-t
harant 	 harant 	 harant
havarovat 	 havar-ova-t 	 havar-ova-t
heep 	 heep 	 heep
hergot 	 hergot 	 hergot
herní 	 her-n-í 	 her-n-í
hlad 	 hlad 	 hlad
hladce 	 hlad-c-e 	 hlad-c-e
hladový 	 hlad-ov-ý 	 hlad-ov-ý
hladí 	 hlad-í 	 hlad-í
hlasy 	 hlas-y 	 hlas-y
hlavu 	 hlav-u 	 hlav-u
hlubší 	 hlub-š-í 	 hlub-š-í
hluk 	 hluk 	 hluk
hlučný 	 hluč-n-ý 	 hluč-n-ý
hmatat 	 hmat-a-t 	 hmat-a-t
hmotnostní 	 hmot-n-ost-n-í 	 hmot-n-ost-n-í
hnípat 	 hníp-a-t 	 hníp-a-t
hnízda 	 hnízd-a 	 hnízd-a
hoch 	 hoch 	 hoch
hodláte 	 hodl-á-te 	 hodl-á-te
honili 	 hon-i-l-i 	 hon-i-l-i
honkat 	 honk-a-t 	 honk-a-t
horovat 	 hor-ova-t 	 hor-ova-t
horynových 	 horyn-ov-ých 	 horyn-ov-ých
horách 	 hor-ách 	 hor-ách
horálek 	 horálek 	 horálek
hospody 	 hospod-y 	 hospod-y
hospodě 	 hospod-ě 	 hospod-ě
hotelu 	 hotel-u 	 hotel-u
hotelů 	 hotel-ů 	 hotel-ů
houfovat 	 houf-ova-t 	 houf-ova-t
houston 	 houston 	 houston
hradec 	 hrad-ec 	 hrad-ec
hranic 	 hran-ic 	 hran-ic
hrdostí 	 hrd-ost-í 	 hrd-ost-í
hrozí 	 hroz-í 	 hroz-í
hubatou 	 hub-at-ou 	 hub-at-ou
huby 	 hub-y 	 hub-y
hulit 	 hul-i-t 	 hul-i-t
humbuk 	 humbuk 	 humbuk
huť 	 huť 	 huť
hygiena 	 hygien-a 	 hygien-a
hádali 	 hád-a-l-i 	 hád-a-l-i
hádat 	 hád-a-t 	 hád-a-t
hřešit 	 hřeš-i-t 	 hřeš-i-t
hřížit 	 hříž-i-t 	 hříž-i-t
ian 	 ian 	 ian
idejí 	 idej-í 	 idej-í
imitovat 	 imit-ova-t 	 imit-ova-t
index 	 index 	 index
inherovat 	 inher-ova-t 	 inher-ova-t
inovace 	 inov-ace 	 inov-ace
irena 	 iren-a 	 iren-a
irkutsku 	 irkutsk-u 	 irkutsk-u
iron 	 iron 	 iron
jaa 	 jaa 	 jaa
jací 	 jac-í 	 jac-í
jakost 	 jak-ost 	 jak-ost
jan 	 jan 	 jan
janské 	 jan-sk-é 	 jan-sk-é
japonský 	 japon-sk-ý 	 japon-sk-ý
javelin 	 javelin 	 javelin
jediný 	 jedin-ý 	 jedin-ý
jedině 	 jedin-ě 	 jedin-ě
jednalo 	 jedn-a-l-o 	 jedn-a-l-o
jedno 	 jedn-o 	 jedn-o
jednota 	 jedn-ot-a 	 jedn-ot-a
jednotný 	 jedn-ot-n-ý 	 jedn-ot-n-ý
jednotě 	 jedn-ot-ě 	 jedn-ot-ě
jednou 	 jedn-ou 	 jedn-ou
jeseníkách 	 jesen-ík-ách 	 jesen-ík-ách
jethro 	 jethro 	 jethro
ježatý 	 jež-at-ý 	 jež-at-ý
jiker 	 jiker 	 jiker
jiní 	 jin-í 	 jin-í
jiskří 	 jiskř-í 	 jiskř-í
john 	 john 	 john
joint 	 joint 	 joint
jubilovat 	 jubil-ova-t 	 jubil-ova-t
jádře 	 jádř-e 	 jádř-e
kajutu 	 kajut-u 	 kajut-u
kaktusů 	 kaktus-ů 	 kaktus-ů
kamaráda 	 kamarád-a 	 kamarád-a
kamera 	 kamera 	 kamera
kamionů 	 kamion-ů 	 kamion-ů
kanadského 	 kanad-sk-ého 	 kanad-sk-ého
kanadském 	 kanad-sk-ém 	 kanad-sk-ém
kapacity 	 kapacit-y 	 kapacit-y
kapely 	 kapel-y 	 kapel-y
kapitální 	 kapitál-n-í 	 kapitál-n-í
kapitána 	 kapitán-a 	 kapitán-a
kapsu 	 kaps-u 	 kaps-u
kardašovy 	 kardašov-y 	 kardašov-y
kasernovat 	 kasern-ova-t 	 kasern-ova-t
kaše 	 kaš-e 	 kaš-e
kefurt 	 kefurt 	 kefurt
kina 	 kin-a 	 kin-a
klausův 	 klaus-ův 	 klaus-ův
klepat 	 klep-a-t 	 klep-a-t
klesající 	 kles-aj-íc-í 	 kles-aj-íc-í
klesly 	 kles-l-y 	 kles-l-y
klesne 	 kles-ne 	 kles-ne
klidná 	 klid-n-á 	 klid-n-á
kliniky 	 klinik-y 	 klinik-y
kličku 	 klič-k-u 	 klič-k-u
kličky 	 klič-k-y 	 klič-k-y
kloakách 	 kloak-ách 	 kloak-ách
klouznout 	 klouz-nou-t 	 klouz-nou-t
kluk 	 kluk 	 kluk
kluku 	 kluk-u 	 kluk-u
klít 	 klí-t 	 klí-t
kmihnout 	 kmih-nou-t 	 kmih-nou-t
kolébat 	 koléb-a-t 	 koléb-a-t
komentovávající 	 koment-ová-v-aj-íc-í 	 koment-ová-v-aj-íc-í
kompetence 	 kompetenc-e 	 kompetenc-e
koncertu 	 koncert-u 	 koncert-u
koncertů 	 koncert-ů 	 koncert-ů
kondolovat 	 kondol-ova-t 	 kondol-ova-t
konferovat 	 konfer-ova-t 	 konfer-ova-t
koninou 	 kon-in-ou 	 kon-in-ou
kopl 	 kop-l 	 kop-l
kopulovat 	 kopul-ova-t 	 kopul-ova-t
kostely 	 kostel-y 	 kostel-y
kostní 	 kost-n-í 	 kost-n-í
koukají 	 kouk-aj-í 	 kouk-aj-í
koumat 	 koum-a-t 	 koum-a-t
koupací 	 koup-ac-í 	 koup-ac-í
koupi 	 koup-i 	 koup-i
kouta 	 kout-a 	 kout-a
koutku 	 kout-k-u 	 kout-k-u
kožené 	 kož-en-é 	 kož-en-é
kraj 	 kraj 	 kraj
krb 	 krb 	 krb
kriminální 	 krimin-ál-n-í 	 krimin-ál-n-í
kritikou 	 krit-ik-ou 	 krit-ik-ou
krk 	 krk 	 krk
kronikář 	 kronik-ář 	 kronik-ář
krumlesco 	 krumlesco 	 krumlesco
krysí 	 krys-í 	 krys-í
krám 	 krám 	 krám
kráva 	 kráv-a 	 kráv-a
kteří 	 kteř-í 	 kteř-í
kufr 	 kufr 	 kufr
kufříku 	 kufř-ík-u 	 kufř-ík-u
kuponové 	 kupon-ov-é 	 kupon-ov-é
kupírovat 	 kupír-ova-t 	 kupír-ova-t
kusů 	 kus-ů 	 kus-ů
kvasit 	 kvas-i-t 	 kvas-i-t
květnu 	 květ-n-u 	 květ-n-u
kydat 	 kyd-a-t 	 kyd-a-t
kysnout 	 kys-nou-t 	 kys-nou-t
kédr 	 kédr 	 kédr
křepčit 	 křep-č-i-t 	 křep-č-i-t
křivkách 	 křiv-k-ách 	 křiv-k-ách
křísit 	 křís-i-t 	 křís-i-t
kříž 	 kříž 	 kříž
kšeft 	 kšeft 	 kšeft
kšeftu 	 kšeft-u 	 kšeft-u
lamentovat 	 lament-ova-t 	 lament-ova-t
le 	 le 	 le
lehko 	 leh-k-o 	 leh-k-o
lepí 	 lep-í 	 lep-í
lesa 	 les-a 	 les-a
lesním 	 les-n-ím 	 les-n-ím
letiště 	 let-išt-ě 	 let-išt-ě
letošní 	 letoš-n-í 	 letoš-n-í
letí 	 let-í 	 let-í
lidský 	 lid-sk-ý 	 lid-sk-ý
lihem 	 lih-em 	 lih-em
limitováno 	 limit-ová-n-o 	 limit-ová-n-o
listu 	 list-u 	 list-u
logikou 	 log-ik-ou 	 log-ik-ou
londýně 	 londýn-ě 	 londýn-ě
loni 	 lon-i 	 lon-i
lotsenovu 	 lotsen-ov-u 	 lotsen-ov-u
ložnicový 	 lož-nic-ov-ý 	 lož-nic-ov-ý
luděk 	 luděk 	 luděk
lupa 	 lup-a 	 lup-a
léky 	 lék-y 	 lék-y
lékárně 	 lék-ár-n-ě 	 lék-ár-n-ě
léta 	 lét-a 	 lét-a
lóži 	 lóž-i 	 lóž-i
malém 	 mal-ém 	 mal-ém
manželů 	 manžel-ů 	 manžel-ů
marco 	 marc-o 	 marc-o
marrackův 	 marrack-ův 	 marrack-ův
maršrútu 	 maršrút-u 	 maršrút-u
masivní 	 mas-iv-n-í 	 mas-iv-n-í
mast 	 mast 	 mast
mašlí 	 mašl-í 	 mašl-í
meduňka 	 meduňk-a 	 meduňk-a
mekat 	 mek-a-t 	 mek-a-t
memnónovy 	 memnón-ov-y 	 memnón-ov-y
mepha 	 meph-a 	 meph-a
mezku 	 mezk-u 	 mezk-u
meč 	 meč 	 meč
meškat 	 mešk-a-t 	 mešk-a-t
mhouřit 	 mhouř-i-t 	 mhouř-i-t
mil 	 mil 	 mil
miliarda 	 miliard-a 	 miliard-a
milo 	 mil-o 	 mil-o
milování 	 mil-ová-n-í 	 mil-ová-n-í
milá 	 mil-á 	 mil-á
minerální 	 minerál-n-í 	 minerál-n-í
mixovat 	 mix-ova-t 	 mix-ova-t
mjasisčev 	 mjasisčev 	 mjasisčev
mladě 	 mlad-ě 	 mlad-ě
mlhy 	 mlh-y 	 mlh-y
mluvící 	 mluv-íc-í 	 mluv-íc-í
mládí 	 mlád-í 	 mlád-í
mlátí 	 mlát-í 	 mlát-í
mnohými 	 mnoh-ými 	 mnoh-ými
model 	 model 	 model
modrou 	 modr-ou 	 modr-ou
monument 	 monument 	 monument
moravského 	 morav-sk-ého 	 morav-sk-ého
more 	 more 	 more
motorových 	 motor-ov-ých 	 motor-ov-ých
motorů 	 motor-ů 	 motor-ů
movis 	 movis 	 movis
mužný 	 muž-n-ý 	 muž-n-ý
mužů 	 muž-ů 	 muž-ů
mykat 	 myk-a-t 	 myk-a-t
myslím 	 mysl-í-m 	 mysl-í-m
média 	 médi-a 	 médi-a
médií 	 médi-í 	 médi-í
míli 	 míl-i 	 míl-i
míra 	 mír-a 	 mír-a
místní 	 míst-n-í 	 míst-n-í
místných 	 míst-n-ých 	 míst-n-ých
míře 	 míř-e 	 míř-e
mířit 	 míř-i-t 	 míř-i-t
míří 	 míř-í 	 míř-í
mědit 	 měd-i-t 	 měd-i-t
městu 	 měst-u 	 měst-u
nabídnout 	 na-bíd-nou-t 	 na-bíd-nou-t
nacházet 	 na-cház-e-t 	 na-cház-e-t
nacpávat 	 na-cp-á-v-a-t 	 na-cp-á-v-a-t
nadbíhat 	 nad-bíh-a-t 	 nad-bíh-a-t
nadklánět 	 nad-klán-ě-t 	 nad-klán-ě-t
naflákat 	 na-flák-a-t 	 na-flák-a-t
nahlížíme 	 na-hlíž-í-me 	 na-hlíž-í-me
nahradit 	 na-hrad-i-t 	 na-hrad-i-t
nahrávat 	 na-hrá-v-a-t 	 na-hrá-v-a-t
nahřát 	 na-hřá-t 	 na-hřá-t
nakouřit 	 na-kouř-i-t 	 na-kouř-i-t
nakupit 	 na-kup-i-t 	 na-kup-i-t
nakřivovat 	 na-křiv-ova-t 	 na-křiv-ova-t
naleznout 	 na-lez-nou-t 	 na-lez-nou-t
naleštit 	 na-lešt-i-t 	 na-lešt-i-t
nalopotit 	 na-lopot-i-t 	 na-lopot-i-t
naloupat 	 na-loup-a-t 	 na-loup-a-t
namlouvat 	 na-mlouv-a-t 	 na-mlouv-a-t
namítá 	 na-mít-á 	 na-mít-á
napadat 	 na-pad-a-t 	 na-pad-a-t
naparádit 	 na-parád-i-t 	 na-parád-i-t
naplivnout 	 na-pliv-nou-t 	 na-pliv-nou-t
napojil 	 na-poj-i-l 	 na-poj-i-l
napočítal 	 na-po-čít-a-l 	 na-po-čít-a-l
napínalo 	 na-pín-a-l-o 	 na-pín-a-l-o
napěnit 	 na-pěn-i-t 	 na-pěn-i-t
narobit 	 na-rob-i-t 	 na-rob-i-t
narážím 	 na-ráž-í-m 	 na-ráž-í-m
nasekat 	 na-sek-a-t 	 na-sek-a-t
naskákat 	 na-skák-a-t 	 na-skák-a-t
naspořit 	 na-spoř-i-t 	 na-spoř-i-t
nastrouhat 	 na-strouh-a-t 	 na-strouh-a-t
nastrčil 	 na-strč-i-l 	 na-strč-i-l
natínat 	 na-tín-a-t 	 na-tín-a-t
navnadit 	 na-vnad-i-t 	 na-vnad-i-t
navolat 	 na-vol-a-t 	 na-vol-a-t
navozuje 	 na-voz-uje 	 na-voz-uje
navrtat 	 na-vrt-a-t 	 na-vrt-a-t
navrátit 	 na-vrát-i-t 	 na-vrát-i-t
navyknout 	 na-vyk-nou-t 	 na-vyk-nou-t
navyprávět 	 na-vy-práv-ě-t 	 na-vy-práv-ě-t
načesávat 	 na-čes-á-v-a-t 	 na-čes-á-v-a-t
nařezávat 	 na-řez-á-v-a-t 	 na-řez-á-v-a-t
naříci 	 na-říc-i 	 na-říc-i
našvihat 	 na-švih-a-t 	 na-švih-a-t
naťapat 	 na-ťap-a-t 	 na-ťap-a-t
neb 	 neb 	 neb
nechuť 	 ne-chuť 	 ne-chuť
nedutnout 	 ne-dut-nou-t 	 ne-dut-nou-t
negativními 	 negat-iv-n-ími 	 negat-iv-n-ími
nehmotného 	 ne-hmot-n-ého 	 ne-hmot-n-ého
nehty 	 neht-y 	 neht-y
nejlíp 	 nej-líp 	 nej-líp
nejméně 	 nej-mén-ě 	 nej-mén-ě
nekoupil 	 ne-koup-i-l 	 ne-koup-i-l
nelidské 	 ne-lid-sk-é 	 ne-lid-sk-é
nemluvně 	 ne-mluv-n-ě 	 ne-mluv-n-ě
nemocný 	 ne-moc-n-ý 	 ne-moc-n-ý
nemohli 	 ne-moh-l-i 	 ne-moh-l-i
nemožné 	 ne-mož-n-é 	 ne-mož-n-é
nenápadně 	 ne-ná-pad-n-ě 	 ne-ná-pad-n-ě
neplatila 	 ne-plat-i-l-a 	 ne-plat-i-l-a
nepobíral 	 ne-po-bír-a-l 	 ne-po-bír-a-l
nepodnikl 	 ne-pod-nik-l 	 ne-pod-nik-l
nepodpoří 	 ne-pod-poř-í 	 ne-pod-poř-í
nepohodnout 	 ne-po-hod-nou-t 	 ne-po-hod-nou-t
nepokusíte 	 ne-po-kus-í-te 	 ne-po-kus-í-te
nepolepší 	 ne-po-lep-š-í 	 ne-po-lep-š-í
nepomohou 	 ne-po-moh-ou 	 ne-po-moh-ou
neposlední 	 ne-po-sled-n-í 	 ne-po-sled-n-í
nepracoval 	 ne-prac-ova-l 	 ne-prac-ova-l
nepružné 	 ne-pruž-n-é 	 ne-pruž-n-é
nepřijdou 	 ne-při-jd-ou 	 ne-při-jd-ou
nepřikážu 	 ne-při-káž-u 	 ne-při-káž-u
nepřipraví 	 ne-při-prav-í 	 ne-při-prav-í
nesprávné 	 ne-s-práv-n-é 	 ne-s-práv-n-é
nevrátila 	 ne-vrát-i-l-a 	 ne-vrát-i-l-a
nevypařila 	 ne-vy-pař-i-l-a 	 ne-vy-pař-i-l-a
neváhají 	 ne-váh-aj-í 	 ne-váh-aj-í
nevážili 	 ne-váž-i-l-i 	 ne-váž-i-l-i
nezávislý 	 ne-zá-vis-l-ý 	 ne-zá-vis-l-ý
nezískáme 	 ne-získ-á-me 	 ne-získ-á-me
nečervená 	 ne-červen-á 	 ne-červen-á
neškodné 	 ne-škod-n-é 	 ne-škod-n-é
neštěstí 	 ne-štěst-í 	 ne-štěst-í
nocí 	 noc-í 	 noc-í
noetika 	 noet-ik-a 	 noet-ik-a
nohou 	 noh-ou 	 noh-ou
norbert 	 norbert 	 norbert
normovat 	 norm-ova-t 	 norm-ova-t
normám 	 norm-ám 	 norm-ám
nosaté 	 nos-at-é 	 nos-at-é
nová 	 nov-á 	 nov-á
novými 	 nov-ými 	 nov-ými
nula 	 nul-a 	 nul-a
nuly 	 nul-y 	 nul-y
nutným 	 nut-n-ým 	 nut-n-ým
nykláku 	 nyklák-u 	 nyklák-u
nymburka 	 nymburk-a 	 nymburk-a
nálady 	 ná-lad-y 	 ná-lad-y
náleží 	 ná-lež-í 	 ná-lež-í
nápadná 	 ná-pad-n-á 	 ná-pad-n-á
nápadný 	 ná-pad-n-ý 	 ná-pad-n-ý
nápady 	 ná-pad-y 	 ná-pad-y
návody 	 ná-vod-y 	 ná-vod-y
nítit 	 nít-i-t 	 nít-i-t
němá 	 něm-á 	 něm-á
němé 	 něm-é 	 něm-é
obchodníkův 	 ob-chod-ník-ův 	 ob-chod-ník-ův
obchodu 	 ob-chod-u 	 ob-chod-u
obcházet 	 ob-cház-e-t 	 ob-cház-e-t
obci 	 obc-i 	 obc-i
obdobné 	 ob-dob-n-é 	 ob-dob-n-é
oblizovat 	 ob-liz-ova-t 	 ob-liz-ova-t
obléknout 	 ob-lék-nou-t 	 ob-lék-nou-t
oblízat 	 ob-líz-a-t 	 ob-líz-a-t
obr 	 obr 	 obr
obrodit 	 ob-rod-i-t 	 ob-rod-i-t
obsahují 	 ob-sah-uj-í 	 ob-sah-uj-í
obsahující 	 ob-sah-uj-íc-í 	 ob-sah-uj-íc-í
obtisknout 	 ob-tisk-nou-t 	 ob-tisk-nou-t
obyčejné 	 obyčej-n-é 	 obyčej-n-é
obílit 	 o-bíl-i-t 	 o-bíl-i-t
oběda 	 oběd-a 	 oběd-a
oběsil 	 oběs-i-l 	 oběs-i-l
obětuje 	 obět-uje 	 obět-uje
obživit 	 ob-živ-i-t 	 ob-živ-i-t
ochrannému 	 o-chran-n-ému 	 o-chran-n-ému
ochraně 	 o-chran-ě 	 o-chran-ě
odbelhávat 	 od-belh-á-v-a-t 	 od-belh-á-v-a-t
odborném 	 od-bor-n-ém 	 od-bor-n-ém
odchlípnout 	 od-chlíp-nou-t 	 od-chlíp-nou-t
odchvátat 	 od-chvát-a-t 	 od-chvát-a-t
odcházet 	 od-cház-e-t 	 od-cház-e-t
odchází 	 od-cház-í 	 od-cház-í
odcválat 	 od-cvál-a-t 	 od-cvál-a-t
odkapat 	 od-kap-a-t 	 od-kap-a-t
odklusat 	 od-klus-a-t 	 od-klus-a-t
odkopnout 	 od-kop-nou-t 	 od-kop-nou-t
odkopávat 	 od-kop-á-v-a-t 	 od-kop-á-v-a-t
odloupat 	 od-loup-a-t 	 od-loup-a-t
odloupávat 	 od-loup-á-v-a-t 	 od-loup-á-v-a-t
odloženou 	 od-lož-en-ou 	 od-lož-en-ou
odložení 	 od-lož-en-í 	 od-lož-en-í
odmalička 	 od-mal-ičk-a 	 od-mal-ičk-a
odmítnout 	 od-mít-nou-t 	 od-mít-nou-t
odměňujeme 	 od-měň-uje-me 	 od-měň-uje-me
odměřovat 	 od-měř-ova-t 	 od-měř-ova-t
odpisovaného 	 od-pis-ova-n-ého 	 od-pis-ova-n-ého
odpovídat 	 od-po-víd-a-t 	 od-po-víd-a-t
odpovědnost 	 od-po-věd-n-ost 	 od-po-věd-n-ost
odpřáhnout 	 od-přáh-nou-t 	 od-přáh-nou-t
odrazuje 	 od-raz-uje 	 od-raz-uje
odsouvací 	 od-souv-a-c-í 	 od-souv-a-c-í
odspěchat 	 od-spěch-a-t 	 od-spěch-a-t
odsrkávat 	 od-srk-á-v-a-t 	 od-srk-á-v-a-t
odstranit 	 od-stran-i-t 	 od-stran-i-t
odstrkávat 	 od-strk-á-v-a-t 	 od-strk-á-v-a-t
odstříknout 	 od-střík-nou-t 	 od-střík-nou-t
odsunovat 	 od-sun-ova-t 	 od-sun-ova-t
odtrhat 	 od-trh-a-t 	 od-trh-a-t
odtrhávat 	 od-trh-á-v-a-t 	 od-trh-á-v-a-t
odvařit 	 od-vař-i-t 	 od-vař-i-t
odvedeného 	 od-ved-en-ého 	 od-ved-en-ého
odvelet 	 od-vel-e-t 	 od-vel-e-t
odříkat 	 od-řík-a-t 	 od-řík-a-t
odštěpovat 	 od-štěp-ova-t 	 od-štěp-ova-t
oh 	 oh 	 oh
ohluchnout 	 o-hluch-nou-t 	 o-hluch-nou-t
ohlušit 	 o-hluš-i-t 	 o-hluš-i-t
ohromně 	 o-hrom-n-ě 	 o-hrom-n-ě
oken 	 oken 	 oken
okrajovým 	 o-kraj-ov-ým 	 o-kraj-ov-ým
okresní 	 okres-n-í 	 okres-n-í
okrádal 	 o-krád-a-l 	 o-krád-a-l
olfen 	 olfen 	 olfen
omílat 	 o-míl-a-t 	 o-míl-a-t
opadávat 	 o-pad-á-v-a-t 	 o-pad-á-v-a-t
operacích 	 oper-ac-ích 	 oper-ac-ích
oplakávat 	 o-plak-á-v-a-t 	 o-plak-á-v-a-t
opláknout 	 o-plák-nou-t 	 o-plák-nou-t
opršet 	 o-prš-e-t 	 o-prš-e-t
organismus 	 organismus 	 organismus
orijentovaná 	 orijent-ova-n-á 	 orijent-ova-n-á
orlí 	 orl-í 	 orl-í
orážet 	 o-ráž-e-t 	 o-ráž-e-t
osazovat 	 o-saz-ova-t 	 o-saz-ova-t
osekat 	 o-sek-a-t 	 o-sek-a-t
osekávat 	 o-sek-á-v-a-t 	 o-sek-á-v-a-t
oskar 	 oskar 	 oskar
oslabit 	 o-slab-i-t 	 o-slab-i-t
oslepit 	 o-slep-i-t 	 o-slep-i-t
ostravské 	 ostrav-sk-é 	 ostrav-sk-é
ostravy 	 ostrav-y 	 ostrav-y
osušovanost 	 o-suš-ova-n-ost 	 o-suš-ova-n-ost
osvěcovat 	 o-svěc-ova-t 	 o-svěc-ova-t
osvědčovat 	 o-svědč-ova-t 	 o-svědč-ova-t
otravovat 	 o-trav-ova-t 	 o-trav-ova-t
ovládnout 	 o-vlád-nou-t 	 o-vlád-nou-t
ověřit 	 o-věř-i-t 	 o-věř-i-t
oznobovat 	 o-znob-ova-t 	 o-znob-ova-t
očekávají 	 o-ček-á-v-aj-í 	 o-ček-á-v-aj-í
očíslit 	 o-čísl-i-t 	 o-čísl-i-t
očíslovat 	 o-čísl-ova-t 	 o-čísl-ova-t
oškrabat 	 o-škrab-a-t 	 o-škrab-a-t
ožvykovat 	 o-žvyk-ova-t 	 o-žvyk-ova-t
padly 	 pad-l-y 	 pad-l-y
paláci 	 palác-i 	 palác-i
parodovat 	 parod-ova-t 	 parod-ova-t
pas 	 pas 	 pas
patlat 	 patl-a-t 	 patl-a-t
patřil 	 patř-i-l 	 patř-i-l
pavel 	 pavel 	 pavel
pavlačí 	 pavlač-í 	 pavlač-í
pařit 	 pař-i-t 	 pař-i-t
paříž 	 paříž 	 paříž
pelichat 	 pelich-a-t 	 pelich-a-t
peníz 	 peníz 	 peníz
perly 	 perl-y 	 perl-y
perunovy 	 perun-ov-y 	 perun-ov-y
pestrý 	 pestr-ý 	 pestr-ý
pestřit 	 pestř-i-t 	 pestř-i-t
pečiva 	 peč-iv-a 	 peč-iv-a
pečivo 	 peč-iv-o 	 peč-iv-o
peřině 	 peř-in-ě 	 peř-in-ě
piston 	 piston 	 piston
pižlat 	 pižl-a-t 	 pižl-a-t
placení 	 plac-en-í 	 plac-en-í
platné 	 plat-n-é 	 plat-n-é
plavky 	 plav-k-y 	 plav-k-y
plemenit 	 plemen-i-t 	 plemen-i-t
plesknout 	 plesk-nou-t 	 plesk-nou-t
plisovat 	 plis-ova-t 	 plis-ova-t
plivat 	 pliv-a-t 	 pliv-a-t
plnou 	 pln-ou 	 pln-ou
plochy 	 ploch-y 	 ploch-y
plyn 	 plyn 	 plyn
plácající 	 plác-aj-íc-í 	 plác-aj-íc-í
plánech 	 plán-ech 	 plán-ech
plánu 	 plán-u 	 plán-u
plátcem 	 plát-c-em 	 plát-c-em
plátci 	 plát-c-i 	 plát-c-i
plíce 	 plíc-e 	 plíc-e
plínku 	 plín-k-u 	 plín-k-u
pobídnout 	 po-bíd-nou-t 	 po-bíd-nou-t
pobíjet 	 po-bíj-e-t 	 po-bíj-e-t
pobírali 	 po-bír-a-l-i 	 po-bír-a-l-i
pochutnal 	 po-chut-n-a-l 	 po-chut-n-a-l
pochutnatelný 	 po-chut-n-a-teln-ý 	 po-chut-n-a-teln-ý
pochyba 	 po-chyb-a 	 po-chyb-a
pochytávat 	 po-chyt-á-v-a-t 	 po-chyt-á-v-a-t
pochází 	 po-cház-í 	 po-cház-í
pocházím 	 po-cház-í-m 	 po-cház-í-m
poddolovat 	 pod-dol-ova-t 	 pod-dol-ova-t
podléhat 	 pod-léh-a-t 	 pod-léh-a-t
podmínit 	 pod-mín-i-t 	 pod-mín-i-t
podmítnout 	 pod-mít-nou-t 	 pod-mít-nou-t
podnětu 	 pod-nět-u 	 pod-nět-u
podupávat 	 po-dup-á-v-a-t 	 po-dup-á-v-a-t
podvazovat 	 pod-vaz-ova-t 	 pod-vaz-ova-t
podílíte 	 po-díl-í-te 	 po-díl-í-te
podřazovat 	 pod-řaz-ova-t 	 pod-řaz-ova-t
podřeknout 	 pod-řek-nou-t 	 pod-řek-nou-t
pohlídnout 	 po-hlíd-nou-t 	 po-hlíd-nou-t
pohlíželo 	 po-hlíž-e-l-o 	 po-hlíž-e-l-o
pohlíží 	 po-hlíž-í 	 po-hlíž-í
pohryzovat 	 po-hryz-ova-t 	 po-hryz-ova-t
pohyboval 	 po-hyb-ova-l 	 po-hyb-ova-l
pohřešit 	 po-hřeš-i-t 	 po-hřeš-i-t
pojídat 	 po-jíd-a-t 	 po-jíd-a-t
pojímání 	 po-jím-á-n-í 	 po-jím-á-n-í
pokladny 	 po-klad-n-y 	 po-klad-n-y
poklepat 	 po-klep-a-t 	 po-klep-a-t
poklesnout 	 po-kles-nou-t 	 po-kles-nou-t
pokosit 	 po-kos-i-t 	 po-kos-i-t
pokračoval 	 po-krač-ova-l 	 po-krač-ova-l
pokračování 	 po-krač-ová-n-í 	 po-krač-ová-n-í
pokroutit 	 po-krout-i-t 	 po-krout-i-t
pokusit 	 po-kus-i-t 	 po-kus-i-t
pokývat 	 po-kýv-a-t 	 po-kýv-a-t
položil 	 po-lož-i-l 	 po-lož-i-l
polských 	 pol-sk-ých 	 pol-sk-ých
pomazat 	 po-maz-a-t 	 po-maz-a-t
pomlaskávat 	 po-mlask-á-v-a-t 	 po-mlask-á-v-a-t
pomodlil 	 po-modl-i-l 	 po-modl-i-l
pomokřit 	 po-mokř-i-t 	 po-mokř-i-t
pomýlit 	 po-mýl-i-t 	 po-mýl-i-t
ponížit 	 po-níž-i-t 	 po-níž-i-t
poplatníka 	 po-plat-ník-a 	 po-plat-ník-a
poplivat 	 po-pliv-a-t 	 po-pliv-a-t
popoběhnout 	 po-po-běh-nou-t 	 po-po-běh-nou-t
poprašovat 	 po-praš-ova-t 	 po-praš-ova-t
popálil 	 po-pál-i-l 	 po-pál-i-l
popálit 	 po-pál-i-t 	 po-pál-i-t
porculánu 	 porculán-u 	 porculán-u
poroučím 	 po-rouč-í-m 	 po-rouč-í-m
porubat 	 po-rub-a-t 	 po-rub-a-t
poskočit 	 po-skoč-i-t 	 po-skoč-i-t
posolit 	 po-sol-i-t 	 po-sol-i-t
pospícháme 	 po-spích-á-me 	 po-spích-á-me
postačit 	 po-stač-i-t 	 po-stač-i-t
postupně 	 po-stup-n-ě 	 po-stup-n-ě
postupů 	 po-stup-ů 	 po-stup-ů
postávalo 	 po-stá-v-a-l-o 	 po-stá-v-a-l-o
posuzování 	 po-suz-ová-n-í 	 po-suz-ová-n-í
posuzuje 	 po-suz-uje 	 po-suz-uje
posvítila 	 po-svít-i-l-a 	 po-svít-i-l-a
posílení 	 po-síl-en-í 	 po-síl-en-í
posílá 	 po-síl-á 	 po-síl-á
posýpat 	 po-sýp-a-t 	 po-sýp-a-t
potraviny 	 po-trav-in-y 	 po-trav-in-y
potrhnout 	 po-trh-nou-t 	 po-trh-nou-t
potěšení 	 po-těš-en-í 	 po-těš-en-í
potěšit 	 po-těš-i-t 	 po-těš-i-t
potřební 	 po-třeb-n-í 	 po-třeb-n-í
potřebných 	 po-třeb-n-ých 	 po-třeb-n-ých
poulit 	 poul-i-t 	 poul-i-t
povinny 	 po-vin-n-y 	 po-vin-n-y
povléci 	 po-vléc-i 	 po-vléc-i
povolená 	 po-vol-en-á 	 po-vol-en-á
povolují 	 po-vol-uj-í 	 po-vol-uj-í
povážíme 	 po-váž-í-me 	 po-váž-í-me
povídka 	 po-víd-k-a 	 po-víd-k-a
pověste 	 po-věs-te 	 po-věs-te
pověsíme 	 po-věs-í-me 	 po-věs-í-me
pozamykat 	 po-za-myk-a-t 	 po-za-myk-a-t
pozdní 	 pozd-n-í 	 pozd-n-í
pozitivně 	 pozit-iv-n-ě 	 pozit-iv-n-ě
počestná 	 po-čest-n-á 	 po-čest-n-á
počistit 	 po-čist-i-t 	 po-čist-i-t
počárat 	 po-čár-a-t 	 po-čár-a-t
počíhat 	 po-číh-a-t 	 po-číh-a-t
počítají 	 po-čít-aj-í 	 po-čít-aj-í
počítalo 	 po-čít-a-l-o 	 po-čít-a-l-o
pořádně 	 po-řád-n-ě 	 po-řád-n-ě
pořádání 	 po-řád-á-n-í 	 po-řád-á-n-í
pošlapávat 	 po-šlap-á-v-a-t 	 po-šlap-á-v-a-t
poštu 	 pošt-u 	 pošt-u
poštípat 	 po-štíp-a-t 	 po-štíp-a-t
požádali 	 po-žád-a-l-i 	 po-žád-a-l-i
pragmatism 	 pragm-at-ism 	 pragm-at-ism
prajzler 	 prajzler 	 prajzler
prasknout 	 prask-nou-t 	 prask-nou-t
pravd 	 prav-d 	 prav-d
pravdy 	 prav-d-y 	 prav-d-y
praví 	 prav-í 	 prav-í
pravý 	 prav-ý 	 prav-ý
praxí 	 prax-í 	 prax-í
pražského 	 praž-sk-ého 	 praž-sk-ého
premií 	 prem-i-í 	 prem-i-í
press 	 press 	 press
previtský 	 previt-sk-ý 	 previt-sk-ý
prodlužit 	 pro-dluž-i-t 	 pro-dluž-i-t
produkty 	 pro-dukt-y 	 pro-dukt-y
prodávám 	 pro-d-á-v-á-m 	 pro-d-á-v-á-m
prodělat 	 pro-děl-a-t 	 pro-děl-a-t
proděláme 	 pro-děl-á-me 	 pro-děl-á-me
proděravět 	 pro-děr-av-ě-t 	 pro-děr-av-ě-t
proflákat 	 pro-flák-a-t 	 pro-flák-a-t
profoukávat 	 pro-fouk-á-v-a-t 	 pro-fouk-á-v-a-t
prohlížet 	 pro-hlíž-e-t 	 pro-hlíž-e-t
prohrabat 	 pro-hrab-a-t 	 pro-hrab-a-t
projekt 	 pro-jekt 	 pro-jekt
prokazují 	 pro-kaz-uj-í 	 pro-kaz-uj-í
prokopávat 	 pro-kop-á-v-a-t 	 pro-kop-á-v-a-t
prokrvit 	 pro-krv-i-t 	 pro-krv-i-t
prolamovat 	 pro-lam-ova-t 	 pro-lam-ova-t
prolévat 	 pro-lé-v-a-t 	 pro-lé-v-a-t
prolívat 	 pro-lí-v-a-t 	 pro-lí-v-a-t
promýkat 	 pro-mýk-a-t 	 pro-mýk-a-t
propad 	 pro-pad 	 pro-pad
propadl 	 pro-pad-l 	 pro-pad-l
proplout 	 pro-plou-t 	 pro-plou-t
prorážet 	 pro-ráž-e-t 	 pro-ráž-e-t
prosekat 	 pro-sek-a-t 	 pro-sek-a-t
prosimás 	 prosimás 	 prosimás
prostou 	 prost-ou 	 prost-ou
prostějově 	 prostějov-ě 	 prostějov-ě
prosířit 	 pro-síř-i-t 	 pro-síř-i-t
prosýpat 	 pro-sýp-a-t 	 pro-sýp-a-t
protahuje 	 pro-tah-uje 	 pro-tah-uje
protokol 	 protokol 	 protokol
protrhat 	 pro-trh-a-t 	 pro-trh-a-t
provedeny 	 pro-ved-en-y 	 pro-ved-en-y
provléci 	 pro-vléc-i 	 pro-vléc-i
provozních 	 pro-voz-n-ích 	 pro-voz-n-ích
provozoval 	 pro-voz-ova-l 	 pro-voz-ova-l
provádíte 	 pro-vád-í-te 	 pro-vád-í-te
provádějí 	 pro-vád-ěj-í 	 pro-vád-ěj-í
prozařovat 	 pro-zař-ova-t 	 pro-zař-ova-t
prožívat 	 pro-ží-v-a-t 	 pro-ží-v-a-t
pruhovat 	 pruh-ova-t 	 pruh-ova-t
prvém 	 prv-ém 	 prv-ém
pryč 	 pryč 	 pryč
pryčně 	 pryč-n-ě 	 pryč-n-ě
práv 	 práv 	 práv
právních 	 práv-n-ích 	 práv-n-ích
právního 	 práv-n-ího 	 práv-n-ího
právo 	 práv-o 	 práv-o
prázdné 	 prázdn-é 	 prázdn-é
prýsknout 	 prýsk-nou-t 	 prýsk-nou-t
průkazky 	 prů-kaz-k-y 	 prů-kaz-k-y
publikací 	 publik-ac-í 	 publik-ac-í
pulsovat 	 puls-ova-t 	 puls-ova-t
pumpnout 	 pump-nou-t 	 pump-nou-t
purple 	 purple 	 purple
pustit 	 pust-i-t 	 pust-i-t
pustí 	 pust-í 	 pust-í
pusť 	 pusť 	 pusť
páchat 	 pách-a-t 	 pách-a-t
pán 	 pán 	 pán
pánové 	 pán-ové 	 pán-ové
párovat 	 pár-ova-t 	 pár-ova-t
pásci 	 pásc-i 	 pásc-i
páté 	 pát-é 	 pát-é
páčit 	 páč-i-t 	 páč-i-t
písknout 	 písk-nou-t 	 písk-nou-t
pódiem 	 pódi-em 	 pódi-em
pódiu 	 pódi-u 	 pódi-u
pěkné 	 pěkn-é 	 pěkn-é
pěst 	 pěst 	 pěst
pěstit 	 pěst-i-t 	 pěst-i-t
pětník 	 pět-ník 	 pět-ník
přeceňovat 	 pře-ceň-ova-t 	 pře-ceň-ova-t
přechodná 	 pře-chod-n-á 	 pře-chod-n-á
předložit 	 před-lož-i-t 	 před-lož-i-t
předměty 	 před-mět-y 	 před-mět-y
předmětů 	 před-mět-ů 	 před-mět-ů
předpisů 	 před-pis-ů 	 před-pis-ů
představ 	 před-stav 	 před-stav
představy 	 před-stav-y 	 před-stav-y
přehazoval 	 pře-haz-ova-l 	 pře-haz-ova-l
přehazovat 	 pře-haz-ova-t 	 pře-haz-ova-t
přehlédl 	 pře-hléd-l 	 pře-hléd-l
přehrada 	 pře-hrad-a 	 pře-hrad-a
překacovat 	 pře-kac-ova-t 	 pře-kac-ova-t
překladatel 	 pře-klad-a-tel 	 pře-klad-a-tel
překlonit 	 pře-klon-i-t 	 pře-klon-i-t
překonávat 	 pře-kon-á-v-a-t 	 pře-kon-á-v-a-t
překvapíme 	 pře-kvap-í-me 	 pře-kvap-í-me
přelhat 	 pře-lh-a-t 	 pře-lh-a-t
přemalovat 	 pře-mal-ova-t 	 pře-mal-ova-t
přemotávat 	 pře-mot-á-v-a-t 	 pře-mot-á-v-a-t
přemístit 	 pře-míst-i-t 	 pře-míst-i-t
přesedět 	 pře-sed-ě-t 	 pře-sed-ě-t
přesléchat 	 pře-sléch-a-t 	 pře-sléch-a-t
přesnost 	 přesn-ost 	 přesn-ost
přesností 	 přesn-ost-í 	 přesn-ost-í
přesunovat 	 pře-sun-ova-t 	 pře-sun-ova-t
přesýpat 	 pře-sýp-a-t 	 pře-sýp-a-t
přetrhnout 	 pře-trh-nou-t 	 pře-trh-nou-t
převléknout 	 pře-vlék-nou-t 	 pře-vlék-nou-t
převlíkat 	 pře-vlík-a-t 	 pře-vlík-a-t
převodem 	 pře-vod-em 	 pře-vod-em
převádět 	 pře-vád-ě-t 	 pře-vád-ě-t
převázat 	 pře-váz-a-t 	 pře-váz-a-t
převážně 	 pře-váž-n-ě 	 pře-váž-n-ě
převívat 	 pře-ví-v-a-t 	 pře-ví-v-a-t
přeříkávat 	 pře-řík-á-v-a-t 	 pře-řík-á-v-a-t
přibírat 	 při-bír-a-t 	 při-bír-a-t
přihýbat 	 při-hýb-a-t 	 při-hýb-a-t
přijechat 	 při-jech-a-t 	 při-jech-a-t
přijuchat 	 při-juch-a-t 	 při-juch-a-t
přiklapnout 	 při-klap-nou-t 	 při-klap-nou-t
přiláká 	 při-lák-á 	 při-lák-á
přilétávat 	 při-lét-á-v-a-t 	 při-lét-á-v-a-t
přilézt 	 při-léz-t 	 při-léz-t
přimáznout 	 při-máz-nou-t 	 při-máz-nou-t
přiměšovat 	 při-měš-ova-t 	 při-měš-ova-t
připadne 	 při-pad-ne 	 při-pad-ne
připřáhnout 	 při-přáh-nou-t 	 při-přáh-nou-t
přirazit 	 při-raz-i-t 	 při-raz-i-t
přisýpat 	 při-sýp-a-t 	 při-sýp-a-t
přivařit 	 při-vař-i-t 	 při-vař-i-t
přivážet 	 při-váž-e-t 	 při-váž-e-t
přičinění 	 při-čin-ěn-í 	 při-čin-ěn-í
přičouditelný 	 při-čoud-i-teln-ý 	 při-čoud-i-teln-ý
přiživit 	 při-živ-i-t 	 při-živ-i-t
přiživovat 	 při-živ-ova-t 	 při-živ-ova-t
přižínat 	 při-žín-a-t 	 při-žín-a-t
přání 	 přá-n-í 	 přá-n-í
příchod 	 pří-chod 	 pří-chod
případné 	 pří-pad-n-é 	 pří-pad-n-é
případu 	 pří-pad-u 	 pří-pad-u
přístřeší 	 pří-střeš-í 	 pří-střeš-í
příštím 	 příšt-ím 	 příšt-ím
příště 	 příšt-ě 	 příšt-ě
půdní 	 půd-n-í 	 půd-n-í
půdu 	 půd-u 	 půd-u
půjčte 	 půjč-te 	 půjč-te
québec 	 québec 	 québec
rada 	 rad-a 	 rad-a
radu 	 rad-u 	 rad-u
raketu 	 raket-u 	 raket-u
rallye 	 rallye 	 rallye
rasy 	 ras-y 	 ras-y
ravaissona 	 ravaisson-a 	 ravaisson-a
razit 	 raz-i-t 	 raz-i-t
redakční 	 redakč-n-í 	 redakč-n-í
regulovat 	 regul-ova-t 	 regul-ova-t
regály 	 regál-y 	 regál-y
rejda 	 rejd-a 	 rejd-a
rejha 	 rejh-a 	 rejh-a
rekord 	 rekord 	 rekord
republikou 	 republik-ou 	 republik-ou
resp 	 resp 	 resp
reálné 	 reál-n-é 	 reál-n-é
rigolovat 	 rigol-ova-t 	 rigol-ova-t
rodinný 	 rod-in-n-ý 	 rod-in-n-ý
rodí 	 rod-í 	 rod-í
roh 	 roh 	 roh
rojit 	 roj-i-t 	 roj-i-t
roky 	 rok-y 	 rok-y
rozběhnout 	 roz-běh-nou-t 	 roz-běh-nou-t
rozchodit 	 roz-chod-i-t 	 roz-chod-i-t
rozdivit 	 roz-div-i-t 	 roz-div-i-t
rozdrolit 	 roz-drol-i-t 	 roz-drol-i-t
rozdrtit 	 roz-drt-i-t 	 roz-drt-i-t
rozdávat 	 roz-d-á-v-a-t 	 roz-d-á-v-a-t
rozdíly 	 roz-díl-y 	 roz-díl-y
rozdělovat 	 roz-děl-ova-t 	 roz-děl-ova-t
rozehřívat 	 roze-hří-v-a-t 	 roze-hří-v-a-t
rozeskupit 	 roze-skup-i-t 	 roze-skup-i-t
rozestírat 	 roze-stír-a-t 	 roze-stír-a-t
rozhazovat 	 roz-haz-ova-t 	 roz-haz-ova-t
rozhlas 	 roz-hlas 	 roz-hlas
rozhled 	 roz-hled 	 roz-hled
rozhostit 	 roz-host-i-t 	 roz-host-i-t
rozhovoru 	 roz-hovor-u 	 roz-hovor-u
rozhozený 	 roz-hoz-en-ý 	 roz-hoz-en-ý
rozhýbat 	 roz-hýb-a-t 	 roz-hýb-a-t
rozjásat 	 roz-jás-a-t 	 roz-jás-a-t
rozkazovat 	 roz-kaz-ova-t 	 roz-kaz-ova-t
rozkazu 	 roz-kaz-u 	 roz-kaz-u
rozkloktat 	 roz-klokt-a-t 	 roz-klokt-a-t
rozklížit 	 roz-klíž-i-t 	 roz-klíž-i-t
rozkmotřit 	 roz-kmotř-i-t 	 roz-kmotř-i-t
rozkopávat 	 roz-kop-á-v-a-t 	 roz-kop-á-v-a-t
rozkoukávat 	 roz-kouk-á-v-a-t 	 roz-kouk-á-v-a-t
rozleptávat 	 roz-lept-á-v-a-t 	 roz-lept-á-v-a-t
rozlišovat 	 roz-liš-ova-t 	 roz-liš-ova-t
rozložit 	 roz-lož-i-t 	 roz-lož-i-t
rozluky 	 roz-luk-y 	 roz-luk-y
rozluštit 	 roz-lušt-i-t 	 roz-lušt-i-t
rozléhá 	 roz-léh-á 	 roz-léh-á
rozmrzávat 	 roz-mrz-á-v-a-t 	 roz-mrz-á-v-a-t
roznýtovat 	 roz-nýt-ova-t 	 roz-nýt-ova-t
rozpažit 	 roz-paž-i-t 	 roz-paž-i-t
rozporů 	 roz-por-ů 	 roz-por-ů
rozpíjet 	 roz-píj-e-t 	 roz-píj-e-t
rozsáhlou 	 roz-sáh-l-ou 	 roz-sáh-l-ou
rozsáhlý 	 roz-sáh-l-ý 	 roz-sáh-l-ý
roztavit 	 roz-tav-i-t 	 roz-tav-i-t
roztroubit 	 roz-troub-i-t 	 roz-troub-i-t
roztáhnout 	 roz-táh-nou-t 	 roz-táh-nou-t
roztávat 	 roz-tá-v-a-t 	 roz-tá-v-a-t
rozumí 	 roz-um-í 	 roz-um-í
rozvlňovat 	 roz-vlň-ova-t 	 roz-vlň-ova-t
rozvážil 	 roz-váž-i-l 	 roz-váž-i-l
rozvážně 	 roz-váž-n-ě 	 roz-váž-n-ě
rozvíjí 	 roz-víj-í 	 roz-víj-í
rozvěšovat 	 roz-věš-ova-t 	 roz-věš-ova-t
rozčesat 	 roz-čes-a-t 	 roz-čes-a-t
rozředit 	 roz-řed-i-t 	 roz-řed-i-t
rozškvařit 	 roz-škvař-i-t 	 roz-škvař-i-t
rozšít 	 roz-ší-t 	 roz-ší-t
rozšíření 	 roz-šíř-en-í 	 roz-šíř-en-í
rozžhavil 	 roz-žh-av-i-l 	 roz-žh-av-i-l
rozžvýkat 	 roz-žvýk-a-t 	 roz-žvýk-a-t
ruka 	 ruk-a 	 ruk-a
ruku 	 ruk-u 	 ruk-u
russel 	 russel 	 russel
rád 	 rád 	 rád
rádi 	 rád-i 	 rád-i
rána 	 rán-a 	 rán-a
ráno 	 rán-o 	 rán-o
různě 	 různ-ě 	 různ-ě
růže 	 růž-e 	 růž-e
salutovat 	 salut-ova-t 	 salut-ova-t
samsung 	 samsung 	 samsung
samá 	 sam-á 	 sam-á
sbíhat 	 s-bíh-a-t 	 s-bíh-a-t
schválit 	 s-chvál-i-t 	 s-chvál-i-t
scéna 	 scén-a 	 scén-a
sedmé 	 sedm-é 	 sedm-é
seger 	 seger 	 seger
server 	 server 	 server
sestrkávat 	 se-strk-á-v-a-t 	 se-strk-á-v-a-t
sestříhat 	 se-stříh-a-t 	 se-stříh-a-t
sešmajdat 	 se-šmajd-a-t 	 se-šmajd-a-t
shladit 	 s-hlad-i-t 	 s-hlad-i-t
shlídnout 	 s-hlíd-nou-t 	 s-hlíd-nou-t
silence 	 silence 	 silence
sir 	 sir 	 sir
sklouznout 	 s-klouz-nou-t 	 s-klouz-nou-t
skrápnout 	 s-kráp-nou-t 	 s-kráp-nou-t
skáče 	 skáč-e 	 skáč-e
skříní 	 skřín-í 	 skřín-í
skřípět 	 skříp-ě-t 	 skříp-ě-t
skříň 	 skříň 	 skříň
sladovat 	 slad-ova-t 	 slad-ova-t
slastí 	 slast-í 	 slast-í
slavnostně 	 slav-n-ost-n-ě 	 slav-n-ost-n-ě
sledování 	 sled-ová-n-í 	 sled-ová-n-í
slepou 	 slep-ou 	 slep-ou
slota 	 slot-a 	 slot-a
sloupy 	 sloup-y 	 sloup-y
slovní 	 slov-n-í 	 slov-n-í
slovník 	 slov-n-ík 	 slov-n-ík
slunce 	 slun-c-e 	 slun-c-e
sluncí 	 slun-c-í 	 slun-c-í
slunit 	 slun-i-t 	 slun-i-t
slušné 	 sluš-n-é 	 sluš-n-é
slyšet 	 slyš-e-t 	 slyš-e-t
smaragdy 	 smaragd-y 	 smaragd-y
smetanový 	 smetan-ov-ý 	 smetan-ov-ý
směl 	 smě-l 	 smě-l
směšný 	 směš-n-ý 	 směš-n-ý
snah 	 snah 	 snah
snídaně 	 s-níd-a-n-ě 	 s-níd-a-n-ě
sníh 	 sníh 	 sníh
sobotu 	 sobot-u 	 sobot-u
solidnost 	 solid-n-ost 	 solid-n-ost
solidní 	 solid-n-í 	 solid-n-í
soudním 	 soud-n-ím 	 soud-n-ím
soustředit 	 sou-střed-i-t 	 sou-střed-i-t
současným 	 sou-čas-n-ým 	 sou-čas-n-ým
soužit 	 souž-i-t 	 souž-i-t
species 	 species 	 species
sportovní 	 sport-ov-n-í 	 sport-ov-n-í
sprchnout 	 s-prch-nou-t 	 s-prch-nou-t
správních 	 s-práv-n-ích 	 s-práv-n-ích
spřahovat 	 s-přah-ova-t 	 s-přah-ova-t
srna 	 srn-a 	 srn-a
stabilní 	 stabil-n-í 	 stabil-n-í
stadionu 	 stadion-u 	 stadion-u
stagnuje 	 stagn-uje 	 stagn-uje
starostí 	 star-ost-í 	 star-ost-í
start 	 start 	 start
staré 	 star-é 	 star-é
stačilo 	 stač-i-l-o 	 stač-i-l-o
steward 	 steward 	 steward
stojaté 	 stoj-at-é 	 stoj-at-é
stopy 	 stop-y 	 stop-y
stornovat 	 storn-ova-t 	 storn-ova-t
stoupnout 	 stoup-nou-t 	 stoup-nou-t
stoupněte 	 stoup-ně-te 	 stoup-ně-te
strahov 	 strahov 	 strahov
stran 	 stran 	 stran
straší 	 straš-í 	 straš-í
strong 	 strong 	 strong
strčit 	 strč-i-t 	 strč-i-t
stuart 	 stuart 	 stuart
studijních 	 stud-ij-n-ích 	 stud-ij-n-ích
studiu 	 stud-i-u 	 stud-i-u
studovaný 	 stud-ova-n-ý 	 stud-ova-n-ý
studuje 	 stud-uje 	 stud-uje
stupni 	 stup-n-i 	 stup-n-i
stydět 	 styd-ě-t 	 styd-ě-t
stál 	 stá-l 	 stá-l
stálý 	 stál-ý 	 stál-ý
stát 	 stá-t 	 stá-t
stínit 	 stín-i-t 	 stín-i-t
stříbrné 	 stříbr-n-é 	 stříbr-n-é
střílí 	 stříl-í 	 stříl-í
stůl 	 stůl 	 stůl
svalovou 	 sval-ov-ou 	 sval-ov-ou
svetr 	 svetr 	 svetr
svítí 	 svít-í 	 svít-í
světský 	 svět-sk-ý 	 svět-sk-ý
symbol 	 symbol 	 symbol
sypou 	 syp-ou 	 syp-ou
síci 	 síc-i 	 síc-i
sílu 	 síl-u 	 síl-u
sýra 	 sýr-a 	 sýr-a
tablety 	 tablet-y 	 tablet-y
tančit 	 tanč-i-t 	 tanč-i-t
tasit 	 tas-i-t 	 tas-i-t
technologického 	 techn-o-log-ick-ého 	 techn-o-log-ick-ého
televize 	 televize 	 televize
tepichy 	 tepich-y 	 tepich-y
textu 	 text-u 	 text-u
tezi 	 tez-i 	 tez-i
tip 	 tip 	 tip
tips 	 tips 	 tips
tipy 	 tip-y 	 tip-y
tisk 	 tisk 	 tisk
tisknou 	 tisk-n-ou 	 tisk-n-ou
tiskárnu 	 tisk-árn-u 	 tisk-árn-u
tomáš 	 tomáš 	 tomáš
topilo 	 top-i-l-o 	 top-i-l-o
tops 	 tops 	 tops
toužit 	 touž-i-t 	 touž-i-t
tradovat 	 trad-ova-t 	 trad-ova-t
traktorů 	 traktor-ů 	 traktor-ů
trans 	 trans 	 trans
trní 	 trn-í 	 trn-í
tropickém 	 trop-ick-ém 	 trop-ick-ém
tropy 	 trop-y 	 trop-y
troufat 	 trouf-a-t 	 trouf-a-t
trysknout 	 trysk-nou-t 	 trysk-nou-t
trůnu 	 trůn-u 	 trůn-u
tržním 	 trž-n-ím 	 trž-n-ím
tuhého 	 tuh-ého 	 tuh-ého
tuky 	 tuk-y 	 tuk-y
tulit 	 tul-i-t 	 tul-i-t
tupit 	 tup-i-t 	 tup-i-t
tupě 	 tup-ě 	 tup-ě
turci 	 turc-i 	 turc-i
turek 	 turek 	 turek
tušící 	 tuš-íc-í 	 tuš-íc-í
tvor 	 tvor 	 tvor
tvořil 	 tvoř-i-l 	 tvoř-i-l
tvořily 	 tvoř-i-l-y 	 tvoř-i-l-y
tyfem 	 tyf-em 	 tyf-em
typů 	 typ-ů 	 typ-ů
tázat 	 táz-a-t 	 táz-a-t
týdeníku 	 týden-ík-u 	 týden-ík-u
týká 	 týk-á 	 týk-á
těhotenství 	 těhoten-ství 	 těhoten-ství
tělo 	 těl-o 	 těl-o
těsnat 	 těsn-a-t 	 těsn-a-t
těší 	 těš-í 	 těš-í
třasknout 	 třask-nou-t 	 třask-nou-t
třpytit 	 třpyt-i-t 	 třpyt-i-t
ubírat 	 u-bír-a-t 	 u-bír-a-t
udusit 	 u-dus-i-t 	 u-dus-i-t
udělání 	 u-děl-á-n-í 	 u-děl-á-n-í
uhledat 	 u-hled-a-t 	 u-hled-a-t
uhlí 	 uhl-í 	 uhl-í
uhražen 	 u-hraž-en 	 u-hraž-en
ujistit 	 u-jist-i-t 	 u-jist-i-t
ukládá 	 u-klád-á 	 u-klád-á
ukopnout 	 u-kop-nou-t 	 u-kop-nou-t
ukrajovat 	 u-kraj-ova-t 	 u-kraj-ova-t
ukroutit 	 u-krout-i-t 	 u-krout-i-t
ukvapovat 	 u-kvap-ova-t 	 u-kvap-ova-t
ukápnout 	 u-káp-nou-t 	 u-káp-nou-t
umučit 	 u-muč-i-t 	 u-muč-i-t
umáznout 	 u-máz-nou-t 	 u-máz-nou-t
umírňovat 	 u-mír-ň-ova-t 	 u-mír-ň-ova-t
unavujou 	 u-nav-uj-ou 	 u-nav-uj-ou
unikát 	 unik-át 	 unik-át
unožit 	 u-nož-i-t 	 u-nož-i-t
upadlo 	 u-pad-l-o 	 u-pad-l-o
uplatit 	 u-plat-i-t 	 u-plat-i-t
uplatnil 	 u-plat-n-i-l 	 u-plat-n-i-l
uplatněný 	 u-plat-n-ěn-ý 	 u-plat-n-ěn-ý
uplivnout 	 u-pliv-nou-t 	 u-pliv-nou-t
upravená 	 u-prav-en-á 	 u-prav-en-á
upíchat 	 u-pích-a-t 	 u-pích-a-t
upíjet 	 u-píj-e-t 	 u-píj-e-t
urgovat 	 urg-ova-t 	 urg-ova-t
uriah 	 uriah 	 uriah
urobit 	 u-rob-i-t 	 u-rob-i-t
urousat 	 u-rous-a-t 	 u-rous-a-t
urozená 	 u-roz-en-á 	 u-roz-en-á
určitě 	 urč-it-ě 	 urč-it-ě
usedat 	 u-sed-a-t 	 u-sed-a-t
usedavě 	 u-sed-a-v-ě 	 u-sed-a-v-ě
usednout 	 u-sed-nou-t 	 u-sed-nou-t
usekat 	 u-sek-a-t 	 u-sek-a-t
useknout 	 u-sek-nou-t 	 u-sek-nou-t
usmál 	 u-smá-l 	 u-smá-l
usoudí 	 u-soud-í 	 u-soud-í
ustavičně 	 u-stav-ič-n-ě 	 u-stav-ič-n-ě
ustupovat 	 u-stup-ova-t 	 u-stup-ova-t
ustřihnout 	 u-střih-nou-t 	 u-střih-nou-t
utrousit 	 u-trous-i-t 	 u-trous-i-t
utrpěl 	 u-trp-ě-l 	 u-trp-ě-l
utrpět 	 u-trp-ě-t 	 u-trp-ě-t
utvrzovat 	 u-tvrz-ova-t 	 u-tvrz-ova-t
utěšenému 	 u-těš-en-ému 	 u-těš-en-ému
uvedenou 	 u-ved-en-ou 	 u-ved-en-ou
uvedených 	 u-ved-en-ých 	 u-ved-en-ých
uvolnit 	 u-vol-n-i-t 	 u-vol-n-i-t
uvyknout 	 u-vyk-nou-t 	 u-vyk-nou-t
uvádějí 	 u-vád-ěj-í 	 u-vád-ěj-í
uvádět 	 u-vád-ě-t 	 u-vád-ě-t
uzdravovat 	 u-zdrav-ova-t 	 u-zdrav-ova-t
uznávání 	 u-zn-á-v-á-n-í 	 u-zn-á-v-á-n-í
ušplíchnout 	 u-šplích-nou-t 	 u-šplích-nou-t
uživit 	 u-živ-i-t 	 u-živ-i-t
užmoulat 	 u-žmoul-a-t 	 u-žmoul-a-t
užívat 	 u-ží-v-a-t 	 u-ží-v-a-t
vadí 	 vad-í 	 vad-í
vajnar 	 vajnar 	 vajnar
vank 	 vank 	 vank
vaně 	 van-ě 	 van-ě
vatikánský 	 vatikán-sk-ý 	 vatikán-sk-ý
vedou 	 ved-ou 	 ved-ou
velikou 	 vel-ik-ou 	 vel-ik-ou
vezmou 	 vez-m-ou 	 vez-m-ou
večer 	 večer 	 večer
vhazovat 	 v-haz-ova-t 	 v-haz-ova-t
vidimovat 	 vidim-ova-t 	 vidim-ova-t
vidíte 	 vid-í-te 	 vid-í-te
vily 	 vil-y 	 vil-y
virile 	 virile 	 virile
vizum 	 viz-um 	 viz-um
viďte 	 viď-te 	 viď-te
vkládáme 	 v-klád-á-me 	 v-klád-á-me
vlak 	 vlak 	 vlak
vlastnostech 	 vlast-n-ost-ech 	 vlast-n-ost-ech
vlasů 	 vlas-ů 	 vlas-ů
vlnu 	 vln-u 	 vln-u
vmyslit 	 v-mysl-i-t 	 v-mysl-i-t
vnitrný 	 v-nitr-n-ý 	 v-nitr-n-ý
vnucoval 	 v-nuc-ova-l 	 v-nuc-ova-l
vnímat 	 v-ním-a-t 	 v-ním-a-t
vodou 	 vod-ou 	 vod-ou
vojsko 	 voj-sk-o 	 voj-sk-o
volat 	 vol-a-t 	 vol-a-t
vozu 	 voz-u 	 voz-u
vrabčí 	 vrab-č-í 	 vrab-č-í
vrahům 	 vrah-ům 	 vrah-ům
vraždi 	 vraž-d-i 	 vraž-d-i
vrhat 	 vrh-a-t 	 vrh-a-t
vrtat 	 vrt-a-t 	 vrt-a-t
vrzat 	 vrz-a-t 	 vrz-a-t
vrátil 	 vrát-i-l 	 vrát-i-l
vstupenku 	 v-stup-enk-u 	 v-stup-enk-u
vstupné 	 v-stup-n-é 	 v-stup-n-é
vstupného 	 v-stup-n-ého 	 v-stup-n-ého
vstupném 	 v-stup-n-ém 	 v-stup-n-ém
vstupu 	 v-stup-u 	 v-stup-u
vybafnout 	 vy-baf-nou-t 	 vy-baf-nou-t
vychládat 	 vy-chlád-a-t 	 vy-chlád-a-t
vychrtlý 	 vy-chrt-l-ý 	 vy-chrt-l-ý
vycházejí 	 vy-cház-ej-í 	 vy-cház-ej-í
vydrápat 	 vy-dráp-a-t 	 vy-dráp-a-t
vydráždit 	 vy-drážd-i-t 	 vy-drážd-i-t
vydumat 	 vy-dum-a-t 	 vy-dum-a-t
vydávit 	 vy-dáv-i-t 	 vy-dáv-i-t
vydýchnout 	 vy-dých-nou-t 	 vy-dých-nou-t
vyděláme 	 vy-děl-á-me 	 vy-děl-á-me
vyhledávat 	 vy-hled-á-v-a-t 	 vy-hled-á-v-a-t
vyhoblovat 	 vy-hobl-ova-t 	 vy-hobl-ova-t
vyhranit 	 vy-hran-i-t 	 vy-hran-i-t
vyhraňovat 	 vy-hraň-ova-t 	 vy-hraň-ova-t
vyhrkla 	 vy-hrk-l-a 	 vy-hrk-l-a
vyhrknout 	 vy-hrk-nou-t 	 vy-hrk-nou-t
vyhýbat 	 vy-hýb-a-t 	 vy-hýb-a-t
vyjíždět 	 vy-jížd-ě-t 	 vy-jížd-ě-t
vykonané 	 vy-kon-a-n-é 	 vy-kon-a-n-é
vykoupal 	 vy-koup-a-l 	 vy-koup-a-l
vykroutit 	 vy-krout-i-t 	 vy-krout-i-t
vylehčit 	 vy-leh-č-i-t 	 vy-leh-č-i-t
vyloučení 	 vy-louč-en-í 	 vy-louč-en-í
vymazat 	 vy-maz-a-t 	 vy-maz-a-t
vymořit 	 vy-moř-i-t 	 vy-moř-i-t
vymáčknout 	 vy-máčk-nou-t 	 vy-máčk-nou-t
vymítat 	 vy-mít-a-t 	 vy-mít-a-t
vynaložili 	 vy-na-lož-i-l-i 	 vy-na-lož-i-l-i
vynaložit 	 vy-na-lož-i-t 	 vy-na-lož-i-t
vypadnou 	 vy-pad-n-ou 	 vy-pad-n-ou
vypláchnout 	 vy-plách-nou-t 	 vy-plách-nou-t
vypláznout 	 vy-pláz-nou-t 	 vy-pláz-nou-t
vyplňující 	 vy-plň-uj-íc-í 	 vy-plň-uj-íc-í
vypojit 	 vy-poj-i-t 	 vy-poj-i-t
vyportrétovat 	 vy-portrét-ova-t 	 vy-portrét-ova-t
vypravili 	 vy-prav-i-l-i 	 vy-prav-i-l-i
vypráví 	 vy-práv-í 	 vy-práv-í
vyprávěli 	 vy-práv-ě-l-i 	 vy-práv-ě-l-i
vypuknout 	 vy-puk-nou-t 	 vy-puk-nou-t
vyrazil 	 vy-raz-i-l 	 vy-raz-i-l
vysedával 	 vy-sed-á-v-a-l 	 vy-sed-á-v-a-l
vysidlovat 	 vy-sidl-ova-t 	 vy-sidl-ova-t
vysmrádnout 	 vy-smrád-nou-t 	 vy-smrád-nou-t
vysmívat 	 vy-smí-v-a-t 	 vy-smí-v-a-t
vystačovaný 	 vy-stač-ova-n-ý 	 vy-stač-ova-n-ý
vystoupení 	 vy-stoup-en-í 	 vy-stoup-en-í
vystoupit 	 vy-stoup-i-t 	 vy-stoup-i-t
vystrkovat 	 vy-strk-ova-t 	 vy-strk-ova-t
vystupuje 	 vy-stup-uje 	 vy-stup-uje
vystřídalo 	 vy-stříd-a-l-o 	 vy-stříd-a-l-o
vystřídat 	 vy-stříd-a-t 	 vy-stříd-a-t
vystříkat 	 vy-střík-a-t 	 vy-střík-a-t
vysvěcovat 	 vy-svěc-ova-t 	 vy-svěc-ova-t
vytepat 	 vy-tep-a-t 	 vy-tep-a-t
vytočit 	 vy-toč-i-t 	 vy-toč-i-t
vytížit 	 vy-tíž-i-t 	 vy-tíž-i-t
vytřeštit 	 vy-třešt-i-t 	 vy-třešt-i-t
vyvařit 	 vy-vař-i-t 	 vy-vař-i-t
vyvolávat 	 vy-vol-á-v-a-t 	 vy-vol-á-v-a-t
vyvracela 	 vy-vrac-e-l-a 	 vy-vrac-e-l-a
vyvrkávat 	 vy-vrk-á-v-a-t 	 vy-vrk-á-v-a-t
vyvěsit 	 vy-věs-i-t 	 vy-věs-i-t
vyznají 	 vy-zn-aj-í 	 vy-zn-aj-í
vyzobat 	 vy-zob-a-t 	 vy-zob-a-t
vyzářit 	 vy-zář-i-t 	 vy-zář-i-t
vyčichnout 	 vy-čich-nou-t 	 vy-čich-nou-t
vyčinil 	 vy-čin-i-l 	 vy-čin-i-l
vyčištěný 	 vy-čišt-ěn-ý 	 vy-čišt-ěn-ý
vyřežu 	 vy-řež-u 	 vy-řež-u
vyříkat 	 vy-řík-a-t 	 vy-řík-a-t
vyšetříme 	 vy-šetř-í-me 	 vy-šetř-í-me
vyštěknout 	 vy-štěk-nou-t 	 vy-štěk-nou-t
vyžaduje 	 vy-žad-uje 	 vy-žad-uje
vyžehlit 	 vy-žehl-i-t 	 vy-žehl-i-t
vyžle 	 vyžle 	 vyžle
vyžvanit 	 vy-žvan-i-t 	 vy-žvan-i-t
vyžíhat 	 vy-žíh-a-t 	 vy-žíh-a-t
válka 	 válk-a 	 válk-a
vážné 	 váž-n-é 	 váž-n-é
vážný 	 váž-n-ý 	 váž-n-ý
víc 	 víc 	 víc
východního 	 vý-chod-n-ího 	 vý-chod-n-ího
východě 	 vý-chod-ě 	 vý-chod-ě
výcviku 	 vý-cvik-u 	 vý-cvik-u
výhodnější 	 vý-hod-n-ějš-í 	 vý-hod-n-ějš-í
výmluvnost 	 vý-mluv-n-ost 	 vý-mluv-n-ost
výpočetní 	 vý-po-čet-n-í 	 vý-po-čet-n-í
výrazné 	 vý-raz-n-é 	 vý-raz-n-é
výukových 	 vý-uk-ov-ých 	 vý-uk-ov-ých
vývozu 	 vý-voz-u 	 vý-voz-u
výší 	 výš-í 	 výš-í
vědec 	 věd-ec 	 věd-ec
vědou 	 věd-ou 	 věd-ou
vědro 	 vědr-o 	 vědr-o
vědí 	 věd-í 	 věd-í
vědět 	 věd-ě-t 	 věd-ě-t
věrnými 	 věr-n-ými 	 věr-n-ými
věz 	 věz 	 věz
věznit 	 věz-n-i-t 	 věz-n-i-t
věčné 	 věč-n-é 	 věč-n-é
věřte 	 věř-te 	 věř-te
věříme 	 věř-í-me 	 věř-í-me
všoupnout 	 v-šoup-nou-t 	 v-šoup-nou-t
vůní 	 vůn-í 	 vůn-í
vůně 	 vůn-ě 	 vůn-ě
wild 	 wild 	 wild
william 	 william 	 william
zabolet 	 za-bol-e-t 	 za-bol-e-t
zabouřit 	 za-bouř-i-t 	 za-bouř-i-t
zabrousit 	 za-brous-i-t 	 za-brous-i-t
zachytila 	 za-chyt-i-l-a 	 za-chyt-i-l-a
zacinkat 	 za-cink-a-t 	 za-cink-a-t
zacloňovat 	 za-cloň-ova-t 	 za-cloň-ova-t
zafouknout 	 za-fouk-nou-t 	 za-fouk-nou-t
zahlenit 	 za-hlen-i-t 	 za-hlen-i-t
zahleňovat 	 za-hleň-ova-t 	 za-hleň-ova-t
zahnědnout 	 za-hněd-nou-t 	 za-hněd-nou-t
zahoukat 	 za-houk-a-t 	 za-houk-a-t
zahvízdat 	 za-hvízd-a-t 	 za-hvízd-a-t
zajistila 	 za-jist-i-l-a 	 za-jist-i-l-a
zajistit 	 za-jist-i-t 	 za-jist-i-t
zajisté 	 za-jist-é 	 za-jist-é
zajídat 	 za-jíd-a-t 	 za-jíd-a-t
zajímá 	 za-jím-á 	 za-jím-á
zakalit 	 za-kal-i-t 	 za-kal-i-t
zakazujícími 	 za-kaz-uj-íc-ími 	 za-kaz-uj-íc-ími
zakecat 	 za-kec-a-t 	 za-kec-a-t
zaklapnout 	 za-klap-nou-t 	 za-klap-nou-t
zaklepe 	 za-klep-e 	 za-klep-e
zakomíhat 	 za-komíh-a-t 	 za-komíh-a-t
zakončovat 	 za-konč-ova-t 	 za-konč-ova-t
zakrvavět 	 za-krv-av-ě-t 	 za-krv-av-ě-t
zakrývat 	 za-krý-v-a-t 	 za-krý-v-a-t
zakuklit 	 za-kukl-i-t 	 za-kukl-i-t
zakázek 	 za-káz-ek 	 za-káz-ek
zakázku 	 za-káz-k-u 	 za-káz-k-u
zakázky 	 za-káz-k-y 	 za-káz-k-y
zakázkách 	 za-káz-k-ách 	 za-káz-k-ách
zakývala 	 za-kýv-a-l-a 	 za-kýv-a-l-a
zalidnit 	 za-lid-n-i-t 	 za-lid-n-i-t
založený 	 za-lož-en-ý 	 za-lož-en-ý
založil 	 za-lož-i-l 	 za-lož-i-l
založiti 	 za-lož-i-ti 	 za-lož-i-ti
zalykat 	 za-lyk-a-t 	 za-lyk-a-t
zalétat 	 za-lét-a-t 	 za-lét-a-t
zalítnout 	 za-lít-nou-t 	 za-lít-nou-t
zamalovat 	 za-mal-ova-t 	 za-mal-ova-t
zameškat 	 za-mešk-a-t 	 za-mešk-a-t
zameškávat 	 za-mešk-á-v-a-t 	 za-mešk-á-v-a-t
zamručet 	 za-mruč-e-t 	 za-mruč-e-t
zaměstná 	 za-měst-n-á 	 za-měst-n-á
zaměřovat 	 za-měř-ova-t 	 za-měř-ova-t
zapadající 	 za-pad-aj-íc-í 	 za-pad-aj-íc-í
zaperlit 	 za-perl-i-t 	 za-perl-i-t
zapichovat 	 za-pich-ova-t 	 za-pich-ova-t
zaplacené 	 za-plac-en-é 	 za-plac-en-é
zaplakal 	 za-plak-a-l 	 za-plak-a-l
zaplítat 	 za-plít-a-t 	 za-plít-a-t
zapojit 	 za-poj-i-t 	 za-poj-i-t
zapovídat 	 za-po-víd-a-t 	 za-po-víd-a-t
zapřádat 	 za-přád-a-t 	 za-přád-a-t
zapůjčovat 	 za-půjč-ova-t 	 za-půjč-ova-t
zaručen 	 za-ruč-en 	 za-ruč-en
zaručit 	 za-ruč-i-t 	 za-ruč-i-t
zaručuje 	 za-ruč-uje 	 za-ruč-uje
zasedli 	 za-sed-l-i 	 za-sed-l-i
zaskřípnout 	 za-skříp-nou-t 	 za-skříp-nou-t
zasmolit 	 za-smol-i-t 	 za-smol-i-t
zasmrádnout 	 za-smrád-nou-t 	 za-smrád-nou-t
zasnoubil 	 za-snoub-i-l 	 za-snoub-i-l
zastřelit 	 za-střel-i-t 	 za-střel-i-t
zastříhat 	 za-stříh-a-t 	 za-stříh-a-t
zasvinit 	 za-svin-i-t 	 za-svin-i-t
zasykla 	 za-syk-l-a 	 za-syk-l-a
zasypaný 	 za-syp-a-n-ý 	 za-syp-a-n-ý
zasílat 	 za-síl-a-t 	 za-síl-a-t
zasívat 	 za-sí-v-a-t 	 za-sí-v-a-t
zatancovat 	 za-tanc-ova-t 	 za-tanc-ova-t
zatracená 	 za-trac-en-á 	 za-trac-en-á
zatratil 	 za-trat-i-l 	 za-trat-i-l
zatroubit 	 za-troub-i-t 	 za-troub-i-t
zatrápený 	 za-tráp-en-ý 	 za-tráp-en-ý
zatřpytit 	 za-třpyt-i-t 	 za-třpyt-i-t
zavazuje 	 za-vaz-uje 	 za-vaz-uje
zavlečenou 	 za-vleč-en-ou 	 za-vleč-en-ou
zavléci 	 za-vléc-i 	 za-vléc-i
zavrhovat 	 za-vrh-ova-t 	 za-vrh-ova-t
zavrzat 	 za-vrz-a-t 	 za-vrz-a-t
zaváhat 	 za-váh-a-t 	 za-váh-a-t
zavírali 	 za-vír-a-l-i 	 za-vír-a-l-i
zavěšení 	 za-věš-en-í 	 za-věš-en-í
zavřel 	 za-vř-e-l 	 za-vř-e-l
zavřít 	 za-vř-í-t 	 za-vř-í-t
začišťovat 	 za-čišť-ova-t 	 za-čišť-ova-t
začudit 	 za-čud-i-t 	 za-čud-i-t
začínají 	 za-čín-aj-í 	 za-čín-aj-í
zařadil 	 za-řad-i-l 	 za-řad-i-l
zařazeny 	 za-řaz-en-y 	 za-řaz-en-y
zařizovatel 	 za-řiz-ova-tel 	 za-řiz-ova-tel
zařízením 	 za-říz-en-ím 	 za-říz-en-ím
zaškaredit 	 za-škared-i-t 	 za-škared-i-t
zašmudlat 	 za-šmudl-a-t 	 za-šmudl-a-t
zaštěknout 	 za-štěk-nou-t 	 za-štěk-nou-t
zažívat 	 za-ží-v-a-t 	 za-ží-v-a-t
zbarvovat 	 z-barv-ova-t 	 z-barv-ova-t
zbaštit 	 z-bašt-i-t 	 z-bašt-i-t
zbožni 	 z-bož-n-i 	 z-bož-n-i
zbrušovat 	 z-bruš-ova-t 	 z-bruš-ova-t
zchodit 	 z-chod-i-t 	 z-chod-i-t
zchvátit 	 z-chvát-i-t 	 z-chvát-i-t
zcuchat 	 z-cuch-a-t 	 z-cuch-a-t
zdřevnatět 	 z-dřev-n-at-ě-t 	 z-dřev-n-at-ě-t
zemana 	 zeman-a 	 zeman-a
zesilovat 	 ze-sil-ova-t 	 ze-sil-ova-t
zestárnout 	 ze-stár-nou-t 	 ze-stár-nou-t
zesílit 	 ze-síl-i-t 	 ze-síl-i-t
zešedivět 	 ze-šed-iv-ě-t 	 ze-šed-iv-ě-t
zešpatnět 	 ze-špat-n-ě-t 	 ze-špat-n-ě-t
zhasnou 	 z-has-n-ou 	 z-has-n-ou
zimě 	 zim-ě 	 zim-ě
zježit 	 z-jež-i-t 	 z-jež-i-t
zjihnout 	 z-jih-nou-t 	 z-jih-nou-t
zjistit 	 z-jist-i-t 	 z-jist-i-t
zkazilo 	 z-kaz-i-l-o 	 z-kaz-i-l-o
zkoksovat 	 z-koks-ova-t 	 z-koks-ova-t
zkoušet 	 z-kouš-e-t 	 z-kouš-e-t
zkusila 	 z-kus-i-l-a 	 z-kus-i-l-a
zkušeností 	 z-kuš-en-ost-í 	 z-kuš-en-ost-í
zkypřet 	 z-kypř-e-t 	 z-kypř-e-t
zlatnout 	 zlat-nou-t 	 zlat-nou-t
zmazat 	 z-maz-a-t 	 z-maz-a-t
zmeškat 	 z-mešk-a-t 	 z-mešk-a-t
zmodrat 	 z-modr-a-t 	 z-modr-a-t
zmrvit 	 z-mrv-i-t 	 z-mrv-i-t
zmuchlat 	 z-muchl-a-t 	 z-muchl-a-t
zmýlit 	 z-mýl-i-t 	 z-mýl-i-t
znemravnit 	 z-ne-mrav-n-i-t 	 z-ne-mrav-n-i-t
známku 	 znám-k-u 	 znám-k-u
znásobovaný 	 z-násob-ova-n-ý 	 z-násob-ova-n-ý
zoufnout 	 zouf-nou-t 	 zouf-nou-t
zplynit 	 z-plyn-i-t 	 z-plyn-i-t
zpěčovat 	 zpěč-ova-t 	 zpěč-ova-t
zpřísnit 	 z-přísn-i-t 	 z-přísn-i-t
zrakový 	 zrak-ov-ý 	 zrak-ov-ý
zregulovat 	 z-regul-ova-t 	 z-regul-ova-t
zrušeny 	 z-ruš-en-y 	 z-ruš-en-y
zrušení 	 z-ruš-en-í 	 z-ruš-en-í
zrušil 	 z-ruš-i-l 	 z-ruš-i-l
ztepat 	 z-tep-a-t 	 z-tep-a-t
ztlouci 	 z-tlouc-i 	 z-tlouc-i
ztrhat 	 z-trh-a-t 	 z-trh-a-t
ztropí 	 z-trop-í 	 z-trop-í
ztrátou 	 z-trát-ou 	 z-trát-ou
ztrýznit 	 z-trýzn-i-t 	 z-trýzn-i-t
ztuchnout 	 z-tuch-nou-t 	 z-tuch-nou-t
ztupit 	 z-tup-i-t 	 z-tup-i-t
ztupět 	 z-tup-ě-t 	 z-tup-ě-t
ztížená 	 z-tíž-en-á 	 z-tíž-en-á
ztěžovat 	 z-těž-ova-t 	 z-těž-ova-t
zuhelnět 	 z-uhel-n-ě-t 	 z-uhel-n-ě-t
zvadaně 	 z-vad-a-n-ě 	 z-vad-a-n-ě
zvlášť 	 zvlášť 	 zvlášť
zvrátit 	 z-vrát-i-t 	 z-vrát-i-t
zvážení 	 z-váž-en-í 	 z-váž-en-í
zvířata 	 zvíř-at-a 	 zvíř-at-a
zvýšil 	 z-výš-i-l 	 z-výš-i-l
zády 	 zád-y 	 zád-y
zákazníka 	 zá-kaz-ník-a 	 zá-kaz-ník-a
základního 	 zá-klad-n-ího 	 zá-klad-n-ího
zálohy 	 zá-loh-y 	 zá-loh-y
zámek 	 zá-mek 	 zá-mek
západními 	 zá-pad-n-ími 	 zá-pad-n-ími
záporný 	 zá-por-n-ý 	 zá-por-n-ý
zápraží 	 zá-praž-í 	 zá-praž-í
zásahu 	 zá-sah-u 	 zá-sah-u
zásobení 	 zá-sob-en-í 	 zá-sob-en-í
zásobování 	 zá-sob-ová-n-í 	 zá-sob-ová-n-í
zásobováním 	 zá-sob-ová-n-ím 	 zá-sob-ová-n-ím
závadu 	 zá-vad-u 	 zá-vad-u
závazných 	 zá-vaz-n-ých 	 zá-vaz-n-ých
závazným 	 zá-vaz-n-ým 	 zá-vaz-n-ým
závislý 	 zá-vis-l-ý 	 zá-vis-l-ý
zšedivět 	 z-šed-iv-ě-t 	 z-šed-iv-ě-t
úmysly 	 ú-mysl-y 	 ú-mysl-y
úprava 	 ú-prav-a 	 ú-prav-a
úrodnou 	 ú-rod-n-ou 	 ú-rod-n-ou
úspěchy 	 ú-spěch-y 	 ú-spěch-y
úspěšnou 	 ú-spěš-n-ou 	 ú-spěš-n-ou
úspěšnější 	 ú-spěš-n-ějš-í 	 ú-spěš-n-ějš-í
ústav 	 ú-stav 	 ú-stav
útrobách 	 útrob-ách 	 útrob-ách
útrpně 	 ú-trp-n-ě 	 ú-trp-n-ě
úvahu 	 ú-vah-u 	 ú-vah-u
úvahy 	 ú-vah-y 	 ú-vah-y
účastně 	 ú-čast-n-ě 	 ú-čast-n-ě
úřad 	 ú-řad 	 ú-řad
úřadem 	 ú-řad-em 	 ú-řad-em
úřadu 	 ú-řad-u 	 ú-řad-u
čachrovat 	 čachr-ova-t 	 čachr-ova-t
časově 	 čas-ov-ě 	 čas-ov-ě
častovat 	 čast-ova-t 	 čast-ova-t
častý 	 čast-ý 	 čast-ý
časy 	 čas-y 	 čas-y
časů 	 čas-ů 	 čas-ů
čechy 	 čech-y 	 čech-y
čekají 	 ček-aj-í 	 ček-aj-í
čekal 	 ček-a-l 	 ček-a-l
čekalo 	 ček-a-l-o 	 ček-a-l-o
četné 	 čet-n-é 	 čet-n-é
čich 	 čich 	 čich
čilý 	 čil-ý 	 čil-ý
činila 	 čin-i-l-a 	 čin-i-l-a
činit 	 čin-i-t 	 čin-i-t
čiřit 	 čiř-i-t 	 čiř-i-t
čtveračit 	 čtver-ač-i-t 	 čtver-ač-i-t
čtvrt 	 čtvrt 	 čtvrt
čtvrtletního 	 čtvrt-let-n-ího 	 čtvrt-let-n-ího
čtvrté 	 čtvrt-é 	 čtvrt-é
čárat 	 čár-a-t 	 čár-a-t
čáča 	 čáč-a 	 čáč-a
číhal 	 číh-a-l 	 číh-a-l
číslovat 	 čísl-ova-t 	 čísl-ova-t
ďoubat 	 ďoub-a-t 	 ďoub-a-t
ďáblem 	 ďábl-em 	 ďábl-em
ňákou 	 ňák-ou 	 ňák-ou
řadou 	 řad-ou 	 řad-ou
ředit 	 řed-i-t 	 řed-i-t
ředitel 	 řed-i-tel 	 řed-i-tel
řetězových 	 řetěz-ov-ých 	 řetěz-ov-ých
řešit 	 řeš-i-t 	 řeš-i-t
řád 	 řád 	 řád
řádní 	 řád-n-í 	 řád-n-í
řádně 	 řád-n-ě 	 řád-n-ě
řídkým 	 říd-k-ým 	 říd-k-ým
říkají 	 řík-aj-í 	 řík-aj-í
říznout 	 říz-nou-t 	 říz-nou-t
šanci 	 šanc-i 	 šanc-i
šedivý 	 šed-iv-ý 	 šed-iv-ý
šek 	 šek 	 šek
šeků 	 šek-ů 	 šek-ů
šeptne 	 šept-ne 	 šept-ne
šero 	 šer-o 	 šer-o
šesté 	 šest-é 	 šest-é
šibal 	 šib-a-l 	 šib-a-l
šikovně 	 šik-ov-n-ě 	 šik-ov-n-ě
škola 	 škol-a 	 škol-a
školu 	 škol-u 	 škol-u
školy 	 škol-y 	 škol-y
škrtil 	 škrt-i-l 	 škrt-i-l
škádlit 	 škádl-i-t 	 škádl-i-t
šmankote 	 šmankote 	 šmankote
šmatat 	 šmat-a-t 	 šmat-a-t
šminkovat 	 šmink-ova-t 	 šmink-ova-t
špaček 	 špaček 	 špaček
špekovávat 	 špek-ová-v-a-t 	 špek-ová-v-a-t
šprýmovat 	 šprým-ova-t 	 šprým-ova-t
špásovat 	 špás-ova-t 	 špás-ova-t
štrachat 	 štrach-a-t 	 štrach-a-t
štěně 	 štěn-ě 	 štěn-ě
šumperka 	 šumperk-a 	 šumperk-a
švýcarské 	 švýcar-sk-é 	 švýcar-sk-é
šílí 	 šíl-í 	 šíl-í
šíří 	 šíř-í 	 šíř-í
žaludek 	 žaludek 	 žaludek
žehlit 	 žehl-i-t 	 žehl-i-t
žehrat 	 žehr-a-t 	 žehr-a-t
žlutá 	 žlut-á 	 žlut-á
žáby 	 žáb-y 	 žáb-y
žádali 	 žád-a-l-i 	 žád-a-l-i
žádné 	 žád-n-é 	 žád-n-é
