pasterovat 	 paster-ova-t 	 paster-ova-t
předpokládat 	 před-po-klád-a-t 	 před-po-klád-a-t
černorudý 	 čern-o-rud-ý 	 čern-o-rud-ý
polistopadový 	 po-list-o-pad-ov-ý 	 po-list-o-pad-ov-ý
zkáznit 	 z-káz-n-i-t 	 z-káz-n-i-t
hadrník 	 hadr-ník 	 hadr-ník
odstupné 	 od-stup-n-é 	 od-stup-n-é
black 	 black 	 black
vyspílat 	 vy-spíl-a-t 	 vy-spíl-a-t
prací 	 prac-í 	 prac-í
jadrnějšího 	 jadr-n-ějš-ího 	 jadr-n-ějš-ího
pleskat 	 plesk-a-t 	 plesk-a-t
očadit 	 o-čad-i-t 	 o-čad-i-t
krysí 	 krys-í 	 krys-í
mloci 	 mloc-i 	 mloc-i
poběží 	 po-běž-í 	 po-běž-í
jednotu 	 jedn-ot-u 	 jedn-ot-u
sjednávat 	 s-jedn-á-v-a-t 	 s-jedn-á-v-a-t
zaběhlá 	 za-běh-l-á 	 za-běh-l-á
skaný 	 skan-ý 	 skan-ý
vznášet 	 vz-náš-e-t 	 vz-náš-e-t
povozit 	 po-voz-i-t 	 po-voz-i-t
přitvrdit 	 při-tvrd-i-t 	 při-tvrd-i-t
zúčtovávat 	 z-ú-čt-ová-v-a-t 	 z-ú-čt-ová-v-a-t
výrazem 	 vý-raz-em 	 vý-raz-em
hokejisté 	 hokej-ist-é 	 hokej-ist-é
nazvučit 	 na-zvuč-i-t 	 na-zvuč-i-t
vystavil 	 vy-stav-i-l 	 vy-stav-i-l
propotratové 	 pro-po-trat-ov-é 	 pro-po-trat-ov-é
tužbami 	 tuž-b-ami 	 tuž-b-ami
akademie 	 akadem-i-e 	 akadem-i-e
zamaskovat 	 za-mask-ova-t 	 za-mask-ova-t
vězí 	 věz-í 	 věz-í
dosycovat 	 do-syc-ova-t 	 do-syc-ova-t
špitál 	 špitál 	 špitál
aquilejský 	 aquilej-sk-ý 	 aquilej-sk-ý
kyprý 	 kypr-ý 	 kypr-ý
veliké 	 vel-ik-é 	 vel-ik-é
technokultura 	 techn-o-kult-ur-a 	 techn-o-kult-ur-a
spoluurčit 	 spolu-urč-i-t 	 spolu-urč-i-t
obemílat 	 obe-míl-a-t 	 obe-míl-a-t
stavy 	 stav-y 	 stav-y
uznávající 	 u-zn-á-v-aj-íc-í 	 u-zn-á-v-aj-íc-í
ukáže 	 u-káž-e 	 u-káž-e
tolik 	 tolik 	 tolik
neratovice 	 nerat-ov-ic-e 	 nerat-ov-ic-e
věnuje 	 věn-uje 	 věn-uje
vydražit 	 vy-draž-i-t 	 vy-draž-i-t
dominantní 	 domin-ant-n-í 	 domin-ant-n-í
letitý 	 let-it-ý 	 let-it-ý
požádání 	 po-žád-á-n-í 	 po-žád-á-n-í
přestane 	 pře-sta-ne 	 pře-sta-ne
bagdád 	 bagdád 	 bagdád
nažvanit 	 na-žvan-i-t 	 na-žvan-i-t
pokmínovat 	 po-kmín-ova-t 	 po-kmín-ova-t
hostýn 	 hostýn 	 hostýn
sub 	 sub 	 sub
posiluje 	 po-sil-uje 	 po-sil-uje
povyskakovat 	 po-vy-skak-ova-t 	 po-vy-skak-ova-t
nehledal 	 ne-hled-a-l 	 ne-hled-a-l
zavzdychat 	 za-vz-dych-a-t 	 za-vz-dych-a-t
sedlářovi 	 sed-l-ář-ovi 	 sed-l-ář-ovi
zasnoubil 	 za-snoub-i-l 	 za-snoub-i-l
nažehlit 	 na-žeh-l-i-t 	 na-žeh-l-i-t
pokryla 	 po-kry-l-a 	 po-kry-l-a
lech 	 lech 	 lech
kufříkem 	 kufř-ík-em 	 kufř-ík-em
transportovat 	 trans-port-ova-t 	 trans-port-ova-t
napomenout 	 na-po-men-ou-t 	 na-po-men-ou-t
přeskakovat 	 pře-skak-ova-t 	 pře-skak-ova-t
moudře 	 moudř-e 	 moudř-e
převýšit 	 pře-výš-i-t 	 pře-výš-i-t
trojný 	 trojn-ý 	 trojn-ý
síra 	 sír-a 	 sír-a
obě 	 ob-ě 	 ob-ě
vyhrabování 	 vy-hrab-ová-n-í 	 vy-hrab-ová-n-í
více 	 více 	 více
vyhrotovat 	 vy-hrot-ova-t 	 vy-hrot-ova-t
zahanbeně 	 za-han-b-en-ě 	 za-han-b-en-ě
docouvat 	 do-couv-a-t 	 do-couv-a-t
zobák 	 zob-ák 	 zob-ák
nevinnou 	 ne-vin-n-ou 	 ne-vin-n-ou
nepodpoří 	 ne-pod-poř-í 	 ne-pod-poř-í
překladatel 	 pře-klad-a-tel 	 pře-klad-a-tel
meziledovou 	 mezi-led-ov-ou 	 mezi-led-ov-ou
rekapitulovat 	 re-kapit-ul-ova-t 	 re-kapit-ul-ova-t
přihrát 	 při-hrá-t 	 při-hrá-t
přicupat 	 při-cup-a-t 	 při-cup-a-t
oplatit 	 o-plat-i-t 	 o-plat-i-t
patnácti 	 pat-náct-i 	 pat-náct-i
koukala 	 kouk-a-l-a 	 kouk-a-l-a
bakalářského 	 bakalář-sk-ého 	 bakalář-sk-ého
pata 	 pat-a 	 pat-a
protisknout 	 pro-tisk-nou-t 	 pro-tisk-nou-t
zvýraznění 	 z-vý-raz-n-ěn-í 	 z-vý-raz-n-ěn-í
separovat 	 se-par-ova-t 	 se-par-ova-t
škobrtnout 	 škobrt-nou-t 	 škobrt-nou-t
rozhodčích 	 roz-hod-č-ích 	 roz-hod-č-ích
citelný 	 cit-eln-ý 	 cit-eln-ý
došívat 	 do-ší-v-a-t 	 do-ší-v-a-t
odtlouci 	 od-tlouc-i 	 od-tlouc-i
kufříku 	 kufř-ík-u 	 kufř-ík-u
šatech 	 šat-ech 	 šat-ech
osobnostní 	 osob-n-ost-n-í 	 osob-n-ost-n-í
stoupat 	 stoup-a-t 	 stoup-a-t
solidnost 	 solid-n-ost 	 solid-n-ost
hryznout 	 hryz-nou-t 	 hryz-nou-t
zamňouknout 	 za-mňouk-nou-t 	 za-mňouk-nou-t
obestavovat 	 obe-stav-ova-t 	 obe-stav-ova-t
zbrunátnět 	 z-brunát-n-ě-t 	 z-brunát-n-ě-t
úspěchem 	 ú-spěch-em 	 ú-spěch-em
mláto 	 mlát-o 	 mlát-o
nadšení 	 na-dš-en-í 	 na-dš-en-í
přežívají 	 pře-ží-v-aj-í 	 pře-ží-v-aj-í
francouzských 	 franc-ouz-sk-ých 	 franc-ouz-sk-ých
poklekat 	 po-klek-a-t 	 po-klek-a-t
kouřilo 	 kouř-i-l-o 	 kouř-i-l-o
povinny 	 po-vin-n-y 	 po-vin-n-y
prohloubit 	 pro-hloub-i-t 	 pro-hloub-i-t
autohavárie 	 aut-o-havár-i-e 	 aut-o-havár-i-e
makrostruktura 	 makro-strukt-ur-a 	 makro-strukt-ur-a
dával 	 d-á-v-a-l 	 d-á-v-a-l
azyl 	 azyl 	 azyl
šeredného 	 šered-n-ého 	 šered-n-ého
touží 	 touž-í 	 touž-í
přilíznout 	 při-líz-nou-t 	 při-líz-nou-t
jednotlačítková 	 jedn-o-tlač-í-tk-ov-á 	 jedn-o-tlač-í-tk-ov-á
protivzdušné 	 proti-vz-duš-n-é 	 proti-vz-duš-n-é
rozlítostnit 	 roz-lít-ost-n-i-t 	 roz-lít-ost-n-i-t
font 	 font 	 font
středisko 	 střed-isk-o 	 střed-isk-o
putovávat 	 put-ová-v-a-t 	 put-ová-v-a-t
holocén 	 holo-cén 	 holo-cén
povídala 	 po-víd-a-l-a 	 po-víd-a-l-a
proplížit 	 pro-plíž-i-t 	 pro-plíž-i-t
konstanta 	 kon-stant-a 	 kon-stant-a
rýsovat 	 rýs-ova-t 	 rýs-ova-t
workshopech 	 work-shop-ech 	 work-shop-ech
útržků 	 ú-trž-k-ů 	 ú-trž-k-ů
potenciální 	 potenc-iál-n-í 	 potenc-iál-n-í
čepem 	 čep-em 	 čep-em
naveslovat 	 na-vesl-ova-t 	 na-vesl-ova-t
žehnout 	 žeh-nou-t 	 žeh-nou-t
vyrázovat 	 vy-ráz-ova-t 	 vy-ráz-ova-t
indickou 	 ind-ic-k-ou 	 ind-ic-k-ou
pejsánek 	 pejs-án-ek 	 pejs-án-ek
nesprávných 	 ne-s-práv-n-ých 	 ne-s-práv-n-ých
stráský 	 strás-k-ý 	 strás-k-ý
hlásat 	 hlás-a-t 	 hlás-a-t
zablátil 	 za-blát-i-l 	 za-blát-i-l
pásmu 	 pás-m-u 	 pás-m-u
pochyba 	 po-chyb-a 	 po-chyb-a
vyvolalo 	 vy-vol-a-l-o 	 vy-vol-a-l-o
haag 	 haag 	 haag
osvěžovat 	 o-svěž-ova-t 	 o-svěž-ova-t
stopu 	 stop-u 	 stop-u
keš 	 keš 	 keš
vydojovat 	 vy-doj-ova-t 	 vy-doj-ova-t
minisukni 	 mini-sukn-i 	 mini-sukn-i
zásoby 	 zá-sob-y 	 zá-sob-y
zapsat 	 za-ps-a-t 	 za-ps-a-t
sprintovat 	 sprint-ova-t 	 sprint-ova-t
jablunkov 	 jablunk-ov 	 jablunk-ov
arméni 	 armén-i 	 armén-i
čtvrtpravd 	 čtvrt-pravd 	 čtvrt-pravd
zpráskat 	 z-prásk-a-t 	 z-prásk-a-t
vcházejíc 	 v-cház-ej-íc 	 v-cház-ej-íc
nasírat 	 na-sír-a-t 	 na-sír-a-t
fofrovat 	 fofr-ova-t 	 fofr-ova-t
koš 	 koš 	 koš
dětinštět 	 dět-in-št-ě-t 	 dět-in-št-ě-t
nahamounit 	 na-hamoun-i-t 	 na-hamoun-i-t
znečišťující 	 z-ne-čišť-uj-íc-í 	 z-ne-čišť-uj-íc-í
zapípat 	 za-píp-a-t 	 za-píp-a-t
vyčesávat 	 vy-čes-á-v-a-t 	 vy-čes-á-v-a-t
užít 	 u-ží-t 	 u-ží-t
quoi 	 quoi 	 quoi
ukovat 	 u-kov-a-t 	 u-kov-a-t
přivolávat 	 při-vol-á-v-a-t 	 při-vol-á-v-a-t
reprezentují 	 re-prezent-uj-í 	 re-prezent-uj-í
vodotok 	 vod-o-tok 	 vod-o-tok
žlábkovat 	 žláb-k-ova-t 	 žláb-k-ova-t
kancelář 	 kancelář 	 kancelář
kieransová 	 kierans-ov-á 	 kierans-ov-á
singl 	 singl 	 singl
povyrazit 	 po-vy-raz-i-t 	 po-vy-raz-i-t
neapol 	 neapol 	 neapol
zapouštět 	 za-poušt-ě-t 	 za-poušt-ě-t
životních 	 ži-v-ot-n-ích 	 ži-v-ot-n-ích
šatlavy 	 šatl-av-y 	 šatl-av-y
přímým 	 přím-ým 	 přím-ým
nepružné 	 ne-pruž-n-é 	 ne-pruž-n-é
zaužívat 	 za-u-ží-v-a-t 	 za-u-ží-v-a-t
hříšnou 	 hříš-n-ou 	 hříš-n-ou
návod 	 ná-vod 	 ná-vod
vaně 	 van-ě 	 van-ě
pipka 	 pipk-a 	 pipk-a
zoubkovat 	 zoub-k-ova-t 	 zoub-k-ova-t
povznést 	 po-vz-nés-t 	 po-vz-nés-t
pětisegmentový 	 pět-i-segment-ov-ý 	 pět-i-segment-ov-ý
angažován 	 angaž-ová-n 	 angaž-ová-n
plachta 	 placht-a 	 placht-a
naslibovat 	 na-slib-ova-t 	 na-slib-ova-t
rozumové 	 roz-um-ov-é 	 roz-um-ov-é
suchoprdů 	 such-o-prd-ů 	 such-o-prd-ů
řemeslo 	 řemesl-o 	 řemesl-o
odštrachat 	 od-štrach-a-t 	 od-štrach-a-t
souseda 	 sou-sed-a 	 sou-sed-a
střelilo 	 střel-i-l-o 	 střel-i-l-o
onemocnět 	 o-ne-moc-n-ě-t 	 o-ne-moc-n-ě-t
marie 	 mari-e 	 mari-e
zívaje 	 zív-aj-e 	 zív-aj-e
vpravili 	 v-prav-i-l-i 	 v-prav-i-l-i
přehmátnout 	 pře-hmát-nou-t 	 pře-hmát-nou-t
tur 	 tur 	 tur
informačním 	 in-form-ač-n-ím 	 in-form-ač-n-ím
euckenova 	 eucken-ov-a 	 eucken-ov-a
informuje 	 in-form-uje 	 in-form-uje
ztechnizovat 	 z-techn-iz-ova-t 	 z-techn-iz-ova-t
zmaškařit 	 z-mašk-ař-i-t 	 z-mašk-ař-i-t
opomínat 	 o-po-mín-a-t 	 o-po-mín-a-t
vodopády 	 vod-o-pád-y 	 vod-o-pád-y
vylétat 	 vy-lét-a-t 	 vy-lét-a-t
tromba 	 tromb-a 	 tromb-a
západočínský 	 zá-pad-o-čín-sk-ý 	 zá-pad-o-čín-sk-ý
pobývat 	 po-bý-v-a-t 	 po-bý-v-a-t
lanařit 	 lan-ař-i-t 	 lan-ař-i-t
zchromit 	 z-chrom-i-t 	 z-chrom-i-t
hustého 	 hust-ého 	 hust-ého
lézt 	 léz-t 	 léz-t
historického 	 histor-ick-ého 	 histor-ick-ého
burácet 	 bur-ác-e-t 	 bur-ác-e-t
křáp 	 křáp 	 křáp
utajit 	 u-taj-i-t 	 u-taj-i-t
nástrojem 	 ná-stroj-em 	 ná-stroj-em
rozrušena 	 roz-ruš-en-a 	 roz-ruš-en-a
nosu 	 nos-u 	 nos-u
vodolově 	 vodolov-ě 	 vodolov-ě
kouzelníkovýma 	 kouzel-n-ík-ov-ýma 	 kouzel-n-ík-ov-ýma
úroveň 	 ú-rov-eň 	 ú-rov-eň
šupnout 	 šup-nou-t 	 šup-nou-t
štítit 	 štít-i-t 	 štít-i-t
provinit 	 pro-vin-i-t 	 pro-vin-i-t
koupili 	 koup-i-l-i 	 koup-i-l-i
svrhovat 	 s-vrh-ova-t 	 s-vrh-ova-t
okrájet 	 o-kráj-e-t 	 o-kráj-e-t
vyrovnaný 	 vy-rovn-a-n-ý 	 vy-rovn-a-n-ý
proběhám 	 pro-běh-á-m 	 pro-běh-á-m
lahviček 	 lahv-iček 	 lahv-iček
populace 	 popul-ac-e 	 popul-ac-e
obořit 	 o-boř-i-t 	 o-boř-i-t
nevidíte 	 ne-vid-í-te 	 ne-vid-í-te
společnost 	 spol-eč-n-ost 	 spol-eč-n-ost
námořník 	 ná-moř-n-ík 	 ná-moř-n-ík
odbarvit 	 od-barv-i-t 	 od-barv-i-t
zacílit 	 za-cíl-i-t 	 za-cíl-i-t
připlížit 	 při-plíž-i-t 	 při-plíž-i-t
zchladnout 	 z-chlad-nou-t 	 z-chlad-nou-t
vykurýrovat 	 vy-kur-ýr-ova-t 	 vy-kur-ýr-ova-t
zchytřet 	 z-chytř-e-t 	 z-chytř-e-t
baconovi 	 bacon-ovi 	 bacon-ovi
vklínovaný 	 v-klín-ova-n-ý 	 v-klín-ova-n-ý
chýší 	 chýš-í 	 chýš-í
dívali 	 dív-a-l-i 	 dív-a-l-i
mezimozku 	 mezi-mozk-u 	 mezi-mozk-u
vyčleňovat 	 vy-čleň-ova-t 	 vy-čleň-ova-t
jola 	 jol-a 	 jol-a
nezáleží 	 ne-zá-lež-í 	 ne-zá-lež-í
poušť 	 poušť 	 poušť
zabudovat 	 za-bud-ova-t 	 za-bud-ova-t
klouže 	 klouž-e 	 klouž-e
nečesal 	 ne-čes-a-l 	 ne-čes-a-l
pohrdávat 	 po-hrd-á-v-a-t 	 po-hrd-á-v-a-t
funkci 	 funkc-i 	 funkc-i
ožebračit 	 o-žebr-ač-i-t 	 o-žebr-ač-i-t
napínák 	 na-pín-ák 	 na-pín-ák
ledkovat 	 led-k-ova-t 	 led-k-ova-t
zamhouřit 	 za-mhouř-i-t 	 za-mhouř-i-t
oloupit 	 o-loup-i-t 	 o-loup-i-t
kluk 	 kluk 	 kluk
valil 	 val-i-l 	 val-i-l
kmotro 	 kmotr-o 	 kmotr-o
nechalo 	 nech-a-l-o 	 nech-a-l-o
zamhuřovat 	 za-mhuř-ova-t 	 za-mhuř-ova-t
souhlasí 	 sou-hlas-í 	 sou-hlas-í
zachytat 	 za-chyt-a-t 	 za-chyt-a-t
šlapat 	 šlap-a-t 	 šlap-a-t
taft 	 taft 	 taft
ujišťovala 	 u-jišť-ova-l-a 	 u-jišť-ova-l-a
beta 	 bet-a 	 bet-a
četní 	 čet-n-í 	 čet-n-í
sorbovat 	 sorb-ova-t 	 sorb-ova-t
hlučnej 	 hluč-n-ej 	 hluč-n-ej
loupávat 	 loup-á-v-a-t 	 loup-á-v-a-t
mikrosporami 	 mikro-spor-ami 	 mikro-spor-ami
tělo 	 těl-o 	 těl-o
narodily 	 na-rod-i-l-y 	 na-rod-i-l-y
odpočítat 	 od-po-čít-a-t 	 od-po-čít-a-t
nacházet 	 na-cház-e-t 	 na-cház-e-t
patera 	 pater-a 	 pater-a
srazil 	 s-raz-i-l 	 s-raz-i-l
šámbr 	 šámbr 	 šámbr
pročišťovat 	 pro-čišť-ova-t 	 pro-čišť-ova-t
ohřebit 	 o-hřeb-i-t 	 o-hřeb-i-t
bezpečnosti 	 bezpeč-n-ost-i 	 bezpeč-n-ost-i
levonohého 	 lev-o-noh-ého 	 lev-o-noh-ého
dialekt 	 dia-lekt 	 dia-lekt
fermežovat 	 fermež-ova-t 	 fermež-ova-t
zaviklat 	 za-vikl-a-t 	 za-vikl-a-t
natěšit 	 na-těš-i-t 	 na-těš-i-t
upěchovat 	 u-pěch-ova-t 	 u-pěch-ova-t
přijmete 	 při-j-me-te 	 při-j-me-te
odpozorovat 	 od-po-zor-ova-t 	 od-po-zor-ova-t
rozkatit 	 roz-kat-i-t 	 roz-kat-i-t
uvědomit 	 u-věd-om-i-t 	 u-věd-om-i-t
elektřiny 	 elektř-in-y 	 elektř-in-y
italského 	 ital-sk-ého 	 ital-sk-ého
vrat 	 vrat 	 vrat
pivotéka 	 piv-o-ték-a 	 piv-o-ték-a
rozměňující 	 roz-měň-uj-íc-í 	 roz-měň-uj-íc-í
pomačkat 	 po-mačk-a-t 	 po-mačk-a-t
rozestřela 	 roze-stře-l-a 	 roze-stře-l-a
nejistý 	 ne-jist-ý 	 ne-jist-ý
pozemky 	 po-zem-k-y 	 po-zem-k-y
uniformovat 	 uni-form-ova-t 	 uni-form-ova-t
nakvísti 	 na-kvís-ti 	 na-kvís-ti
náturu 	 nátur-u 	 nátur-u
dres 	 dres 	 dres
alarmovat 	 alarm-ova-t 	 alarm-ova-t
čumívávat 	 čum-í-v-á-v-a-t 	 čum-í-v-á-v-a-t
stříbra 	 stříbr-a 	 stříbr-a
slibující 	 s-lib-uj-íc-í 	 s-lib-uj-íc-í
tabelovat 	 tabel-ova-t 	 tabel-ova-t
přiříznout 	 při-říz-nou-t 	 při-říz-nou-t
vypadat 	 vy-pad-a-t 	 vy-pad-a-t
vracet 	 vrac-e-t 	 vrac-e-t
nepřede 	 ne-před-e 	 ne-před-e
brožovat 	 brož-ova-t 	 brož-ova-t
čorba 	 čorb-a 	 čorb-a
pohladila 	 po-hlad-i-l-a 	 po-hlad-i-l-a
flikovat 	 flik-ova-t 	 flik-ova-t
zalomit 	 za-lom-i-t 	 za-lom-i-t
branku 	 bran-k-u 	 bran-k-u
jihokorejcům 	 jih-o-korej-c-ům 	 jih-o-korej-c-ům
nalezení 	 na-lez-en-í 	 na-lez-en-í
napovědět 	 na-po-věd-ě-t 	 na-po-věd-ě-t
šimůnek 	 šimůn-ek 	 šimůn-ek
šoupnout 	 šoup-nou-t 	 šoup-nou-t
oplocovat 	 o-ploc-ova-t 	 o-ploc-ova-t
pláč 	 pláč 	 pláč
koní 	 kon-í 	 kon-í
koučovat 	 kouč-ova-t 	 kouč-ova-t
jinačit 	 jin-ač-i-t 	 jin-ač-i-t
skip 	 skip 	 skip
scratchovat 	 scratch-ova-t 	 scratch-ova-t
odepnout 	 ode-pn-ou-t 	 ode-pn-ou-t
zdvojit 	 z-dv-oj-i-t 	 z-dv-oj-i-t
zásahu 	 zá-sah-u 	 zá-sah-u
zahřmít 	 za-hřm-í-t 	 za-hřm-í-t
uštěknout 	 u-štěk-nou-t 	 u-štěk-nou-t
zfušovat 	 z-fuš-ova-t 	 z-fuš-ova-t
plastický 	 plast-ic-k-ý 	 plast-ic-k-ý
zazněla 	 za-zn-ě-l-a 	 za-zn-ě-l-a
utěšili 	 u-těš-i-l-i 	 u-těš-i-l-i
zahulákat 	 za-hulák-a-t 	 za-hulák-a-t
odstín 	 od-stín 	 od-stín
cukrovat 	 cukr-ova-t 	 cukr-ova-t
odepisovat 	 ode-pis-ova-t 	 ode-pis-ova-t
krevní 	 krev-n-í 	 krev-n-í
severoirský 	 sever-o-ir-sk-ý 	 sever-o-ir-sk-ý
poznávat 	 po-zn-á-v-a-t 	 po-zn-á-v-a-t
královopolský 	 král-ov-o-pol-sk-ý 	 král-ov-o-pol-sk-ý
mořem 	 moř-em 	 moř-em
růstem 	 růst-em 	 růst-em
uklízet 	 u-klíz-e-t 	 u-klíz-e-t
užalovat 	 u-žal-ova-t 	 u-žal-ova-t
nažvástat 	 na-žvást-a-t 	 na-žvást-a-t
hirschovou 	 hirsch-ov-ou 	 hirsch-ov-ou
skoba 	 skob-a 	 skob-a
odcvičit 	 od-cvič-i-t 	 od-cvič-i-t
hašteřit 	 hašteř-i-t 	 hašteř-i-t
poznávajíce 	 po-zn-á-v-aj-íc-e 	 po-zn-á-v-aj-íc-e
nastat 	 na-sta-t 	 na-sta-t
prošacovávat 	 pro-šac-ová-v-a-t 	 pro-šac-ová-v-a-t
ráčit 	 ráč-i-t 	 ráč-i-t
odmlčet 	 od-mlč-e-t 	 od-mlč-e-t
zvětřit 	 z-větř-i-t 	 z-větř-i-t
okorávat 	 o-kor-á-v-a-t 	 o-kor-á-v-a-t
mimořádně 	 mimo-řád-n-ě 	 mimo-řád-n-ě
nevytrubuji 	 ne-vy-trub-uj-i 	 ne-vy-trub-uj-i
ruky 	 ruk-y 	 ruk-y
unavený 	 u-nav-en-ý 	 u-nav-en-ý
přikousnout 	 při-kous-nou-t 	 při-kous-nou-t
prochládat 	 pro-chlád-a-t 	 pro-chlád-a-t
poplacovat 	 po-plac-ova-t 	 po-plac-ova-t
posívat 	 po-sí-v-a-t 	 po-sí-v-a-t
strážnice 	 stráž-nic-e 	 stráž-nic-e
prča 	 prč-a 	 prč-a
ohromena 	 o-hrom-en-a 	 o-hrom-en-a
těšit 	 těš-i-t 	 těš-i-t
protijedoucí 	 proti-jed-ouc-í 	 proti-jed-ouc-í
nenahradí 	 ne-na-hrad-í 	 ne-na-hrad-í
plod 	 plod 	 plod
šňůře 	 šňůř-e 	 šňůř-e
svést 	 s-vést 	 s-vést
znenávidět 	 z-ne-ná-vid-ě-t 	 z-ne-ná-vid-ě-t
krápnout 	 kráp-nou-t 	 kráp-nou-t
oddlužovat 	 od-dluž-ova-t 	 od-dluž-ova-t
shodit 	 s-hod-i-t 	 s-hod-i-t
tvorbě 	 tvor-b-ě 	 tvor-b-ě
drožka 	 drožk-a 	 drožk-a
radioburza 	 radi-o-burz-a 	 radi-o-burz-a
revoluce 	 revoluc-e 	 revoluc-e
potrhává 	 po-trh-á-v-á 	 po-trh-á-v-á
zafetovat 	 za-fet-ova-t 	 za-fet-ova-t
skupinou 	 s-kup-in-ou 	 s-kup-in-ou
zakápnout 	 za-káp-nou-t 	 za-káp-nou-t
slunci 	 slun-c-i 	 slun-c-i
kriminálních 	 krimin-ál-n-ích 	 krimin-ál-n-ích
uchrupnout 	 u-chrup-nou-t 	 u-chrup-nou-t
paušalovat 	 paušal-ova-t 	 paušal-ova-t
lékaři 	 lék-ař-i 	 lék-ař-i
vlaštovek 	 vlašt-ov-ek 	 vlašt-ov-ek
nejpokornější 	 nej-po-kor-n-ěj-š-í 	 nej-po-kor-n-ěj-š-í
naťukávat 	 na-ťuk-á-v-a-t 	 na-ťuk-á-v-a-t
omrknout 	 o-mrk-nou-t 	 o-mrk-nou-t
přespádovat 	 pře-s-pád-ova-t 	 pře-s-pád-ova-t
of 	 o-f 	 o-f
zvelebit 	 z-veleb-i-t 	 z-veleb-i-t
domněnka 	 do-mn-ě-n-k-a 	 do-mn-ě-n-k-a
obeznávat 	 obe-zn-á-v-a-t 	 obe-zn-á-v-a-t
výzkum 	 vý-zkum 	 vý-zkum
fingovat 	 fing-ova-t 	 fing-ova-t
umazlit 	 u-maz-l-i-t 	 u-maz-l-i-t
chelsea 	 chelsea 	 chelsea
reakci 	 re-akc-i 	 re-akc-i
nálepkami 	 ná-lep-k-ami 	 ná-lep-k-ami
šibeničníku 	 šib-en-ič-n-ík-u 	 šib-en-ič-n-ík-u
usykávat 	 u-syk-á-v-a-t 	 u-syk-á-v-a-t
konkrétních 	 konkrét-n-ích 	 konkrét-n-ích
přestudovat 	 pře-stud-ova-t 	 pře-stud-ova-t
vztek 	 vz-tek 	 vz-tek
studeným 	 stud-en-ým 	 stud-en-ým
zlém 	 zl-ém 	 zl-ém
zasanovaný 	 za-san-ova-n-ý 	 za-san-ova-n-ý
uráčit 	 u-ráč-i-t 	 u-ráč-i-t
svetr 	 svetr 	 svetr
zneplatňovat 	 z-ne-plat-ň-ova-t 	 z-ne-plat-ň-ova-t
zranění 	 z-ran-ěn-í 	 z-ran-ěn-í
zpanštět 	 z-pan-št-ě-t 	 z-pan-št-ě-t
připomínky 	 při-po-mín-k-y 	 při-po-mín-k-y
vykolovat 	 vy-kol-ova-t 	 vy-kol-ova-t
vyklonit 	 vy-klon-i-t 	 vy-klon-i-t
arsenal 	 arsenal 	 arsenal
přičmoudit 	 při-čmoud-i-t 	 při-čmoud-i-t
probolet 	 pro-bol-e-t 	 pro-bol-e-t
fačovat 	 fač-ova-t 	 fač-ova-t
žlutohnědý 	 žlut-o-hněd-ý 	 žlut-o-hněd-ý
setřeny 	 se-tř-e-n-y 	 se-tř-e-n-y
osypávat 	 o-syp-á-v-a-t 	 o-syp-á-v-a-t
udiven 	 u-div-en 	 u-div-en
bílém 	 bíl-ém 	 bíl-ém
vysněžit 	 vy-sněž-i-t 	 vy-sněž-i-t
přecpat 	 pře-cp-a-t 	 pře-cp-a-t
souhlasu 	 sou-hlas-u 	 sou-hlas-u
dvouročka 	 dv-ou-roč-k-a 	 dv-ou-roč-k-a
kaktusům 	 kaktus-ům 	 kaktus-ům
přiházívat 	 při-ház-í-v-a-t 	 při-ház-í-v-a-t
brlina 	 brlin-a 	 brlin-a
prvoplánový 	 prv-o-plán-ov-ý 	 prv-o-plán-ov-ý
říhnout 	 říh-nou-t 	 říh-nou-t
sebedůvěry 	 seb-e-dů-věr-y 	 seb-e-dů-věr-y
motol 	 motol 	 motol
stiskat 	 s-tisk-a-t 	 s-tisk-a-t
opěvat 	 o-pě-v-a-t 	 o-pě-v-a-t
ostrých 	 ostr-ých 	 ostr-ých
hesla 	 hesl-a 	 hesl-a
falocentrický 	 fal-o-centr-ick-ý 	 fal-o-centr-ick-ý
zchřadnout 	 z-chřad-nou-t 	 z-chřad-nou-t
synkopovat 	 syn-kop-ova-t 	 syn-kop-ova-t
triáda 	 triád-a 	 triád-a
vyhrnovat 	 vy-hrn-ova-t 	 vy-hrn-ova-t
kůl 	 kůl 	 kůl
západokarpatský 	 zá-pad-o-karpat-sk-ý 	 zá-pad-o-karpat-sk-ý
počítá 	 po-čít-á 	 po-čít-á
zjišťovat 	 z-jišť-ova-t 	 z-jišť-ova-t
příkrém 	 příkr-ém 	 příkr-ém
vydejchat 	 vy-dejch-a-t 	 vy-dejch-a-t
zaspávat 	 za-sp-á-v-a-t 	 za-sp-á-v-a-t
vidí 	 vid-í 	 vid-í
popudem 	 po-pud-em 	 po-pud-em
tuk 	 tuk 	 tuk
průjezdný 	 prů-jezd-n-ý 	 prů-jezd-n-ý
balabán 	 balabán 	 balabán
vynachvalovat 	 vy-na-chval-ova-t 	 vy-na-chval-ova-t
prozradila 	 pro-z-rad-i-l-a 	 pro-z-rad-i-l-a
chábr 	 chábr 	 chábr
obrábět 	 ob-ráb-ě-t 	 ob-ráb-ě-t
zřetelnosti 	 zř-e-teln-ost-i 	 zř-e-teln-ost-i
ukázaly 	 u-káz-a-l-y 	 u-káz-a-l-y
žádní 	 žád-n-í 	 žád-n-í
řachnout 	 řach-nou-t 	 řach-nou-t
stávajícího 	 stá-v-aj-íc-ího 	 stá-v-aj-íc-ího
čtvrt 	 čtvrt 	 čtvrt
pečeť 	 pečeť 	 pečeť
efektivní 	 efekt-iv-n-í 	 efekt-iv-n-í
nedávné 	 ne-dávn-é 	 ne-dávn-é
hrobu 	 hrob-u 	 hrob-u
konferenčních 	 kon-fer-enč-n-ích 	 kon-fer-enč-n-ích
zázračná 	 zá-zrač-n-á 	 zá-zrač-n-á
natlačit 	 na-tlač-i-t 	 na-tlač-i-t
lulat 	 lul-a-t 	 lul-a-t
prosténat 	 pro-stén-a-t 	 pro-stén-a-t
vševědova 	 vš-e-věd-ov-a 	 vš-e-věd-ov-a
manželé 	 manžel-é 	 manžel-é
bach 	 bach 	 bach
beran 	 beran 	 beran
výpovědi 	 vý-po-věd-i 	 vý-po-věd-i
průmyslové 	 prů-mysl-ov-é 	 prů-mysl-ov-é
poturčit 	 po-turč-i-t 	 po-turč-i-t
starým 	 star-ým 	 star-ým
sfázovat 	 s-fáz-ova-t 	 s-fáz-ova-t
princeznou 	 princ-ez-n-ou 	 princ-ez-n-ou
ryba 	 ryb-a 	 ryb-a
sabotáže 	 sabot-áž-e 	 sabot-áž-e
zakvítat 	 za-kvít-a-t 	 za-kvít-a-t
říkat 	 řík-a-t 	 řík-a-t
připadá 	 při-pad-á 	 při-pad-á
shodovalo 	 s-hod-ova-l-o 	 s-hod-ova-l-o
logika 	 log-ik-a 	 log-ik-a
občany 	 obč-an-y 	 obč-an-y
předrahá 	 pře-drah-á 	 pře-drah-á
vytyčit 	 vy-tyč-i-t 	 vy-tyč-i-t
posvětil 	 po-svět-i-l 	 po-svět-i-l
existuje 	 exist-uje 	 exist-uje
rozvážil 	 roz-váž-i-l 	 roz-váž-i-l
úřady 	 ú-řad-y 	 ú-řad-y
vyšmirglovat 	 vy-šmirgl-ova-t 	 vy-šmirgl-ova-t
poslanců 	 po-sl-a-n-c-ů 	 po-sl-a-n-c-ů
redoxní 	 redox-n-í 	 redox-n-í
zpolitizovávat 	 z-polit-iz-ová-v-a-t 	 z-polit-iz-ová-v-a-t
zúčastní 	 z-ú-čast-n-í 	 z-ú-čast-n-í
žádali 	 žád-a-l-i 	 žád-a-l-i
ty 	 t-y 	 t-y
zmontovat 	 z-mont-ova-t 	 z-mont-ova-t
dlani 	 dlan-i 	 dlan-i
dolů 	 dol-ů 	 dol-ů
cimrman 	 cimr-man 	 cimr-man
vyzdvihnout 	 vy-z-dvih-nou-t 	 vy-z-dvih-nou-t
kloaka 	 kloak-a 	 kloak-a
naklást 	 na-klást 	 na-klást
pap 	 pap 	 pap
vytrhávat 	 vy-trh-á-v-a-t 	 vy-trh-á-v-a-t
stočení 	 s-toč-en-í 	 s-toč-en-í
intelektuální 	 intelekt-uál-n-í 	 intelekt-uál-n-í
ježatý 	 jež-at-ý 	 jež-at-ý
natáhnul 	 na-táh-nu-l 	 na-táh-nu-l
povykovat 	 po-vyk-ova-t 	 po-vyk-ova-t
nevyvrátí 	 ne-vy-vrát-í 	 ne-vy-vrát-í
hraničit 	 hran-ič-i-t 	 hran-ič-i-t
zhodnotí 	 z-hod-n-ot-í 	 z-hod-n-ot-í
poloostrovu 	 polo-ostrov-u 	 polo-ostrov-u
osvobození 	 o-svoboz-en-í 	 o-svoboz-en-í
couvat 	 couv-a-t 	 couv-a-t
mořském 	 moř-sk-ém 	 moř-sk-ém
vybydlovat 	 vy-bydl-ova-t 	 vy-bydl-ova-t
chyži 	 chyž-i 	 chyž-i
právoplatné 	 práv-o-plat-n-é 	 práv-o-plat-n-é
šňupl 	 šňup-l 	 šňup-l
povídáme 	 po-víd-á-me 	 po-víd-á-me
virbl 	 virbl 	 virbl
americe 	 americ-e 	 americ-e
žernosecký 	 žern-o-sec-k-ý 	 žern-o-sec-k-ý
posílat 	 po-síl-a-t 	 po-síl-a-t
boršč 	 boršč 	 boršč
směnit 	 s-měn-i-t 	 s-měn-i-t
odkráčet 	 od-kráč-e-t 	 od-kráč-e-t
anděl 	 anděl 	 anděl
trabl 	 trabl 	 trabl
zaškaredět 	 za-škared-ě-t 	 za-škared-ě-t
přilísat 	 při-lís-a-t 	 při-lís-a-t
nižšímu 	 niž-š-ímu 	 niž-š-ímu
posvátném 	 po-svát-n-ém 	 po-svát-n-ém
neobyčejně 	 ne-obyčej-n-ě 	 ne-obyčej-n-ě
planý 	 plan-ý 	 plan-ý
páchlo 	 pách-l-o 	 pách-l-o
zneklidnit 	 z-ne-klid-n-i-t 	 z-ne-klid-n-i-t
drsek 	 drsek 	 drsek
vylizovat 	 vy-liz-ova-t 	 vy-liz-ova-t
psovi 	 ps-ovi 	 ps-ovi
rudém 	 rud-ém 	 rud-ém
pokles 	 po-kles 	 po-kles
rigolovat 	 rigol-ova-t 	 rigol-ova-t
koupi 	 koup-i 	 koup-i
vyžírat 	 vy-žír-a-t 	 vy-žír-a-t
metný 	 metn-ý 	 metn-ý
uvědomil 	 u-věd-om-i-l 	 u-věd-om-i-l
vydrbat 	 vy-drb-a-t 	 vy-drb-a-t
vyrobila 	 vy-rob-i-l-a 	 vy-rob-i-l-a
opryžovanost 	 o-pryž-ova-n-ost 	 o-pryž-ova-n-ost
třístupňové 	 tř-í-stup-ň-ov-é 	 tř-í-stup-ň-ov-é
lento 	 lent-o 	 lent-o
propařovat 	 pro-pař-ova-t 	 pro-pař-ova-t
klif 	 klif 	 klif
čechizovat 	 čech-iz-ova-t 	 čech-iz-ova-t
čtyřicítka 	 čtyř-i-cít-k-a 	 čtyř-i-cít-k-a
nazvětšovat 	 na-z-vět-š-ova-t 	 na-z-vět-š-ova-t
vozidel 	 voz-i-del 	 voz-i-del
chmýr 	 chmýr 	 chmýr
řešením 	 řeš-en-ím 	 řeš-en-ím
vajíčko 	 vajíč-k-o 	 vajíč-k-o
proklubat 	 pro-klub-a-t 	 pro-klub-a-t
hupnout 	 hup-nou-t 	 hup-nou-t
nálady 	 ná-lad-y 	 ná-lad-y
zavlažit 	 za-vlaž-i-t 	 za-vlaž-i-t
volávat 	 vol-á-v-a-t 	 vol-á-v-a-t
udřít 	 u-dř-í-t 	 u-dř-í-t
klienti 	 klient-i 	 klient-i
prohýbat 	 pro-hýb-a-t 	 pro-hýb-a-t
elektrony 	 elektr-on-y 	 elektr-on-y
alexandrii 	 alexandr-i-i 	 alexandr-i-i
dialog 	 dia-log 	 dia-log
přeplnit 	 pře-pln-i-t 	 pře-pln-i-t
ztloustla 	 z-tloust-l-a 	 z-tloust-l-a
sepisovat 	 se-pis-ova-t 	 se-pis-ova-t
seslat 	 se-sl-a-t 	 se-sl-a-t
zbili 	 z-bi-l-i 	 z-bi-l-i
svěsit 	 s-věs-i-t 	 s-věs-i-t
poseru 	 po-ser-u 	 po-ser-u
protisměru 	 proti-s-měr-u 	 proti-s-měr-u
pudlovat 	 pudl-ova-t 	 pudl-ova-t
zpraktičtět 	 z-prakt-ič-t-ě-t 	 z-prakt-ič-t-ě-t
huňaté 	 huň-at-é 	 huň-at-é
neklápl 	 ne-kláp-l 	 ne-kláp-l
šmiknout 	 šmik-nou-t 	 šmik-nou-t
nabídnout 	 na-bíd-nou-t 	 na-bíd-nou-t
popohánět 	 po-po-hán-ě-t 	 po-po-hán-ě-t
pětivrstvý 	 pět-i-vrstv-ý 	 pět-i-vrstv-ý
radiomateriál 	 radi-o-mater-iál 	 radi-o-mater-iál
zdravět 	 zdrav-ě-t 	 zdrav-ě-t
kouř 	 kouř 	 kouř
zabručeli 	 za-bruč-e-l-i 	 za-bruč-e-l-i
zavazadla 	 za-vaz-a-dl-a 	 za-vaz-a-dl-a
vyvarovat 	 vy-var-ova-t 	 vy-var-ova-t
podělávat 	 po-děl-á-v-a-t 	 po-děl-á-v-a-t
velkoklub 	 vel-k-o-klub 	 vel-k-o-klub
hampl 	 hampl 	 hampl
podepsala 	 pode-ps-a-l-a 	 pode-ps-a-l-a
zaspurtovat 	 za-spurt-ova-t 	 za-spurt-ova-t
přecvaknout 	 pře-cvak-nou-t 	 pře-cvak-nou-t
podsunovat 	 pod-sun-ova-t 	 pod-sun-ova-t
podlaze 	 pod-laz-e 	 pod-laz-e
přičísti 	 při-čís-ti 	 při-čís-ti
zahřešit 	 za-hřeš-i-t 	 za-hřeš-i-t
čistokrevný 	 čist-o-krev-n-ý 	 čist-o-krev-n-ý
přidražit 	 při-draž-i-t 	 při-draž-i-t
přivřít 	 při-vř-í-t 	 při-vř-í-t
nepravdivé 	 ne-prav-d-iv-é 	 ne-prav-d-iv-é
chmelařit 	 chmel-ař-i-t 	 chmel-ař-i-t
morgan 	 morgan 	 morgan
kosmické 	 kosm-ick-é 	 kosm-ick-é
zdupávat 	 z-dup-á-v-a-t 	 z-dup-á-v-a-t
protibushovský 	 proti-bush-ovsk-ý 	 proti-bush-ovsk-ý
doprovázívat 	 do-pro-váz-í-v-a-t 	 do-pro-váz-í-v-a-t
pravdě 	 prav-d-ě 	 prav-d-ě
zasypaný 	 za-syp-a-n-ý 	 za-syp-a-n-ý
českolipsko 	 čes-k-o-lip-sk-o 	 čes-k-o-lip-sk-o
rozšířila 	 roz-šíř-i-l-a 	 roz-šíř-i-l-a
činitel 	 čin-i-tel 	 čin-i-tel
zažití 	 za-ži-t-í 	 za-ži-t-í
vykonati 	 vy-kon-a-ti 	 vy-kon-a-ti
přezbrojit 	 pře-z-broj-i-t 	 pře-z-broj-i-t
ukotvovat 	 u-kotv-ova-t 	 u-kotv-ova-t
zpochybňovat 	 z-po-chyb-ň-ova-t 	 z-po-chyb-ň-ova-t
kabelovod 	 kabel-o-vod 	 kabel-o-vod
výhod 	 vý-hod 	 vý-hod
nesouhlasím 	 ne-sou-hlas-í-m 	 ne-sou-hlas-í-m
odchází 	 od-cház-í 	 od-cház-í
hallovi 	 hall-ovi 	 hall-ovi
lebeda 	 lebed-a 	 lebed-a
nevyspalá 	 ne-vy-sp-a-l-á 	 ne-vy-sp-a-l-á
nejdražší 	 nej-draž-š-í 	 nej-draž-š-í
čet 	 čet 	 čet
vyloudit 	 vy-loud-i-t 	 vy-loud-i-t
dosahuje 	 do-sah-uje 	 do-sah-uje
stenografovat 	 steno-graf-ova-t 	 steno-graf-ova-t
upatlat 	 u-patl-a-t 	 u-patl-a-t
bezvýznamné 	 bez-vý-znam-n-é 	 bez-vý-znam-n-é
zatrápení 	 za-tráp-en-í 	 za-tráp-en-í
rozjitřovat 	 roz-jitř-ova-t 	 roz-jitř-ova-t
vážnou 	 váž-n-ou 	 váž-n-ou
makrozvuk 	 makro-zvuk 	 makro-zvuk
povolme 	 po-vol-me 	 po-vol-me
jiří 	 jiř-í 	 jiř-í
věda 	 věd-a 	 věd-a
překulit 	 pře-kul-i-t 	 pře-kul-i-t
vysoušet 	 vy-souš-e-t 	 vy-souš-e-t
špionáží 	 špion-áž-í 	 špion-áž-í
znoj 	 znoj 	 znoj
pobryndávat 	 po-brynd-á-v-a-t 	 po-brynd-á-v-a-t
nebyli 	 ne-by-l-i 	 ne-by-l-i
ucrkující 	 u-crk-uj-íc-í 	 u-crk-uj-íc-í
kydat 	 kyd-a-t 	 kyd-a-t
jaromír 	 jaromír 	 jaromír
kozáků 	 kozák-ů 	 kozák-ů
vyráběly 	 vy-ráb-ě-l-y 	 vy-ráb-ě-l-y
vyplavat 	 vy-plav-a-t 	 vy-plav-a-t
nedostat 	 ne-do-sta-t 	 ne-do-sta-t
umluvit 	 u-mluv-i-t 	 u-mluv-i-t
útěšnými 	 ú-těš-n-ými 	 ú-těš-n-ými
vyrazíme 	 vy-raz-í-me 	 vy-raz-í-me
kaplan 	 kaplan 	 kaplan
statků 	 stat-k-ů 	 stat-k-ů
tůma 	 tům-a 	 tům-a
normálních 	 norm-ál-n-ích 	 norm-ál-n-ích
sprostit 	 s-prost-i-t 	 s-prost-i-t
už 	 už 	 už
smíchu 	 smích-u 	 smích-u
zkoušku 	 z-kouš-k-u 	 z-kouš-k-u
plak 	 plak 	 plak
výletě 	 vý-let-ě 	 vý-let-ě
okrajovat 	 o-kraj-ova-t 	 o-kraj-ova-t
nakopit 	 na-kop-i-t 	 na-kop-i-t
zaúsťovat 	 za-úsť-ova-t 	 za-úsť-ova-t
rýna 	 rýn-a 	 rýn-a
charles 	 charles 	 charles
rekonfigurovat 	 re-kon-fig-ur-ova-t 	 re-kon-fig-ur-ova-t
sekala 	 sek-a-l-a 	 sek-a-l-a
jednoosý 	 jedn-o-os-ý 	 jedn-o-os-ý
protrpět 	 pro-trp-ě-t 	 pro-trp-ě-t
troubit 	 troub-i-t 	 troub-i-t
práci 	 prác-i 	 prác-i
obalit 	 o-bal-i-t 	 o-bal-i-t
vejcorodých 	 vejc-o-rod-ých 	 vejc-o-rod-ých
vzduchu 	 vz-duch-u 	 vz-duch-u
odtřídit 	 od-tříd-i-t 	 od-tříd-i-t
sťatý 	 sťat-ý 	 sťat-ý
gaunerů 	 gauner-ů 	 gauner-ů
nervových 	 nerv-ov-ých 	 nerv-ov-ých
ptávat 	 pt-á-v-a-t 	 pt-á-v-a-t
kelt 	 kelt 	 kelt
trčit 	 trč-i-t 	 trč-i-t
recitovat 	 re-cit-ova-t 	 re-cit-ova-t
saň 	 saň 	 saň
společnostem 	 spol-eč-n-ost-em 	 spol-eč-n-ost-em
ulehčuje 	 u-leh-č-uje 	 u-leh-č-uje
fico 	 fic-o 	 fic-o
severokyperskou 	 sever-o-kyper-sk-ou 	 sever-o-kyper-sk-ou
fit 	 fit 	 fit
hřbetě 	 hřbet-ě 	 hřbet-ě
útulek 	 ú-tul-ek 	 ú-tul-ek
spojovací 	 s-poj-ova-c-í 	 s-poj-ova-c-í
věznit 	 věz-n-i-t 	 věz-n-i-t
odsedět 	 od-sed-ě-t 	 od-sed-ě-t
zamyslil 	 za-mysl-i-l 	 za-mysl-i-l
plotem 	 plot-em 	 plot-em
třítýdenní 	 tř-í-týden-n-í 	 tř-í-týden-n-í
brept 	 brept 	 brept
letecké 	 let-ec-k-é 	 let-ec-k-é
trevor 	 trevor 	 trevor
pornografii 	 porn-o-graf-i-i 	 porn-o-graf-i-i
morálním 	 morál-n-ím 	 morál-n-ím
dmýchat 	 dmých-a-t 	 dmých-a-t
estetickými 	 estet-ic-k-ými 	 estet-ic-k-ými
losangeleský 	 los-angeles-k-ý 	 los-angeles-k-ý
galakoncertem 	 gala-koncert-em 	 gala-koncert-em
vbít 	 v-bí-t 	 v-bí-t
jednotlivci 	 jedn-ot-liv-c-i 	 jedn-ot-liv-c-i
implikovat 	 im-plik-ova-t 	 im-plik-ova-t
zítra 	 zítr-a 	 zítr-a
projektů 	 pro-jekt-ů 	 pro-jekt-ů
pronájem 	 pro-ná-jem 	 pro-ná-jem
druhé 	 druh-é 	 druh-é
účetnímu 	 ú-čet-n-ímu 	 ú-čet-n-ímu
zavazující 	 za-vaz-uj-íc-í 	 za-vaz-uj-íc-í
zpytovat 	 z-pyt-ova-t 	 z-pyt-ova-t
tvořiti 	 tvoř-i-ti 	 tvoř-i-ti
zahleňovat 	 za-hleň-ova-t 	 za-hleň-ova-t
nejmenší 	 nej-men-š-í 	 nej-men-š-í
vzorná 	 v-zor-n-á 	 v-zor-n-á
pobyt 	 po-by-t 	 po-by-t
kousala 	 kous-a-l-a 	 kous-a-l-a
ztřískat 	 z-třísk-a-t 	 z-třísk-a-t
prázdné 	 prázdn-é 	 prázdn-é
vymámit 	 vy-mám-i-t 	 vy-mám-i-t
rozčilit 	 roz-čil-i-t 	 roz-čil-i-t
nešvařit 	 ne-švař-i-t 	 ne-švař-i-t
vyhraňovat 	 vy-hraň-ova-t 	 vy-hraň-ova-t
zintegrovat 	 z-in-tegr-ova-t 	 z-in-tegr-ova-t
chatt 	 chatt 	 chatt
označitelných 	 o-znač-i-teln-ých 	 o-znač-i-teln-ých
přeskakoval 	 pře-skak-ova-l 	 pře-skak-ova-l
jakov 	 jak-ov 	 jak-ov
ryps 	 ryps 	 ryps
federovat 	 feder-ova-t 	 feder-ova-t
mario 	 mari-o 	 mari-o
podkasat 	 pod-kas-a-t 	 pod-kas-a-t
vládním 	 vlád-n-ím 	 vlád-n-ím
utilitární 	 utilit-ár-n-í 	 utilit-ár-n-í
vedla 	 ved-l-a 	 ved-l-a
zedník 	 zed-ník 	 zed-ník
poodejít 	 po-ode-jí-t 	 po-ode-jí-t
nestřílel 	 ne-stříl-e-l 	 ne-stříl-e-l
štíně 	 štín-ě 	 štín-ě
lísknout 	 lísk-nou-t 	 lísk-nou-t
grafu 	 graf-u 	 graf-u
ideálem 	 ideál-em 	 ideál-em
super 	 super 	 super
louh 	 louh 	 louh
přeléčit 	 pře-léč-i-t 	 pře-léč-i-t
vypršet 	 vy-prš-e-t 	 vy-prš-e-t
dozorovat 	 do-zor-ova-t 	 do-zor-ova-t
výlučně 	 vý-luč-n-ě 	 vý-luč-n-ě
balíčkovat 	 bal-íč-k-ova-t 	 bal-íč-k-ova-t
vezpívat 	 ve-z-pí-v-a-t 	 ve-z-pí-v-a-t
díváte 	 dív-á-te 	 dív-á-te
formátovat 	 form-át-ova-t 	 form-át-ova-t
nakrafat 	 na-kraf-a-t 	 na-kraf-a-t
vzepřít 	 vze-př-í-t 	 vze-př-í-t
diplomové 	 diplom-ov-é 	 diplom-ov-é
šuměl 	 šum-ě-l 	 šum-ě-l
potřebám 	 po-třeb-á-m 	 po-třeb-á-m
vyhrabávat 	 vy-hrab-á-v-a-t 	 vy-hrab-á-v-a-t
rachotem 	 rach-ot-em 	 rach-ot-em
poklesl 	 po-kles-l 	 po-kles-l
působívat 	 pů-sob-í-v-a-t 	 pů-sob-í-v-a-t
zajamovat 	 za-jam-ova-t 	 za-jam-ova-t
kreol 	 kreol 	 kreol
pravdivý 	 prav-d-iv-ý 	 prav-d-iv-ý
odložené 	 od-lož-en-é 	 od-lož-en-é
vyobchodovat 	 vy-ob-chod-ova-t 	 vy-ob-chod-ova-t
doloupat 	 do-loup-a-t 	 do-loup-a-t
dvoustrana 	 dv-ou-stran-a 	 dv-ou-stran-a
rozkopat 	 roz-kop-a-t 	 roz-kop-a-t
kilotuna 	 kilo-tun-a 	 kilo-tun-a
amerikánská 	 amerik-án-sk-á 	 amerik-án-sk-á
sloupu 	 sloup-u 	 sloup-u
klopýtal 	 klopýt-a-l 	 klopýt-a-l
vyženu 	 vy-žen-u 	 vy-žen-u
zrudnout 	 z-rud-nou-t 	 z-rud-nou-t
srab 	 srab 	 srab
zpřísňovat 	 z-přísň-ova-t 	 z-přísň-ova-t
staromódní 	 star-o-mód-n-í 	 star-o-mód-n-í
tažené 	 taž-en-é 	 taž-en-é
skříni 	 skřín-i 	 skřín-i
přepojit 	 pře-poj-i-t 	 pře-poj-i-t
vbíjet 	 v-bíj-e-t 	 v-bíj-e-t
přidal 	 při-d-a-l 	 při-d-a-l
volané 	 vol-a-n-é 	 vol-a-n-é
mlel 	 ml-e-l 	 ml-e-l
generálmajor 	 generál-major 	 generál-major
narýt 	 na-rý-t 	 na-rý-t
jedním 	 jedn-ím 	 jedn-ím
světový 	 svět-ov-ý 	 svět-ov-ý
toneru 	 toner-u 	 toner-u
subjekty 	 sub-jekt-y 	 sub-jekt-y
vylíže 	 vy-líž-e 	 vy-líž-e
kradená 	 krad-en-á 	 krad-en-á
rozžvatlat 	 roz-žvatl-a-t 	 roz-žvatl-a-t
podmínkou 	 pod-mín-k-ou 	 pod-mín-k-ou
šumperku 	 šumperk-u 	 šumperk-u
principu 	 princip-u 	 princip-u
pestrobarevný 	 pestr-o-barev-n-ý 	 pestr-o-barev-n-ý
zmalovat 	 z-mal-ova-t 	 z-mal-ova-t
odkoupit 	 od-koup-i-t 	 od-koup-i-t
recht 	 recht 	 recht
manažerské 	 manaž-er-sk-é 	 manaž-er-sk-é
nemá 	 ne-m-á 	 ne-m-á
rozvlákňovat 	 roz-vlák-ň-ova-t 	 roz-vlák-ň-ova-t
nedošlo 	 ne-do-š-l-o 	 ne-do-š-l-o
oceňován 	 o-ceň-ová-n 	 o-ceň-ová-n
nastrkal 	 na-strk-a-l 	 na-strk-a-l
sesekat 	 se-sek-a-t 	 se-sek-a-t
částka 	 část-k-a 	 část-k-a
vstupenek 	 v-stup-en-ek 	 v-stup-en-ek
roztát 	 roz-tá-t 	 roz-tá-t
prodávala 	 pro-d-á-v-a-l-a 	 pro-d-á-v-a-l-a
stěžovatelé 	 s-těž-ova-tel-é 	 s-těž-ova-tel-é
bóra 	 bór-a 	 bór-a
úspěšných 	 ú-spěš-n-ých 	 ú-spěš-n-ých
prosytit 	 pro-syt-i-t 	 pro-syt-i-t
pasterizovat 	 paster-iz-ova-t 	 paster-iz-ova-t
prokaučovat 	 pro-kauč-ova-t 	 pro-kauč-ova-t
klíma 	 klím-a 	 klím-a
nabrnknout 	 na-brnk-nou-t 	 na-brnk-nou-t
gigajoul 	 giga-joul 	 giga-joul
zacvaknout 	 za-cvak-nou-t 	 za-cvak-nou-t
zamrmlat 	 za-mrml-a-t 	 za-mrml-a-t
šifrovaných 	 šifr-ova-n-ých 	 šifr-ova-n-ých
zápasů 	 zá-pas-ů 	 zá-pas-ů
náležitost 	 ná-lež-it-ost 	 ná-lež-it-ost
dyáda 	 dyád-a 	 dyád-a
umyslet 	 u-mysl-e-t 	 u-mysl-e-t
rozkmitat 	 roz-kmit-a-t 	 roz-kmit-a-t
rozplemeňovat 	 roz-plemeň-ova-t 	 roz-plemeň-ova-t
prétorský 	 prétor-sk-ý 	 prétor-sk-ý
jitrocel 	 jitr-o-cel 	 jitr-o-cel
napřed 	 na-před 	 na-před
rantl 	 rantl 	 rantl
vyfouknout 	 vy-fouk-nou-t 	 vy-fouk-nou-t
uchlastat 	 u-chlast-a-t 	 u-chlast-a-t
spolupráce 	 spolu-prác-e 	 spolu-prác-e
propouštívat 	 pro-poušt-í-v-a-t 	 pro-poušt-í-v-a-t
pánem 	 pán-em 	 pán-em
uchvacovat 	 u-chvac-ova-t 	 u-chvac-ova-t
rav 	 rav 	 rav
nebydlíme 	 ne-bydl-í-me 	 ne-bydl-í-me
zvedly 	 z-ved-l-y 	 z-ved-l-y
utříbit 	 u-tříb-i-t 	 u-tříb-i-t
čtyřlístek 	 čtyř-líst-ek 	 čtyř-líst-ek
svatost 	 svat-ost 	 svat-ost
silnic 	 sil-n-ic 	 sil-n-ic
zamezit 	 za-mez-i-t 	 za-mez-i-t
vzala 	 vz-a-l-a 	 vz-a-l-a
bázlivě 	 bá-z-l-iv-ě 	 bá-z-l-iv-ě
svatozář 	 svat-o-zář 	 svat-o-zář
výrobnu 	 vý-rob-n-u 	 vý-rob-n-u
podpisu 	 pod-pis-u 	 pod-pis-u
vojenská 	 voj-en-sk-á 	 voj-en-sk-á
vyklopit 	 vy-klop-i-t 	 vy-klop-i-t
nadýchat 	 na-dých-a-t 	 na-dých-a-t
namířeno 	 na-míř-en-o 	 na-míř-en-o
vážné 	 váž-n-é 	 váž-n-é
chorobných 	 chor-ob-n-ých 	 chor-ob-n-ých
míchávat 	 mích-á-v-a-t 	 mích-á-v-a-t
účel 	 ú-čel 	 ú-čel
ztekucený 	 z-tek-uc-en-ý 	 z-tek-uc-en-ý
regentíkův 	 regent-ík-ův 	 regent-ík-ův
výrazným 	 vý-raz-n-ým 	 vý-raz-n-ým
nadezdívat 	 nade-zd-í-v-a-t 	 nade-zd-í-v-a-t
puk 	 puk 	 puk
pokrucovat 	 po-kruc-ova-t 	 po-kruc-ova-t
popobíhat 	 po-po-bíh-a-t 	 po-po-bíh-a-t
veškeré 	 veš-k-er-é 	 veš-k-er-é
akademickému 	 akadem-ic-k-ému 	 akadem-ic-k-ému
překvapení 	 pře-kvap-en-í 	 pře-kvap-en-í
stupni 	 stup-n-i 	 stup-n-i
kušnit 	 kuš-n-i-t 	 kuš-n-i-t
svěřovat 	 s-věř-ova-t 	 s-věř-ova-t
bort 	 bort 	 bort
odtrhovat 	 od-trh-ova-t 	 od-trh-ova-t
kmihnout 	 kmih-nou-t 	 kmih-nou-t
staronové 	 star-o-nov-é 	 star-o-nov-é
zachvátit 	 za-chvát-i-t 	 za-chvát-i-t
obvinění 	 ob-vin-ěn-í 	 ob-vin-ěn-í
rozteskňovat 	 roz-tesk-ň-ova-t 	 roz-tesk-ň-ova-t
plandat 	 pland-a-t 	 pland-a-t
voptat 	 vo-pt-a-t 	 vo-pt-a-t
dřevohlinitý 	 dřev-o-hlin-it-ý 	 dřev-o-hlin-it-ý
nesl 	 nes-l 	 nes-l
šál 	 šál 	 šál
ožívat 	 o-ží-v-a-t 	 o-ží-v-a-t
vyplynulo 	 vy-ply-nu-l-o 	 vy-ply-nu-l-o
lídr 	 lídr 	 lídr
rohoží 	 rohož-í 	 rohož-í
primátora 	 prim-át-or-a 	 prim-át-or-a
zaoblit 	 za-obl-i-t 	 za-obl-i-t
nacizovat 	 nac-iz-ova-t 	 nac-iz-ova-t
hejtman 	 hejtman 	 hejtman
periferie 	 perifer-i-e 	 perifer-i-e
kartách 	 kart-ách 	 kart-ách
naseknout 	 na-sek-nou-t 	 na-sek-nou-t
zkušební 	 z-kuš-eb-n-í 	 z-kuš-eb-n-í
vrzat 	 vrz-a-t 	 vrz-a-t
knejp 	 knejp 	 knejp
cvrknout 	 cvrk-nou-t 	 cvrk-nou-t
zviklat 	 z-vikl-a-t 	 z-vikl-a-t
zavadit 	 za-vad-i-t 	 za-vad-i-t
zapojovat 	 za-poj-ova-t 	 za-poj-ova-t
vynulovat 	 vy-nul-ova-t 	 vy-nul-ova-t
velblouda 	 velbloud-a 	 velbloud-a
hrabat 	 hrab-a-t 	 hrab-a-t
špióny 	 špión-y 	 špión-y
přepravovat 	 pře-prav-ova-t 	 pře-prav-ova-t
bajle 	 bajl-e 	 bajl-e
ztáhnout 	 z-táh-nou-t 	 z-táh-nou-t
houpat 	 houp-a-t 	 houp-a-t
bezpečit 	 bezpeč-i-t 	 bezpeč-i-t
záchrany 	 zá-chran-y 	 zá-chran-y
probendit 	 pro-bend-i-t 	 pro-bend-i-t
naříkat 	 na-řík-a-t 	 na-řík-a-t
chutcharatkul 	 chutcharatkul 	 chutcharatkul
polehat 	 po-leh-a-t 	 po-leh-a-t
omoknout 	 o-mok-nou-t 	 o-mok-nou-t
domalovávat 	 do-mal-ová-v-a-t 	 do-mal-ová-v-a-t
šklebí 	 škleb-í 	 škleb-í
sdělení 	 s-děl-en-í 	 s-děl-en-í
ušlehat 	 u-šleh-a-t 	 u-šleh-a-t
přidusat 	 při-dus-a-t 	 při-dus-a-t
přidrnčet 	 při-drnč-e-t 	 při-drnč-e-t
vádí 	 vád-í 	 vád-í
nedělat 	 ne-děl-a-t 	 ne-děl-a-t
soutěž 	 sou-těž 	 sou-těž
cařihradě 	 cař-i-hrad-ě 	 cař-i-hrad-ě
doufání 	 douf-á-n-í 	 douf-á-n-í
prodáváme 	 pro-d-á-v-á-me 	 pro-d-á-v-á-me
oteplovat 	 o-tep-l-ova-t 	 o-tep-l-ova-t
paprika 	 paprik-a 	 paprik-a
vřed 	 vřed 	 vřed
barrandov 	 barrand-ov 	 barrand-ov
profesory 	 pro-fes-or-y 	 pro-fes-or-y
silně 	 sil-n-ě 	 sil-n-ě
zvytahat 	 z-vy-tah-a-t 	 z-vy-tah-a-t
omrdat 	 o-mrd-a-t 	 o-mrd-a-t
šestitisícové 	 šest-i-tisíc-ov-é 	 šest-i-tisíc-ov-é
koukat 	 kouk-a-t 	 kouk-a-t
povzdychávat 	 po-vz-dych-á-v-a-t 	 po-vz-dych-á-v-a-t
provalchovat 	 pro-valch-ova-t 	 pro-valch-ova-t
chřupat 	 chřup-a-t 	 chřup-a-t
kácet 	 kác-e-t 	 kác-e-t
strofa 	 strof-a 	 strof-a
trvalo 	 trv-a-l-o 	 trv-a-l-o
provléci 	 pro-vléc-i 	 pro-vléc-i
dolnorakouský 	 doln-o-rakous-k-ý 	 doln-o-rakous-k-ý
chromozóm 	 chromozóm 	 chromozóm
systémem 	 systém-em 	 systém-em
rozkoší 	 roz-koš-í 	 roz-koš-í
nedosahují 	 ne-do-sah-uj-í 	 ne-do-sah-uj-í
prstem 	 prst-em 	 prst-em
podemlít 	 pode-ml-í-t 	 pode-ml-í-t
obalu 	 o-bal-u 	 o-bal-u
zalepené 	 za-lep-en-é 	 za-lep-en-é
vytloukat 	 vy-tlouk-a-t 	 vy-tlouk-a-t
plynoinstalace 	 plyn-o-in-stal-ac-e 	 plyn-o-in-stal-ac-e
zaplítat 	 za-plít-a-t 	 za-plít-a-t
produkce 	 pro-duk-c-e 	 pro-duk-c-e
metamorfovat 	 meta-morf-ova-t 	 meta-morf-ova-t
formy 	 form-y 	 form-y
halou 	 hal-ou 	 hal-ou
rozvlékat 	 roz-vlék-a-t 	 roz-vlék-a-t
dodrncat 	 do-drnc-a-t 	 do-drnc-a-t
zašmodrchat 	 za-šmodrch-a-t 	 za-šmodrch-a-t
cenotvorba 	 cen-o-tvor-b-a 	 cen-o-tvor-b-a
skladů 	 s-klad-ů 	 s-klad-ů
cvrnk 	 cvrnk 	 cvrnk
balit 	 bal-i-t 	 bal-i-t
ukrutná 	 u-krut-n-á 	 u-krut-n-á
lord 	 lord 	 lord
sesadil 	 se-sad-i-l 	 se-sad-i-l
vymazat 	 vy-maz-a-t 	 vy-maz-a-t
zkřižovat 	 z-křiž-ova-t 	 z-křiž-ova-t
základu 	 zá-klad-u 	 zá-klad-u
znepřehledňovat 	 z-ne-pře-hled-ň-ova-t 	 z-ne-pře-hled-ň-ova-t
perfektně 	 per-fekt-n-ě 	 per-fekt-n-ě
přiškolit 	 při-škol-i-t 	 při-škol-i-t
vyhubnout 	 vy-hub-nou-t 	 vy-hub-nou-t
čaj 	 čaj 	 čaj
vyboulovat 	 vy-boul-ova-t 	 vy-boul-ova-t
spolehlivý 	 s-po-leh-liv-ý 	 s-po-leh-liv-ý
zmagnetizovat 	 z-magnet-iz-ova-t 	 z-magnet-iz-ova-t
naprášit 	 na-práš-i-t 	 na-práš-i-t
harvard 	 harvard 	 harvard
špitat 	 špit-a-t 	 špit-a-t
schopna 	 s-chop-n-a 	 s-chop-n-a
shrbit 	 s-hrb-i-t 	 s-hrb-i-t
trávy 	 tráv-y 	 tráv-y
zpíjet 	 z-píj-e-t 	 z-píj-e-t
naimplementovat 	 na-im-ple-ment-ova-t 	 na-im-ple-ment-ova-t
odporuje 	 od-por-uje 	 od-por-uje
chovávat 	 chov-á-v-a-t 	 chov-á-v-a-t
kamenět 	 kamen-ě-t 	 kamen-ě-t
psychologickým 	 psych-o-log-ick-ým 	 psych-o-log-ick-ým
řeknout 	 řek-nou-t 	 řek-nou-t
chlívce 	 chlív-c-e 	 chlív-c-e
doplahočit 	 do-plahoč-i-t 	 do-plahoč-i-t
producírovat 	 pro-duc-ír-ova-t 	 pro-duc-ír-ova-t
zavodnit 	 za-vod-n-i-t 	 za-vod-n-i-t
posadili 	 po-sad-i-l-i 	 po-sad-i-l-i
zvenkovštět 	 z-ven-k-ov-št-ě-t 	 z-ven-k-ov-št-ě-t
přepíšete 	 pře-píš-e-te 	 pře-píš-e-te
žili 	 ži-l-i 	 ži-l-i
dlužníků 	 dluž-n-ík-ů 	 dluž-n-ík-ů
diana 	 dian-a 	 dian-a
hlídkovat 	 hlíd-k-ova-t 	 hlíd-k-ova-t
obrátek 	 ob-rát-ek 	 ob-rát-ek
nahrbit 	 na-hrb-i-t 	 na-hrb-i-t
měkké 	 měk-k-é 	 měk-k-é
vylupat 	 vy-lup-a-t 	 vy-lup-a-t
rozcestí 	 roz-cest-í 	 roz-cest-í
odsouzen 	 od-souz-en 	 od-souz-en
vláha 	 vláh-a 	 vláh-a
močopudný 	 moč-o-pud-n-ý 	 moč-o-pud-n-ý
vychován 	 vy-chov-á-n 	 vy-chov-á-n
troskotat 	 trosk-ot-a-t 	 trosk-ot-a-t
potvrzují 	 po-tvrz-uj-í 	 po-tvrz-uj-í
zamrholit 	 za-mrhol-i-t 	 za-mrhol-i-t
dotovat 	 dot-ova-t 	 dot-ova-t
podařilo 	 po-dař-i-l-o 	 po-dař-i-l-o
vnad 	 vnad 	 vnad
akademizovat 	 akadem-iz-ova-t 	 akadem-iz-ova-t
fyzicky 	 fyzi-c-k-y 	 fyzi-c-k-y
uléhali 	 u-léh-a-l-i 	 u-léh-a-l-i
donucovat 	 do-nuc-ova-t 	 do-nuc-ova-t
víru 	 vír-u 	 vír-u
potakat 	 po-tak-a-t 	 po-tak-a-t
pin 	 pin 	 pin
poměr 	 po-měr 	 po-měr
dovedete 	 do-ved-e-te 	 do-ved-e-te
dělat 	 děl-a-t 	 děl-a-t
sever 	 sever 	 sever
rozpovídat 	 roz-po-víd-a-t 	 roz-po-víd-a-t
svezl 	 s-vez-l 	 s-vez-l
dřevokresba 	 dřev-o-kres-b-a 	 dřev-o-kres-b-a
klendra 	 klendr-a 	 klendr-a
mohli 	 moh-l-i 	 moh-l-i
zakňučet 	 za-kňuč-e-t 	 za-kňuč-e-t
vyšvihl 	 vy-švih-l 	 vy-švih-l
celosvětová 	 cel-o-svět-ov-á 	 cel-o-svět-ov-á
franěk 	 franěk 	 franěk
vehnat 	 ve-hn-a-t 	 ve-hn-a-t
přijeli 	 při-je-l-i 	 při-je-l-i
zajištěný 	 za-jišt-ěn-ý 	 za-jišt-ěn-ý
trhnout 	 trh-nou-t 	 trh-nou-t
zaklusat 	 za-klus-a-t 	 za-klus-a-t
vetnout 	 ve-tn-ou-t 	 ve-tn-ou-t
vlak 	 vlak 	 vlak
rozvést 	 roz-vést 	 roz-vést
všednosti 	 všedn-ost-i 	 všedn-ost-i
nebudeš 	 ne-bud-e-š 	 ne-bud-e-š
patch 	 patch 	 patch
vymáhat 	 vy-máh-a-t 	 vy-máh-a-t
rozkvasit 	 roz-kvas-i-t 	 roz-kvas-i-t
slabozraké 	 slab-o-zrak-é 	 slab-o-zrak-é
filozofii 	 fil-o-zof-i-i 	 fil-o-zof-i-i
vládní 	 vlád-n-í 	 vlád-n-í
kreml 	 kreml 	 kreml
amsterodamě 	 amsterodam-ě 	 amsterodam-ě
saldo 	 sald-o 	 sald-o
mcenský 	 mcensk-ý 	 mcensk-ý
zasmrádnout 	 za-smrád-nou-t 	 za-smrád-nou-t
vracel 	 vrac-e-l 	 vrac-e-l
rozplavat 	 roz-plav-a-t 	 roz-plav-a-t
pacholkem 	 pachol-k-em 	 pachol-k-em
poodevírat 	 po-ode-vír-a-t 	 po-ode-vír-a-t
důchodců 	 dů-chod-c-ů 	 dů-chod-c-ů
odvahu 	 od-vah-u 	 od-vah-u
přikodrcat 	 při-ko-drc-a-t 	 při-ko-drc-a-t
vztekem 	 vz-tek-em 	 vz-tek-em
doškobrtat 	 do-škobrt-a-t 	 do-škobrt-a-t
vnitropolitický 	 v-nitr-o-polit-ic-k-ý 	 v-nitr-o-polit-ic-k-ý
tepichy 	 tepich-y 	 tepich-y
novém 	 nov-ém 	 nov-ém
protřást 	 pro-třás-t 	 pro-třás-t
navrtět 	 na-vrt-ě-t 	 na-vrt-ě-t
zadrhl 	 za-drh-l 	 za-drh-l
rozetřít 	 roze-tř-í-t 	 roze-tř-í-t
inzulínový 	 inzulín-ov-ý 	 inzulín-ov-ý
prošlapat 	 pro-šlap-a-t 	 pro-šlap-a-t
přimlouvat 	 při-mlouv-a-t 	 při-mlouv-a-t
cápnout 	 cáp-nou-t 	 cáp-nou-t
rozstříknout 	 roz-střík-nou-t 	 roz-střík-nou-t
obtékat 	 ob-ték-a-t 	 ob-ték-a-t
šéfproducent 	 šéf-pro-duc-ent 	 šéf-pro-duc-ent
exportním 	 ex-port-n-ím 	 ex-port-n-ím
zbraní 	 z-bran-í 	 z-bran-í
vysmahovat 	 vy-smah-ova-t 	 vy-smah-ova-t
záchranných 	 zá-chran-n-ých 	 zá-chran-n-ých
toulal 	 toul-a-l 	 toul-a-l
předpis 	 před-pis 	 před-pis
povzbuzení 	 po-vz-buz-en-í 	 po-vz-buz-en-í
tiš 	 tiš 	 tiš
rošt 	 rošt 	 rošt
vyplazit 	 vy-plaz-i-t 	 vy-plaz-i-t
recenzovat 	 re-cenz-ova-t 	 re-cenz-ova-t
zkompletizovat 	 z-kom-plet-iz-ova-t 	 z-kom-plet-iz-ova-t
dočesávat 	 do-čes-á-v-a-t 	 do-čes-á-v-a-t
vyvinit 	 vy-vin-i-t 	 vy-vin-i-t
prostřelovat 	 pro-střel-ova-t 	 pro-střel-ova-t
duha 	 duh-a 	 duh-a
charakteristika 	 charakter-ist-ik-a 	 charakter-ist-ik-a
pyj 	 pyj 	 pyj
koutek 	 kout-ek 	 kout-ek
tržně 	 trž-n-ě 	 trž-n-ě
usedavého 	 u-sed-a-v-ého 	 u-sed-a-v-ého
lupenů 	 lup-en-ů 	 lup-en-ů
lahvičku 	 lahv-ičk-u 	 lahv-ičk-u
podávat 	 po-d-á-v-a-t 	 po-d-á-v-a-t
zhýčkat 	 z-hýč-k-a-t 	 z-hýč-k-a-t
zájemcům 	 zá-jem-c-ům 	 zá-jem-c-ům
západogermánský 	 zá-pad-o-germán-sk-ý 	 zá-pad-o-germán-sk-ý
zamykat 	 za-myk-a-t 	 za-myk-a-t
sykat 	 syk-a-t 	 syk-a-t
mými 	 m-ými 	 m-ými
čisto 	 čist-o 	 čist-o
opakuji 	 o-pak-uj-i 	 o-pak-uj-i
pohasnout 	 po-has-nou-t 	 po-has-nou-t
konfekci 	 kon-fekc-i 	 kon-fekc-i
mnohosti 	 mnoh-ost-i 	 mnoh-ost-i
přípravu 	 pří-prav-u 	 pří-prav-u
vranami 	 vran-ami 	 vran-ami
polského 	 pol-sk-ého 	 pol-sk-ého
turci 	 turc-i 	 turc-i
různobarevný 	 různ-o-barev-n-ý 	 různ-o-barev-n-ý
ztmavovat 	 z-tm-av-ova-t 	 z-tm-av-ova-t
stromě 	 strom-ě 	 strom-ě
rozuzlení 	 roz-uzl-en-í 	 roz-uzl-en-í
spravovat 	 s-prav-ova-t 	 s-prav-ova-t
rozměnit 	 roz-měn-i-t 	 roz-měn-i-t
překoupit 	 pře-koup-i-t 	 pře-koup-i-t
přečesat 	 pře-čes-a-t 	 pře-čes-a-t
hučet 	 huč-e-t 	 huč-e-t
jistého 	 jist-ého 	 jist-ého
způsobené 	 z-pů-sob-en-é 	 z-pů-sob-en-é
dolaru 	 dolar-u 	 dolar-u
pojmové 	 po-jm-ov-é 	 po-jm-ov-é
hlásila 	 hlás-i-l-a 	 hlás-i-l-a
rozkecat 	 roz-kec-a-t 	 roz-kec-a-t
zahozených 	 za-hoz-en-ých 	 za-hoz-en-ých
františkovi 	 frant-iš-k-ovi 	 frant-iš-k-ovi
vyjdeme 	 vy-jd-e-me 	 vy-jd-e-me
pochytávat 	 po-chyt-á-v-a-t 	 po-chyt-á-v-a-t
vyprýštět 	 vy-prýšt-ě-t 	 vy-prýšt-ě-t
umělokamenný 	 um-ě-l-o-kamen-n-ý 	 um-ě-l-o-kamen-n-ý
přelézat 	 pře-léz-a-t 	 pře-léz-a-t
džus 	 džus 	 džus
krejčí 	 krejč-í 	 krejč-í
nastřílet 	 na-stříl-e-t 	 na-stříl-e-t
sociálka 	 soci-ál-k-a 	 soci-ál-k-a
tvrdnout 	 tvrd-nou-t 	 tvrd-nou-t
prošmiknout 	 pro-šmik-nou-t 	 pro-šmik-nou-t
přesunuly 	 pře-su-nu-l-y 	 pře-su-nu-l-y
štafle 	 štafl-e 	 štafl-e
krajského 	 kraj-sk-ého 	 kraj-sk-ého
kára 	 kár-a 	 kár-a
vztyčovat 	 vz-tyč-ova-t 	 vz-tyč-ova-t
zřizovat 	 z-řiz-ova-t 	 z-řiz-ova-t
zamávnout 	 za-máv-nou-t 	 za-máv-nou-t
frotýrovat 	 frot-ýr-ova-t 	 frot-ýr-ova-t
barcelona 	 barcelon-a 	 barcelon-a
dotrénovat 	 do-trén-ova-t 	 do-trén-ova-t
naráží 	 na-ráž-í 	 na-ráž-í
psychiatrii 	 psych-iatr-i-i 	 psych-iatr-i-i
odlepovat 	 od-lep-ova-t 	 od-lep-ova-t
přikrytý 	 při-kry-t-ý 	 při-kry-t-ý
staroegyptský 	 star-o-egypt-sk-ý 	 star-o-egypt-sk-ý
vykrápět 	 vy-kráp-ě-t 	 vy-kráp-ě-t
válčívat 	 vál-č-í-v-a-t 	 vál-č-í-v-a-t
zakótovat 	 za-kót-ova-t 	 za-kót-ova-t
alternovat 	 alter-n-ova-t 	 alter-n-ova-t
ztišit 	 z-tiš-i-t 	 z-tiš-i-t
tichých 	 tich-ých 	 tich-ých
nevídanou 	 ne-víd-a-n-ou 	 ne-víd-a-n-ou
studijí 	 stud-ij-í 	 stud-ij-í
otrapa 	 o-trap-a 	 o-trap-a
vdole 	 vdol-e 	 vdol-e
zašeptnout 	 za-šept-nou-t 	 za-šept-nou-t
klidně 	 klid-n-ě 	 klid-n-ě
podměstečku 	 pod-měst-ečk-u 	 pod-měst-ečk-u
doučovat 	 do-uč-ova-t 	 do-uč-ova-t
peyotl 	 peyotl 	 peyotl
neposlouchal 	 ne-po-slouch-a-l 	 ne-po-slouch-a-l
přiklapnout 	 při-klap-nou-t 	 při-klap-nou-t
maž 	 maž 	 maž
domy 	 dom-y 	 dom-y
sjíždět 	 s-jížd-ě-t 	 s-jížd-ě-t
přeleží 	 pře-lež-í 	 pře-lež-í
skrájet 	 s-kráj-e-t 	 s-kráj-e-t
vykutálený 	 vy-kutál-en-ý 	 vy-kutál-en-ý
zkrátka 	 z-krát-k-a 	 z-krát-k-a
ohazovat 	 o-haz-ova-t 	 o-haz-ova-t
babrat 	 babr-a-t 	 babr-a-t
zhoblovat 	 z-hobl-ova-t 	 z-hobl-ova-t
obracet 	 ob-rac-e-t 	 ob-rac-e-t
budou 	 bud-ou 	 bud-ou
zkoušky 	 z-kouš-k-y 	 z-kouš-k-y
napučet 	 na-puč-e-t 	 na-puč-e-t
olympijské 	 olympij-sk-é 	 olympij-sk-é
škrdlit 	 škrdl-i-t 	 škrdl-i-t
potěšení 	 po-těš-en-í 	 po-těš-en-í
požadavků 	 po-žad-a-v-k-ů 	 po-žad-a-v-k-ů
rastr 	 rastr 	 rastr
rozřadit 	 roz-řad-i-t 	 roz-řad-i-t
souboru 	 sou-bor-u 	 sou-bor-u
uklovnout 	 u-klov-nou-t 	 u-klov-nou-t
dochucovat 	 do-chuc-ova-t 	 do-chuc-ova-t
škrtat 	 škrt-a-t 	 škrt-a-t
pravit 	 prav-i-t 	 prav-i-t
zcelovat 	 z-cel-ova-t 	 z-cel-ova-t
rest 	 rest 	 rest
canc 	 canc 	 canc
zabýváme 	 za-bý-v-á-me 	 za-bý-v-á-me
smluvněprávní 	 s-mluv-n-ě-práv-n-í 	 s-mluv-n-ě-práv-n-í
přežila 	 pře-ži-l-a 	 pře-ži-l-a
hluboko 	 hlub-ok-o 	 hlub-ok-o
zjišťovány 	 z-jišť-ová-n-y 	 z-jišť-ová-n-y
mynheer 	 mynheer 	 mynheer
zazářit 	 za-zář-i-t 	 za-zář-i-t
dvojhlásce 	 dv-oj-hlás-c-e 	 dv-oj-hlás-c-e
ucelovat 	 u-cel-ova-t 	 u-cel-ova-t
zadostičinit 	 za-dost-i-čin-i-t 	 za-dost-i-čin-i-t
zmáčknout 	 z-máčk-nou-t 	 z-máčk-nou-t
kvaltovat 	 kvalt-ova-t 	 kvalt-ova-t
schopnostmi 	 s-chop-n-ost-mi 	 s-chop-n-ost-mi
realitky 	 real-it-k-y 	 real-it-k-y
babo 	 bab-o 	 bab-o
riviéře 	 riviéř-e 	 riviéř-e
memorovat 	 memor-ova-t 	 memor-ova-t
odejmout 	 ode-jm-ou-t 	 ode-jm-ou-t
sesýpat 	 se-sýp-a-t 	 se-sýp-a-t
domovníkův 	 dom-ov-n-ík-ův 	 dom-ov-n-ík-ův
bahnit 	 bahn-i-t 	 bahn-i-t
spoje 	 s-poj-e 	 s-poj-e
radikalizovat 	 radik-al-iz-ova-t 	 radik-al-iz-ova-t
šestnáct 	 šest-náct 	 šest-náct
osudem 	 o-sud-em 	 o-sud-em
osminásobný 	 osm-i-násob-n-ý 	 osm-i-násob-n-ý
neodvoditelná 	 ne-od-vod-i-teln-á 	 ne-od-vod-i-teln-á
systematicky 	 system-at-ic-k-y 	 system-at-ic-k-y
zářil 	 zář-i-l 	 zář-i-l
vavřín 	 vavřín 	 vavřín
zebra 	 zebr-a 	 zebr-a
upoutávat 	 u-pout-á-v-a-t 	 u-pout-á-v-a-t
vymazovat 	 vy-maz-ova-t 	 vy-maz-ova-t
okem 	 ok-em 	 ok-em
veškera 	 veš-k-er-a 	 veš-k-er-a
zdusit 	 z-dus-i-t 	 z-dus-i-t
navozit 	 na-voz-i-t 	 na-voz-i-t
podtínat 	 pod-tín-a-t 	 pod-tín-a-t
normalizovaného 	 norm-al-iz-ova-n-ého 	 norm-al-iz-ova-n-ého
zlepšuje 	 z-lep-š-uje 	 z-lep-š-uje
obyčejné 	 obyčej-n-é 	 obyčej-n-é
připít 	 při-pí-t 	 při-pí-t
kobka 	 kobk-a 	 kobk-a
štace 	 štac-e 	 štac-e
zveršovat 	 z-verš-ova-t 	 z-verš-ova-t
perchta 	 percht-a 	 percht-a
vysoustružit 	 vy-sou-struž-i-t 	 vy-sou-struž-i-t
cestování 	 cest-ová-n-í 	 cest-ová-n-í
řádný 	 řád-n-ý 	 řád-n-ý
chrysleru 	 chrysler-u 	 chrysler-u
odtušil 	 od-tuš-i-l 	 od-tuš-i-l
jakpak 	 jak-pak 	 jak-pak
pohřební 	 po-hřeb-n-í 	 po-hřeb-n-í
završovat 	 za-vrš-ova-t 	 za-vrš-ova-t
léčebné 	 léč-eb-n-é 	 léč-eb-n-é
čtvrtit 	 čtvrt-i-t 	 čtvrt-i-t
best 	 best 	 best
oddaluje 	 od-dal-uje 	 od-dal-uje
dvojprávního 	 dv-oj-práv-n-ího 	 dv-oj-práv-n-ího
prošívat 	 pro-ší-v-a-t 	 pro-ší-v-a-t
dlažba 	 dlaž-b-a 	 dlaž-b-a
krajan 	 kraj-an 	 kraj-an
vlastnímu 	 vlast-n-ímu 	 vlast-n-ímu
le 	 le 	 le
šankr 	 šankr 	 šankr
obývací 	 o-bý-v-a-c-í 	 o-bý-v-a-c-í
shýbl 	 s-hýb-l 	 s-hýb-l
uhel 	 uhel 	 uhel
dožili 	 do-ži-l-i 	 do-ži-l-i
zašetřit 	 za-šetř-i-t 	 za-šetř-i-t
žužlat 	 žužl-a-t 	 žužl-a-t
alterovat 	 alter-ova-t 	 alter-ova-t
přirážky 	 při-ráž-k-y 	 při-ráž-k-y
volně 	 vol-n-ě 	 vol-n-ě
napucovat 	 na-puc-ova-t 	 na-puc-ova-t
předvářet 	 před-vář-e-t 	 před-vář-e-t
prochcat 	 pro-chc-a-t 	 pro-chc-a-t
zkormucovat 	 z-ko-rmuc-ova-t 	 z-ko-rmuc-ova-t
zahnat 	 za-hn-a-t 	 za-hn-a-t
udusit 	 u-dus-i-t 	 u-dus-i-t
vtělit 	 v-těl-i-t 	 v-těl-i-t
šlehat 	 šleh-a-t 	 šleh-a-t
lifrovat 	 lifr-ova-t 	 lifr-ova-t
přirovnat 	 při-rov-n-a-t 	 při-rov-n-a-t
stálozelený 	 stál-o-zelen-ý 	 stál-o-zelen-ý
roztancovat 	 roz-tanc-ova-t 	 roz-tanc-ova-t
kroužila 	 krouž-i-l-a 	 krouž-i-l-a
krutihlav 	 krut-i-hlav 	 krut-i-hlav
stříkat 	 střík-a-t 	 střík-a-t
dohřmít 	 do-hřm-í-t 	 do-hřm-í-t
dostříknout 	 do-střík-nou-t 	 do-střík-nou-t
způsobným 	 z-pů-sob-n-ým 	 z-pů-sob-n-ým
maskovat 	 mask-ova-t 	 mask-ova-t
tetky 	 tet-k-y 	 tet-k-y
zasejčkovat 	 za-sejč-k-ova-t 	 za-sejč-k-ova-t
připomenout 	 při-po-men-ou-t 	 při-po-men-ou-t
cítíme 	 cít-í-me 	 cít-í-me
rozletět 	 roz-let-ě-t 	 roz-let-ě-t
písní 	 písn-í 	 písn-í
hláska 	 hlás-k-a 	 hlás-k-a
oškrábat 	 o-škráb-a-t 	 o-škráb-a-t
pohonných 	 po-hon-n-ých 	 po-hon-n-ých
berdych 	 berdych 	 berdych
pohladit 	 po-hlad-i-t 	 po-hlad-i-t
přebíjet 	 pře-bíj-e-t 	 pře-bíj-e-t
strádáte 	 strád-á-te 	 strád-á-te
odmlouvat 	 od-mlouv-a-t 	 od-mlouv-a-t
naší 	 n-a-š-í 	 n-a-š-í
zašklíbit 	 za-šklíb-i-t 	 za-šklíb-i-t
poplácal 	 po-plác-a-l 	 po-plác-a-l
mokro 	 mok-r-o 	 mok-r-o
vyfajčit 	 vy-fajč-i-t 	 vy-fajč-i-t
zrnovatět 	 zrn-ov-at-ě-t 	 zrn-ov-at-ě-t
biomasa 	 bio-mas-a 	 bio-mas-a
nekonečných 	 ne-koneč-n-ých 	 ne-koneč-n-ých
potřebujete 	 po-třeb-uje-te 	 po-třeb-uje-te
popadl 	 po-pad-l 	 po-pad-l
neuspěchanost 	 ne-u-spěch-a-n-ost 	 ne-u-spěch-a-n-ost
horny 	 horn-y 	 horn-y
chrčet 	 chrč-e-t 	 chrč-e-t
spolehliví 	 s-po-leh-liv-í 	 s-po-leh-liv-í
letovice 	 let-ov-ic-e 	 let-ov-ic-e
drobná 	 drob-n-á 	 drob-n-á
doručení 	 do-ruč-en-í 	 do-ruč-en-í
libo 	 lib-o 	 lib-o
obé 	 ob-é 	 ob-é
změnilo 	 z-měn-i-l-o 	 z-měn-i-l-o
románský 	 román-sk-ý 	 román-sk-ý
odešla 	 ode-š-l-a 	 ode-š-l-a
nesmírnost 	 ne-s-mír-n-ost 	 ne-s-mír-n-ost
někam 	 ně-kam 	 ně-kam
činností 	 čin-n-ost-í 	 čin-n-ost-í
omačkat 	 o-mačk-a-t 	 o-mačk-a-t
nemusíte 	 ne-mus-í-te 	 ne-mus-í-te
serie 	 seri-e 	 seri-e
tišit 	 tiš-i-t 	 tiš-i-t
borovici 	 bor-ov-ic-i 	 bor-ov-ic-i
fyziku 	 fyzi-k-u 	 fyzi-k-u
pověsí 	 po-věs-í 	 po-věs-í
šálit 	 šál-i-t 	 šál-i-t
meteory 	 meteor-y 	 meteor-y
fryntová 	 frynt-ov-á 	 frynt-ov-á
šminka 	 šmink-a 	 šmink-a
mordem 	 mord-em 	 mord-em
lístky 	 líst-k-y 	 líst-k-y
připomínat 	 při-po-mín-a-t 	 při-po-mín-a-t
průměrném 	 prů-měr-n-ém 	 prů-měr-n-ém
lamino 	 lamin-o 	 lamin-o
úrodnou 	 ú-rod-n-ou 	 ú-rod-n-ou
čtyřčíslím 	 čtyř-čísl-ím 	 čtyř-čísl-ím
upinkat 	 u-pink-a-t 	 u-pink-a-t
rozsvětlit 	 roz-svět-l-i-t 	 roz-svět-l-i-t
vylulat 	 vy-lul-a-t 	 vy-lul-a-t
prodávaná 	 pro-d-á-v-a-n-á 	 pro-d-á-v-a-n-á
chybějící 	 chyb-ěj-íc-í 	 chyb-ěj-íc-í
zaštěklo 	 za-štěk-l-o 	 za-štěk-l-o
vyudit 	 vy-ud-i-t 	 vy-ud-i-t
dalimila 	 dalimil-a 	 dalimil-a
čichnout 	 čich-nou-t 	 čich-nou-t
vylamovat 	 vy-lam-ova-t 	 vy-lam-ova-t
oceli 	 ocel-i 	 ocel-i
gymnázium 	 gymnázi-um 	 gymnázi-um
páv 	 páv 	 páv
kapat 	 kap-a-t 	 kap-a-t
ukrajovat 	 u-kraj-ova-t 	 u-kraj-ova-t
uchopit 	 u-chop-i-t 	 u-chop-i-t
sblížit 	 s-blíž-i-t 	 s-blíž-i-t
administrovat 	 ad-mini-str-ova-t 	 ad-mini-str-ova-t
slavnostně 	 slav-n-ost-n-ě 	 slav-n-ost-n-ě
všeobjímající 	 vš-e-ob-jím-aj-íc-í 	 vš-e-ob-jím-aj-íc-í
ošklivý 	 oškliv-ý 	 oškliv-ý
přemazat 	 pře-maz-a-t 	 pře-maz-a-t
důležitější 	 dů-lež-it-ějš-í 	 dů-lež-it-ějš-í
fidli 	 fidl-i 	 fidl-i
převrtat 	 pře-vrt-a-t 	 pře-vrt-a-t
vrtejš 	 vrtejš 	 vrtejš
spojen 	 s-poj-en 	 s-poj-en
zchromnout 	 z-chrom-nou-t 	 z-chrom-nou-t
článků 	 člán-k-ů 	 člán-k-ů
vydlabovat 	 vy-dlab-ova-t 	 vy-dlab-ova-t
peníze 	 peníz-e 	 peníz-e
poškozuje 	 po-škoz-uje 	 po-škoz-uje
pobavit 	 po-bav-i-t 	 po-bav-i-t
karavanů 	 karavan-ů 	 karavan-ů
klisna 	 klisn-a 	 klisn-a
přikout 	 při-kou-t 	 při-kou-t
sebeobranu 	 seb-e-o-bran-u 	 seb-e-o-bran-u
docvičit 	 do-cvič-i-t 	 do-cvič-i-t
možného 	 mož-n-ého 	 mož-n-ého
střelecký 	 střel-ec-k-ý 	 střel-ec-k-ý
vydlabat 	 vy-dlab-a-t 	 vy-dlab-a-t
explikovat 	 ex-plik-ova-t 	 ex-plik-ova-t
raz 	 raz 	 raz
založená 	 za-lož-en-á 	 za-lož-en-á
dodává 	 do-d-á-v-á 	 do-d-á-v-á
merčit 	 merč-i-t 	 merč-i-t
důvod 	 dů-vod 	 dů-vod
hup 	 hup 	 hup
srocovat 	 s-roc-ova-t 	 s-roc-ova-t
protkání 	 pro-tk-á-n-í 	 pro-tk-á-n-í
dodrat 	 do-dr-a-t 	 do-dr-a-t
odcházejí 	 od-cház-ej-í 	 od-cház-ej-í
asimilovat 	 a-simil-ova-t 	 a-simil-ova-t
rozhrabat 	 roz-hrab-a-t 	 roz-hrab-a-t
znovuprožít 	 znovu-pro-ží-t 	 znovu-pro-ží-t
mládenec 	 mlád-en-ec 	 mlád-en-ec
naklepávat 	 na-klep-á-v-a-t 	 na-klep-á-v-a-t
rozsvěcovat 	 roz-svěc-ova-t 	 roz-svěc-ova-t
užmolit 	 u-žmol-i-t 	 u-žmol-i-t
buzerovat 	 buzer-ova-t 	 buzer-ova-t
protizákonný 	 proti-zá-kon-n-ý 	 proti-zá-kon-n-ý
bláznivá 	 blázn-iv-á 	 blázn-iv-á
jistota 	 jist-ot-a 	 jist-ot-a
smésti 	 s-més-ti 	 s-més-ti
oškrabávat 	 o-škrab-á-v-a-t 	 o-škrab-á-v-a-t
přiložit 	 při-lož-i-t 	 při-lož-i-t
radě 	 rad-ě 	 rad-ě
nasouvat 	 na-sou-v-a-t 	 na-sou-v-a-t
pracky 	 prac-k-y 	 prac-k-y
základem 	 zá-klad-em 	 zá-klad-em
proplout 	 pro-plou-t 	 pro-plou-t
dostupovat 	 do-stup-ova-t 	 do-stup-ova-t
odpilovat 	 od-pil-ova-t 	 od-pil-ova-t
sžírat 	 s-žír-a-t 	 s-žír-a-t
refaktovat 	 re-fakt-ova-t 	 re-fakt-ova-t
zjednodušený 	 z-jedn-o-duš-en-ý 	 z-jedn-o-duš-en-ý
rozcitlivět 	 roz-cit-l-iv-ě-t 	 roz-cit-l-iv-ě-t
odměřit 	 od-měř-i-t 	 od-měř-i-t
nové 	 nov-é 	 nov-é
cestička 	 cest-ičk-a 	 cest-ičk-a
rozhýbávat 	 roz-hýb-á-v-a-t 	 roz-hýb-á-v-a-t
důvěrném 	 dů-věr-n-ém 	 dů-věr-n-ém
zvrhat 	 z-vrh-a-t 	 z-vrh-a-t
kadencovat 	 kad-enc-ova-t 	 kad-enc-ova-t
nevinně 	 ne-vin-n-ě 	 ne-vin-n-ě
sekretářky 	 sekret-ář-k-y 	 sekret-ář-k-y
kinobus 	 kin-o-bus 	 kin-o-bus
lýkožravý 	 lýk-o-žr-a-v-ý 	 lýk-o-žr-a-v-ý
kájín 	 kájín 	 kájín
kouzlit 	 kouzl-i-t 	 kouzl-i-t
idea 	 ide-a 	 ide-a
stačily 	 stač-i-l-y 	 stač-i-l-y
trasovat 	 tras-ova-t 	 tras-ova-t
růžovět 	 růž-ov-ě-t 	 růž-ov-ě-t
rysech 	 rys-ech 	 rys-ech
perný 	 pern-ý 	 pern-ý
uložených 	 u-lož-en-ých 	 u-lož-en-ých
dóza 	 dóz-a 	 dóz-a
dohrkat 	 do-hrk-a-t 	 do-hrk-a-t
zapouzdřit 	 za-pouzdř-i-t 	 za-pouzdř-i-t
hrčet 	 hrč-e-t 	 hrč-e-t
tik 	 tik 	 tik
zesvětlovat 	 ze-svět-l-ova-t 	 ze-svět-l-ova-t
rozkošatět 	 roz-koš-at-ě-t 	 roz-koš-at-ě-t
vázanka 	 váz-a-n-k-a 	 váz-a-n-k-a
vyjádřitelna 	 vy-jádř-i-teln-a 	 vy-jádř-i-teln-a
přelouče 	 přelouč-e 	 přelouč-e
murray 	 murray 	 murray
omodřit 	 o-modř-i-t 	 o-modř-i-t
pootvírat 	 po-ot-vír-a-t 	 po-ot-vír-a-t
odcvaknout 	 od-cvak-nou-t 	 od-cvak-nou-t
special 	 speci-al 	 speci-al
švanda 	 švand-a 	 švand-a
nově 	 nov-ě 	 nov-ě
dopravovat 	 do-prav-ova-t 	 do-prav-ova-t
multiplikovat 	 multi-plik-ova-t 	 multi-plik-ova-t
čehož 	 č-eho-ž 	 č-eho-ž
devitalizovat 	 de-vit-al-iz-ova-t 	 de-vit-al-iz-ova-t
fed 	 fed 	 fed
dedukovat 	 de-duk-ova-t 	 de-duk-ova-t
nanaříkání 	 na-na-řík-á-n-í 	 na-na-řík-á-n-í
ustřeďovat 	 u-střeď-ova-t 	 u-střeď-ova-t
omladit 	 o-mlad-i-t 	 o-mlad-i-t
vyniknout 	 vy-nik-nou-t 	 vy-nik-nou-t
vysvlíkat 	 vy-s-vlík-a-t 	 vy-s-vlík-a-t
vyživit 	 vy-ži-v-i-t 	 vy-ži-v-i-t
levitovat 	 lev-it-ova-t 	 lev-it-ova-t
desinfikovat 	 des-in-fik-ova-t 	 des-in-fik-ova-t
poměřovat 	 po-měř-ova-t 	 po-měř-ova-t
kviz 	 kviz 	 kviz
oddělat 	 od-děl-a-t 	 od-děl-a-t
užívati 	 u-ží-v-a-ti 	 u-ží-v-a-ti
čtou 	 čt-ou 	 čt-ou
resyl 	 resyl 	 resyl
nadlehčovat 	 nad-leh-č-ova-t 	 nad-leh-č-ova-t
laicizovat 	 laic-iz-ova-t 	 laic-iz-ova-t
nasypávat 	 na-syp-á-v-a-t 	 na-syp-á-v-a-t
nasvačit 	 na-svač-i-t 	 na-svač-i-t
bystrc 	 bystrc 	 bystrc
gangu 	 gang-u 	 gang-u
ztrhávat 	 z-trh-á-v-a-t 	 z-trh-á-v-a-t
háj 	 háj 	 háj
urážka 	 u-ráž-k-a 	 u-ráž-k-a
oprášit 	 o-práš-i-t 	 o-práš-i-t
zaujatý 	 za-u-j-a-t-ý 	 za-u-j-a-t-ý
zpravodajství 	 z-prav-o-daj-stv-í 	 z-prav-o-daj-stv-í
pláchl 	 plách-l 	 plách-l
zvyšovat 	 z-vyš-ova-t 	 z-vyš-ova-t
fischer 	 fischer 	 fischer
vnitroplicní 	 v-nitr-o-plic-n-í 	 v-nitr-o-plic-n-í
podepřít 	 pode-př-í-t 	 pode-př-í-t
dopředsedovat 	 do-před-sed-ova-t 	 do-před-sed-ova-t
zvyšovala 	 z-vyš-ova-l-a 	 z-vyš-ova-l-a
rozšveholit 	 roz-švehol-i-t 	 roz-švehol-i-t
kostelů 	 kostel-ů 	 kostel-ů
spalovat 	 s-pal-ova-t 	 s-pal-ova-t
zeslábnout 	 ze-sláb-nou-t 	 ze-sláb-nou-t
opovrhovat 	 o-po-vrh-ova-t 	 o-po-vrh-ova-t
kaufcviku 	 kauf-cvik-u 	 kauf-cvik-u
zakoupení 	 za-koup-en-í 	 za-koup-en-í
důkladněji 	 dů-klad-n-ěji 	 dů-klad-n-ěji
tajnosti 	 taj-n-ost-i 	 taj-n-ost-i
rozutéci 	 roz-u-téc-i 	 roz-u-téc-i
promovat 	 pro-m-ova-t 	 pro-m-ova-t
prošťourat 	 pro-šťour-a-t 	 pro-šťour-a-t
čtyřdílnou 	 čtyř-díl-n-ou 	 čtyř-díl-n-ou
myšlení 	 myšl-e-n-í 	 myšl-e-n-í
pumpy 	 pump-y 	 pump-y
domněnek 	 do-mn-ě-n-ek 	 do-mn-ě-n-ek
sídlo 	 sídl-o 	 sídl-o
nadychovat 	 na-dych-ova-t 	 na-dych-ova-t
šestiválec 	 šest-i-vál-ec 	 šest-i-vál-ec
louka 	 louk-a 	 louk-a
procvaknout 	 pro-cvak-nou-t 	 pro-cvak-nou-t
scrabble 	 scrabbl-e 	 scrabbl-e
plat 	 plat 	 plat
odpovídalo 	 od-po-víd-a-l-o 	 od-po-víd-a-l-o
vyhrávat 	 vy-hrá-v-a-t 	 vy-hrá-v-a-t
vroubkovat 	 v-roub-k-ova-t 	 v-roub-k-ova-t
helmách 	 helm-ách 	 helm-ách
osmikilometrový 	 osm-i-kilo-metr-ov-ý 	 osm-i-kilo-metr-ov-ý
mnohodrátové 	 mnoh-o-drát-ov-é 	 mnoh-o-drát-ov-é
fárat 	 fár-a-t 	 fár-a-t
čekala 	 ček-a-l-a 	 ček-a-l-a
nalenošit 	 na-len-oš-i-t 	 na-len-oš-i-t
škvařit 	 škvař-i-t 	 škvař-i-t
schovávat 	 s-chov-á-v-a-t 	 s-chov-á-v-a-t
vyexpedovat 	 vy-ex-ped-ova-t 	 vy-ex-ped-ova-t
zajíkat 	 za-jík-a-t 	 za-jík-a-t
kryptocitát 	 krypto-cit-át 	 krypto-cit-át
zadrmolit 	 za-drmol-i-t 	 za-drmol-i-t
otesávat 	 o-tes-á-v-a-t 	 o-tes-á-v-a-t
stejnokroj 	 stejn-o-kroj 	 stejn-o-kroj
technokracii 	 techn-o-krac-i-i 	 techn-o-krac-i-i
heslo 	 hesl-o 	 hesl-o
desítiletích 	 desít-i-let-ích 	 desít-i-let-ích
univerzitě 	 uni-verz-it-ě 	 uni-verz-it-ě
vyjednávání 	 vy-jedn-á-v-á-n-í 	 vy-jedn-á-v-á-n-í
lysý 	 lys-ý 	 lys-ý
nejvnitřnější 	 nej-v-nitř-n-ěj-š-í 	 nej-v-nitř-n-ěj-š-í
schraňovat 	 s-chraň-ova-t 	 s-chraň-ova-t
chlorpikrin 	 chlorpikrin 	 chlorpikrin
úžas 	 ú-žas 	 ú-žas
nablýskání 	 na-blýsk-á-n-í 	 na-blýsk-á-n-í
resetovat 	 re-set-ova-t 	 re-set-ova-t
červen 	 červen 	 červen
přesypat 	 pře-syp-a-t 	 pře-syp-a-t
dekách 	 dek-ách 	 dek-ách
klub 	 klub 	 klub
programovat 	 pro-gram-ova-t 	 pro-gram-ova-t
desetiboje 	 deset-i-boj-e 	 deset-i-boj-e
žebrákům 	 žebr-ák-ům 	 žebr-ák-ům
snadná 	 snad-n-á 	 snad-n-á
vysmát 	 vy-smá-t 	 vy-smá-t
flámovat 	 flám-ova-t 	 flám-ova-t
sdělil 	 s-děl-i-l 	 s-děl-i-l
unikat 	 u-nik-a-t 	 u-nik-a-t
konat 	 kon-a-t 	 kon-a-t
zahákovat 	 za-hák-ova-t 	 za-hák-ova-t
sjeli 	 s-je-l-i 	 s-je-l-i
zvadnout 	 z-vad-nou-t 	 z-vad-nou-t
zmrzačit 	 z-mrz-ač-i-t 	 z-mrz-ač-i-t
arena 	 aren-a 	 aren-a
rozválet 	 roz-vál-e-t 	 roz-vál-e-t
úsvitě 	 ú-svit-ě 	 ú-svit-ě
knihomolství 	 knih-o-mol-stv-í 	 knih-o-mol-stv-í
zahanbit 	 za-han-b-i-t 	 za-han-b-i-t
drsnatět 	 drs-n-at-ě-t 	 drs-n-at-ě-t
zbla 	 zbl-a 	 zbl-a
velechytře 	 vele-chytř-e 	 vele-chytř-e
zprůchodnit 	 z-prů-chod-n-i-t 	 z-prů-chod-n-i-t
bůh 	 bůh 	 bůh
rozbublat 	 roz-bubl-a-t 	 roz-bubl-a-t
mluvívat 	 mluv-í-v-a-t 	 mluv-í-v-a-t
proštipovat 	 pro-štip-ova-t 	 pro-štip-ova-t
rif 	 rif 	 rif
čítávat 	 čít-á-v-a-t 	 čít-á-v-a-t
javor 	 javor 	 javor
smontovat 	 s-mont-ova-t 	 s-mont-ova-t
blonďatý 	 blonď-at-ý 	 blonď-at-ý
stanislavov 	 stanislav-ov 	 stanislav-ov
parse 	 pars-e 	 pars-e
řídícího 	 říd-íc-ího 	 říd-íc-ího
vzrušovat 	 vz-ruš-ova-t 	 vz-ruš-ova-t
přeuložit 	 pře-u-lož-i-t 	 pře-u-lož-i-t
vymodlovat 	 vy-modl-ova-t 	 vy-modl-ova-t
kondicionovat 	 kon-dic-ion-ova-t 	 kon-dic-ion-ova-t
méněcennou 	 méně-cen-n-ou 	 méně-cen-n-ou
přemýšlím 	 pře-mýšl-í-m 	 pře-mýšl-í-m
přihlédací 	 při-hléd-a-c-í 	 při-hléd-a-c-í
protlačovat 	 pro-tlač-ova-t 	 pro-tlač-ova-t
získala 	 získ-a-l-a 	 získ-a-l-a
sezvat 	 se-zv-a-t 	 se-zv-a-t
zaúřadovat 	 za-ú-řad-ova-t 	 za-ú-řad-ova-t
prokazovat 	 pro-kaz-ova-t 	 pro-kaz-ova-t
rozčesat 	 roz-čes-a-t 	 roz-čes-a-t
klížit 	 klíž-i-t 	 klíž-i-t
vykovat 	 vy-kov-a-t 	 vy-kov-a-t
psané 	 ps-a-n-é 	 ps-a-n-é
monogram 	 mono-gram 	 mono-gram
masky 	 mask-y 	 mask-y
nadnést 	 nad-nés-t 	 nad-nés-t
vyhonit 	 vy-hon-i-t 	 vy-hon-i-t
omalovávat 	 o-mal-ová-v-a-t 	 o-mal-ová-v-a-t
přeorientovávat 	 pře-orient-ová-v-a-t 	 pře-orient-ová-v-a-t
ústech 	 úst-ech 	 úst-ech
