absolventi 	 ab-solv-ent-i 	 absolvent-i
achronisticky 	 a-chron-ist-ic-k-y 	 achronistick-y
adaptabilní 	 adapt-abil-n-í 	 adaptabiln-í
adresátů 	 adres-át-ů 	 adresát-ů
advokát 	 advok-át 	 ad-vokát
aktivitami 	 akt-iv-it-ami 	 aktivit-ami
aktovce 	 akt-ov-c-e 	 akt-ovc-e
aktuálního 	 akt-uál-n-ího 	 aktuál-ního
albigenský 	 albigen-sk-ý 	 albigensk-ý
amerikanismem 	 amerik-an-ism-e-m 	 amerikan-ism-em
amerikánská 	 amerik-án-sk-á 	 amerikán-sk-á
anatólii 	 anatól-i-i 	 anatóli-i
anglii 	 angl-i-i 	 angl-ii
anglosaskou 	 angl-o-sas-k-ou 	 angl-osas-k-ou
antala 	 antal-a 	 anta-la
architektury 	 archi-tekt-ur-y 	 architekt-ur-y
argentiny 	 argentin-y 	 argent-in-y
armáda 	 armád-a 	 armáda
asekurovat 	 a-sekur-ova-t 	 asekur-ova-t
asistentů 	 asist-ent-ů 	 asistent-ů
atamanem 	 ataman-e-m 	 ataman-em
automobilka 	 automobil-k-a 	 auto-mobil-k-a
autorská 	 autor-sk-á 	 aut-orsk-á
avšak 	 a-však 	 avšak
axiomy 	 axiom-y 	 axiomy
babičku 	 bab-ič-k-u 	 bab-ičku
badenu 	 baden-u 	 badenu
bakalářském 	 bakalář-sk-ém 	 bakalářském
balený 	 bal-en-ý 	 balený
balených 	 bal-en-ých 	 balených
bankovek 	 bank-ovek 	 bankovek
bankovním 	 bank-ovn-ím 	 bank-ovním
barona 	 baron-a 	 barona
benzylchorid 	 benz-yl-chor-id 	 benzyl-chor-id
berehovsky 	 bereh-ov-sk-y 	 berehovsk-y
betlémské 	 betlém-sk-é 	 betlémsk-é
bezchybný 	 bez-chyb-n-ý 	 bez-chybn-ý
bezesných 	 beze-sn-ých 	 bezes-n-ých
bezpředpokladová 	 bez-před-po-klad-ov-á 	 bez-předpo-klad-ová
bionaftu 	 bio-naft-u 	 bionaft-u
biřmovat 	 biřm-ova-t 	 biřm-ovat
blafat 	 blaf-a-t 	 blaf-at
blahopřejeme 	 blah-o-pře-je-me 	 blah-opřeje-me
blechu 	 blech-u 	 blechu
blekotat 	 blek-ot-a-t 	 blek-ot-at
bližší 	 bliž-š-í 	 bližší
bloku 	 blok-u 	 bloku
bloumat 	 bloum-a-t 	 bloum-at
bludišti 	 blud-išt-i 	 blud-išti
bodiny 	 bod-in-y 	 bod-iny
božínku 	 bož-ín-k-u 	 božínku
brankář 	 bran-k-ář 	 brank-ář
britští 	 brit-št-í 	 britšt-í
bráchův 	 brách-ův 	 bráchův
buchnout 	 buch-nou-t 	 buch-nout
budiáf 	 budiáf 	 bud-iáf
budoucnosti 	 bud-ou-c-n-ost-i 	 bud-ouc-n-ost-i
budoucím 	 bud-ouc-ím 	 budoucím
budweiserová 	 budweiser-ov-á 	 bud-weiserov-á
bulletinu 	 bulletin-u 	 bullet-in-u
bums 	 bums 	 bum-s
bych 	 by-ch 	 bych
byznys 	 byznys 	 by-znys
bít 	 bí-t 	 bít
bývávaly 	 bý-v-á-v-a-l-y 	 býv-áva-ly
běláskové 	 běl-ás-k-ové 	 běláskové
běžně 	 běž-ně 	 běž-n-ě
běží 	 běž-í 	 běží
břežský 	 břež-sk-ý 	 břežský
bříško 	 bříš-k-o 	 bříško
celkové 	 cel-k-ov-é 	 cel-k-ové
celníky 	 cel-n-ík-y 	 celníky
celoživotní 	 cel-o-ži-v-ot-n-í 	 celoži-vot-n-í
cenovky 	 cen-ovk-y 	 cenov-k-y
ceník 	 cen-ík 	 ceník
cestující 	 cest-uj-í-c-í 	 cestuj-ící
chcíplá 	 chcíp-l-á 	 chcíplá
chlapec 	 chlap-ec 	 chlapec
chlapy 	 chlap-y 	 chlapy
chlapík 	 chlap-ík 	 chlapík
chromou 	 chrom-ou 	 chromou
chrstat 	 chrst-a-t 	 chrsta-t
chráněných 	 chrán-ěn-ých 	 chrán-ěných
chtěli 	 cht-ě-l-i 	 cht-ě-li
chudší 	 chud-š-í 	 chud-ší
chutnání 	 chut-n-á-n-í 	 chut-n-á-ní
chvalořečit 	 chval-o-řeč-i-t 	 chvalo-řeč-i-t
chvílích 	 chvíl-í-ch 	 chvíl-ích
chybějící 	 chyb-ěj-íc-í 	 chyb-ějící
chyběl 	 chyb-ě-l 	 chyběl
chystané 	 chyst-a-n-é 	 chysta-n-é
chystá 	 chyst-á 	 chystá
chytrý 	 chytr-ý 	 chytrý
cigarety 	 cigar-et-y 	 cigaret-y
cizince 	 ciz-in-c-e 	 ciz-inc-e
ctihodnými 	 ct-i-hod-n-ý-m-i 	 ct-i-hod-n-ými
curyšské 	 curyš-sk-é 	 curyšsk-é
cácorka 	 các-or-k-a 	 cácor-k-a
cílem 	 cíl-e-m 	 cíl-em
dakar 	 dakar 	 dak-ar
daktyloskopie 	 daktylo-skopi-e 	 daktyloskop-i-e
dali 	 d-a-l-i 	 da-l-i
dana 	 dan-a 	 d-a-n-a
dané 	 d-a-n-é 	 dan-é
deklarují 	 de-klar-uj-í 	 deklar-uj-í
delikátnostem 	 delikát-n-ost-e-m 	 delikát-n-ost-em
delonovsky 	 delon-ov-sk-y 	 delonovsk-y
delší 	 del-š-í 	 del-ší
denním 	 den-n-í-m 	 den-n-ím
devizové 	 deviz-ov-é 	 de-viz-ov-é
disciplíny 	 disciplín-y 	 dis-ciplíny
diskařský 	 disk-ař-sk-ý 	 diskařský
diskreditovat 	 dis-kred-it-ova-t 	 dis-kredit-ova-t
distanční 	 dis-tanč-n-í 	 dist-anč-n-í
divocí 	 div-oc-í 	 divocí
divoši 	 div-oš-i 	 div-oši
divák 	 div-ák 	 divák
dkp 	 d-k-p 	 dkp
dlážka 	 dláž-k-a 	 dláž-ka
dobrodiní 	 dobr-o-di-n-í 	 dobrodiní
dobrozdání 	 dobr-o-zd-á-n-í 	 dobrozdá-n-í
dobráka 	 dobr-ák-a 	 dobrák-a
dobyli 	 do-by-l-i 	 do-byli
docentů 	 docent-ů 	 do-cent-ů
dodacích 	 do-d-a-c-ích 	 do-dac-ích
dohodli 	 do-hod-l-i 	 do-hodl-i
dohromady 	 do-hromad-y 	 do-hromady
dokonalého 	 do-kon-a-l-é-ho 	 do-kon-a-l-ého
dokáže 	 do-káž-e 	 dokáže
dokáží 	 do-káž-í 	 dokáží
dolnolužický 	 doln-o-luž-ick-ý 	 dolnolužický
domlouvat 	 do-mlouv-a-t 	 do-mlouv-at
domáknout 	 do-mák-nou-t 	 domák-nou-t
dostávají 	 do-stá-v-aj-í 	 dostá-v-ají
dotazníky 	 do-taz-ník-y 	 dotazníky
dotazy 	 do-taz-y 	 do-tazy
dovnitř 	 do-v-nitř 	 do-vnitř
dovřít 	 do-vř-í-t 	 do-vří-t
doznávala 	 do-zn-á-v-a-l-a 	 do-zn-á-v-a-la
dozvíte 	 do-z-v-í-te 	 do-zví-te
dočtete 	 do-čt-e-te 	 do-čt-ete
dočíst 	 do-čís-t 	 do-číst
drbaný 	 drb-a-n-ý 	 drb-aný
drkotali 	 drk-ot-a-l-i 	 drk-ota-l-i
drožkář 	 drožk-ář 	 drožkář
druhém 	 druh-é-m 	 druh-ém
drátkách 	 drát-k-ách 	 drátk-ách
dupání 	 dup-á-n-í 	 dup-á-ní
durajková 	 durajk-ov-á 	 durajkov-á
dveřích 	 dveř-í-ch 	 dveřích
dvojnásobek 	 dv-oj-ná-sob-ek 	 dv-oj-násob-ek
dvojí 	 dv-oj-í 	 dvoj-í
dvorku 	 dvor-k-u 	 dvor-ku
dvouměsíční 	 dv-ou-měsíč-n-í 	 dvou-měsíč-n-í
dynamická 	 dynam-ic-k-á 	 dynamick-á
dynamika 	 dynam-ik-a 	 dynamika
dálkové 	 dál-k-ov-é 	 dál-k-ové
dívají 	 dív-aj-í 	 dív-ají
díváš 	 dív-á-š 	 dívá-š
dědečkův 	 děd-eč-k-ův 	 dědečkův
dětské 	 dět-sk-é 	 dět-ské
dětským 	 dět-sk-ým 	 dětským
dřívějších 	 dřív-ějš-ích 	 dřív-ějších
důchod 	 dů-chod 	 důchod
důchodového 	 dů-chod-ov-ého 	 důchod-ov-ého
důsledky 	 dů-sled-k-y 	 důsledky
ekonomickou 	 eko-nom-ick-ou 	 ekonomickou
empirických 	 empir-ic-k-ý-ch 	 empirických
energie 	 energ-i-e 	 energi-e
expansion 	 expansion 	 ex-pan-sion
faktorů 	 fakt-or-ů 	 faktor-ů
fakultní 	 fakult-n-í 	 fakultn-í
falšovat 	 falš-ova-t 	 falš-ovat
fanoušků 	 fan-oušk-ů 	 fanoušk-ů
farmaceutické 	 farmac-eut-ick-é 	 farmaceutic-k-é
filiace 	 fili-ac-e 	 filiac-e
filozofické 	 filo-zof-ic-k-é 	 fil-o-zofic-k-é
finesami 	 fines-ami 	 finesami
finálním 	 fin-ál-n-ím 	 fináln-ím
fondem 	 fondem 	 fond-em
formosu 	 formos-u 	 form-os-u
formulací 	 form-ul-ac-í 	 formulací
francisku 	 francisk-u 	 francisku
francouzsky 	 franc-ouz-sk-y 	 francouzsk-y
francouzského 	 franc-ouz-sk-ého 	 francouzsk-ého
františek 	 frant-iš-ek 	 františek
friesovský 	 fries-ov-sk-ý 	 friesovsk-ý
funkční 	 funkč-n-í 	 funkčn-í
fyzický 	 fyz-ic-k-ý 	 fyzický
fólie 	 fóli-e 	 fól-i-e
garance 	 garanc-e 	 garance
gastronomie 	 gastr-o-nom-i-e 	 gastro-nom-i-e
generace 	 gener-ac-e 	 generace
generál 	 gener-ál 	 generál
geralda 	 gerald-a 	 geralda
gestikulovat 	 gestik-ul-ova-t 	 gestikul-ova-t
glochidy 	 glochid-y 	 glochidy
graessnerii 	 graessnerii 	 graessner-i-i
gurkhský 	 gurkh-sk-ý 	 gurkhský
haló 	 haló 	 hal-ó
hejkavec 	 hejkavec 	 hej-kavec
hematologického 	 hemat-o-log-ick-ého 	 hemato-logick-ého
hergot 	 hergot 	 her-got
hladověli 	 hlad-ov-ě-l-i 	 hlad-ověl-i
hledajíc 	 hled-aj-íc 	 hled-ajíc
hledisku 	 hled-isk-u 	 hled-isku
hluboká 	 hlub-ok-á 	 hlub-oká
hlubší 	 hlub-š-í 	 hlubší
hmotnostní 	 hmot-n-ost-n-í 	 hmotnost-n-í
hmotného 	 hmot-n-é-ho 	 hmot-n-ého
hnutí 	 h-nu-t-í 	 hnu-t-í
hnípat 	 hníp-a-t 	 hníp-at
hnízdech 	 hnízd-e-ch 	 hnízdech
hochschule 	 hoch-schule 	 hochschul-e
hodinek 	 hodin-ek 	 hodinek
hodinou 	 hodin-ou 	 hodinou
hodláte 	 hodl-á-te 	 hodl-áte
hodnotím 	 hod-n-ot-í-m 	 hod-n-ot-ím
hodnotíte 	 hodn-ot-í-te 	 hod-n-ot-í-te
holandsku 	 holand-sk-u 	 holandsk-u
holiči 	 hol-i-č-i 	 hol-iči
holčičkou 	 hol-č-ič-k-ou 	 hol-čičkou
honili 	 hon-i-l-i 	 hon-i-li
horolezci 	 hor-o-lez-c-i 	 hor-olezc-i
horynových 	 horyn-ov-ých 	 hor-ynov-ých
hotelu 	 hotel-u 	 hotelu
hotovostí 	 hotov-ost-í 	 hotovost-í
houfovat 	 houf-ova-t 	 houf-ovat
houston 	 houston 	 hous-ton
hra 	 hr-a 	 hra
hranic 	 hran-ic 	 hranic
hrbáčův 	 hrb-áč-ův 	 hrbáčův
hromková 	 hrom-k-ov-á 	 hromková
hry 	 hr-y 	 hry
hubatou 	 hub-at-ou 	 hub-atou
husími 	 hus-í-m-i 	 hus-ími
hvězdičky 	 hvězd-ič-k-y 	 hvězdičky
hádali 	 hád-a-l-i 	 hád-a-li
hřbitov 	 hřbitov 	 hřb-itov
idejí 	 idej-í 	 idejí
identifikační 	 identi-fik-ač-n-í 	 identi-fikač-n-í
imigraci 	 i-migr-ac-i 	 imigrac-i
imunoenzymatický 	 imun-o-enzym-at-ick-ý 	 imunoenzymatický
indikátorem 	 in-dik-át-or-em 	 in-dikátor-em
individuální 	 in-divid-u-ál-n-í 	 individuál-n-í
informačním 	 in-form-ač-n-ím 	 in-formač-n-ím
inspektor 	 in-spekt-or 	 in-spektor
instalaci 	 in-stal-ac-i 	 instalac-i
inteligenci 	 intelig-enc-i 	 inteligenc-i
intuice 	 intuic-e 	 intuice
invalidní 	 in-valid-n-í 	 invalidn-í
investičními 	 in-vest-ič-n-ími 	 investič-ními
inzerátech 	 inzer-át-e-ch 	 inzerát-ech
inženýrském 	 inženýr-sk-ém 	 inženýrsk-ém
irkutsku 	 irkutsk-u 	 irk-utsk-u
ivančic 	 ivan-č-ic 	 ivančic
jablíčko 	 jablíč-k-o 	 jablíčko
jakoby 	 jak-o-by 	 jakoby
jakoupak 	 jak-ou-pak 	 jak-oupak
jakého 	 jak-é-ho 	 jak-ého
jakéhokoliv 	 jak-é-ho-koliv 	 jakéhokoliv
jamese 	 james-e 	 jamese
janské 	 jan-sk-é 	 jan-ské
japonský 	 japon-sk-ý 	 japonský
jazejček 	 jazejč-ek 	 jazejček
jednatelem 	 jedn-a-tel-e-m 	 jedn-a-tel-em
jednomotorových 	 jedn-o-motor-ov-ých 	 jedno-motor-ov-ých
jednoosý 	 jedn-o-os-ý 	 jedn-oosý
jedním 	 jedn-í-m 	 jedn-ím
jejích 	 je-j-í-ch 	 jejích
jeseníkách 	 jesen-ík-ách 	 jeseníkách
ježibabo 	 ježibab-o 	 ježibabo
jimž 	 j-i-m-ž 	 j-im-ž
jindy 	 jin-d-y 	 jind-y
jinonice 	 jinonic-e 	 jin-onic-e
jiskří 	 jiskř-í 	 jiskří
jmenují 	 jmen-u-j-í 	 jmen-uj-í
jubilovat 	 jubil-ova-t 	 jubilova-t
jupiterovy 	 jupiter-ov-y 	 jup-iterov-y
juránkův 	 jur-ánk-ův 	 jur-ánkův
jídlo 	 jí-dl-o 	 jídl-o
kadidlo 	 kad-i-dl-o 	 kad-i-dlo
kamaráda 	 kamarád-a 	 kamaráda
kanada 	 kanad-a 	 kanada
kanadou 	 kanad-ou 	 kanadou
kanadské 	 kanad-sk-é 	 kanad-ské
kanadském 	 kanad-sk-ém 	 kanadském
kanadský 	 kanad-sk-ý 	 kanadský
kanadských 	 kanad-sk-ých 	 kanadských
kanadským 	 kanad-sk-ým 	 kanadským
kanady 	 kanad-y 	 kanady
kanadě 	 kanad-ě 	 kanadě
kapacity 	 kapacit-y 	 kapacity
kapelu 	 kapel-u 	 kapelu
kapely 	 kapel-y 	 kapely
kapesníček 	 kapes-níč-ek 	 kapesníček
kapli 	 kapl-i 	 kap-li
kardašovy 	 kardašov-y 	 kardašovy
karlík 	 karl-ík 	 karlík
katalogy 	 kata-log-y 	 kata-logy
katalozích 	 kata-loz-ích 	 katalozích
kavalírem 	 kaval-ír-e-m 	 kavalírem
kavkám 	 kav-k-ám 	 kavkám
každému 	 každ-é-mu 	 každému
kdovíkdo 	 kd-o-v-í-kd-o 	 kd-ovíkdo
kdož 	 kdo-ž 	 kd-o-ž
kg 	 k-g 	 kg
klasifikaci 	 klasi-fik-ac-i 	 klasifikac-i
klesající 	 kles-aj-íc-í 	 klesající
klesly 	 kles-l-y 	 klesl-y
klesne 	 kles-ne 	 kles-n-e
kliniky 	 klinik-y 	 kliniky
kličku 	 klič-k-u 	 kličku
kličky 	 klič-k-y 	 kličky
klnout 	 kl-nou-t 	 klnou-t
kloakách 	 kloak-ách 	 kloakách
kluku 	 kluk-u 	 kluku
klášterem 	 klášter-e-m 	 klášterem
klít 	 klí-t 	 klít
kmihnout 	 kmih-nou-t 	 kmih-nout
knihovat 	 knih-ova-t 	 knih-ovat
knížete 	 kníž-et-e 	 kníž-ete
kocouří 	 koc-ouř-í 	 kocouří
kodrcat 	 kodrc-a-t 	 ko-drc-a-t
koho 	 k-o-ho 	 k-oho
komentovávající 	 koment-ová-v-aj-íc-í 	 koment-ovávající
komorník 	 komor-n-ík 	 komor-ník
kompetenci 	 kompet-enc-i 	 kompetenc-i
komu 	 k-o-mu 	 k-omu
konceptem 	 koncept-em 	 kon-cept-em
koncertní 	 koncert-n-í 	 kon-cert-n-í
koncipováním 	 kon-cip-ová-n-ím 	 koncip-ová-n-ím
konferovat 	 konfer-ova-t 	 kon-fer-ova-t
koninou 	 kon-in-ou 	 kon-inou
konkrétního 	 konkrét-n-ího 	 kon-krét-n-ího
konkrétnímu 	 kon-krét-n-í-mu 	 kon-krét-nímu
kontilití 	 konti-li-t-í 	 kontilití
kontraindikace 	 kontra-in-dik-ac-e 	 kontraindik-ac-e
kontrolorů 	 kontrol-or-ů 	 kontrolor-ů
kontroloři 	 kontrol-oř-i 	 kontroloř-i
konviktem 	 kon-vikt-e-m 	 konvikt-em
konírny 	 kon-ír-n-y 	 kon-írn-y
kopřivnická 	 kopřiv-n-ic-k-á 	 kopřivnick-á
korespondenčními 	 ko-re-spond-enč-n-ími 	 korespond-enč-n-ími
kosmického 	 kosm-ic-k-é-ho 	 kosmického
kostely 	 kostel-y 	 kostely
kostička 	 kost-ič-k-a 	 kostička
kostní 	 kost-n-í 	 kost-ní
kostýmy 	 kostým-y 	 kostýmy
koumat 	 koum-a-t 	 koum-at
koupete 	 koup-e-te 	 koup-ete
koutcíc 	 kout-c-íc 	 koutcíc
koutku 	 kout-k-u 	 kout-ku
koňských 	 koň-sk-ý-ch 	 koňských
kožiše 	 kož-iš-e 	 kožiše
kronikář 	 kronik-ář 	 kronikář
krysí 	 krys-í 	 krysí
krytý 	 kry-t-ý 	 kryt-ý
krádeže 	 krád-ež-e 	 krád-eže
krásným 	 krás-n-ý-m 	 krás-n-ým
kterého 	 kter-é-ho 	 kter-ého
kufříku 	 kufř-ík-u 	 kufřík-u
kupující 	 kup-uj-íc-í 	 kupující
kupírovat 	 kupír-ova-t 	 kup-írova-t
kuriozity 	 kurioz-it-y 	 kuriozit-y
kučeravět 	 kučer-av-ě-t 	 kučerav-ě-t
kvičela 	 kvič-e-l-a 	 kvič-el-a
křivkami 	 křiv-k-a-m-i 	 křiv-kami
křivkách 	 křiv-k-ách 	 křivkách
křídlem 	 kří-dl-e-m 	 křídlem
křísit 	 křís-i-t 	 křís-it
kůzlátek 	 kůzl-át-ek 	 kůzlátek
lavina 	 lav-in-a 	 lav-ina
lavírovat 	 lav-ír-ova-t 	 lavír-ova-t
laťkovat 	 lať-k-ova-t 	 lať-k-ovat
lecčems 	 lec-č-e-m-s 	 lec-č-em-s
lehkým 	 leh-k-ý-m 	 lehkým
lesním 	 les-n-ím 	 les-n-í-m
letadel 	 let-a-del 	 leta-del
letáky 	 let-ák-y 	 letáky
ležákem 	 lež-ák-em 	 ležákem
lhostejnět 	 lhostej-n-ě-t 	 lhostejn-ě-t
lidem 	 lid-e-m 	 lid-em
lidský 	 lid-sk-ý 	 lidský
limit 	 limit 	 lim-i-t
lkát 	 lk-á-t 	 lkát
logikou 	 log-ik-ou 	 log-ikou
loupežníkem 	 loup-ež-n-ík-e-m 	 loup-ež-ník-em
loupežníkovi 	 loup-ež-n-ík-ovi 	 loup-ež-ník-ovi
loupežníku 	 loup-ež-n-ík-u 	 loup-ež-ník-u
loupežníky 	 loup-ež-n-ík-y 	 loup-ež-níky
ltd 	 l-t-d 	 ltd
luděk 	 luděk 	 lud-ěk
lukách 	 luk-á-ch 	 luk-ách
lékařem 	 lék-ař-e-m 	 lékařem
lékem 	 lék-e-m 	 lék-em
lékárnám 	 lék-ár-n-ám 	 lék-ár-n-á-m
lístek 	 líst-ek 	 lístek
lístečcích 	 líst-ečc-ích 	 lístečcích
lístku 	 líst-k-u 	 líst-ku
lístky 	 líst-k-y 	 líst-ky
lístků 	 líst-k-ů 	 lístků
maiden 	 maid-en 	 maiden
majíce 	 m-aj-íc-e 	 m-ajíce
maličkosti 	 mal-ič-k-ost-i 	 mal-ičk-ost-i
maličký 	 mal-ič-k-ý 	 maličký
malkovského 	 malkovsk-ého 	 malk-ovsk-ého
manager 	 manag-er 	 manager
manýrám 	 manýr-á-m 	 manýrám
manželský 	 manžel-sk-ý 	 manželsk-ý
mariánských 	 mari-án-sk-ých 	 mariánských
marketingový 	 market-ing-ov-ý 	 market-ingov-ý
marrackův 	 marrack-ův 	 marrackův
masivní 	 mas-iv-n-í 	 masiv-n-í
materialisty 	 mater-i-al-ist-y 	 material-ist-y
materiálové 	 materi-ál-ov-é 	 materiál-ov-é
materiálu 	 mater-i-ál-u 	 materiál-u
matrice 	 matr-ic-e 	 matric-e
mazání 	 maz-á-n-í 	 maz-ání
mašlí 	 mašl-í 	 mašlí
meduňka 	 meduňk-a 	 meduňka
memnónovy 	 memnón-ov-y 	 mem-nón-ov-y
metafyzických 	 meta-fyz-ic-k-ý-ch 	 meta-fyzick-ých
metafyziku 	 meta-fyz-ik-u 	 meta-fyzik-u
metodologicky 	 metodo-log-ic-k-y 	 metodo-logick-y
mezitím 	 mezi-t-ím 	 mezití-m
meziříčí 	 mezi-říč-í 	 meziříčí
mečení 	 meč-e-n-í 	 meč-en-í
mikroorganismy 	 mikro-organ-ism-y 	 mikroorgan-ism-y
miliarda 	 miliard-a 	 mili-arda
milostpane 	 mil-ost-pan-e 	 mil-ostpane
minerální 	 minerál-n-í 	 mineráln-í
minimem 	 minim-em 	 minimem
minimum 	 minim-um 	 minimum
minulý 	 min-ul-ý 	 minulý
mj 	 m-j 	 mj
mladého 	 mlad-é-ho 	 mlad-ého
mlhy 	 mlh-y 	 mlhy
mluvící 	 mluv-íc-í 	 mluvící
mlýna 	 ml-ýn-a 	 mlýn-a
mlčeli 	 mlč-e-l-i 	 mlč-e-li
moderního 	 modern-í-ho 	 modern-ího
monopolu 	 mon-o-pol-u 	 mono-pol-u
moravec 	 morav-ec 	 moravec
morseovka 	 morse-ov-k-a 	 morseov-k-a
motivací 	 motiv-ac-í 	 motivací
motorlet 	 motor-let 	 motorl-e-t
motorletu 	 motor-let-u 	 motorlet-u
motorových 	 motor-ov-ých 	 motorových
možnostech 	 možn-ost-ech 	 mož-n-ost-ech
mužského 	 muž-sk-é-ho 	 muž-sk-ého
mužství 	 muž-stv-í 	 muž-ství
mysleli 	 mysl-e-l-i 	 mysl-el-i
mávne 	 máv-n-e 	 máv-ne
médií 	 médi-í 	 médií
mésti 	 mést-i 	 més-ti
míli 	 míl-i 	 míli
míním 	 mín-í-m 	 míním
mých 	 m-ý-ch 	 mých
měli 	 mě-l-i 	 m-ě-l-i
měřítka 	 měř-í-tk-a 	 měřítk-a
měřítku 	 měř-í-tk-u 	 měřítku
měšťanské 	 měšť-an-sk-é 	 měšť-ansk-é
mřížovec 	 mříž-ov-ec 	 mříž-ovec
nabitý 	 na-bi-t-ý 	 nabitý
nabyl 	 na-by-l 	 na-byl
nabytí 	 na-by-t-í 	 na-bytí
nabídkových 	 na-bíd-k-ov-ých 	 nabídkových
nabízených 	 na-bíz-en-ých 	 na-bíz-ených
nadcházející 	 nad-cház-ej-íc-í 	 nadcházející
nadindividuálního 	 nad-in-divid-u-ál-n-í-ho 	 nad-in-divid-u-ál-n-ího
nadějemi 	 na-děj-e-m-i 	 na-dějemi
nadřaděného 	 nad-řad-ěn-é-ho 	 nad-řad-ěn-ého
nadšení 	 na-dš-en-í 	 nad-šen-í
nadšením 	 na-dš-en-í-m 	 nad-šen-ím
nahřát 	 na-hřá-t 	 na-hřát
najatí 	 na-j-a-t-í 	 na-jat-í
namasírovat 	 na-mas-ír-ova-t 	 na-masír-ova-t
namlouvat 	 na-mlouv-a-t 	 na-mlouv-at
namoci 	 na-moc-i 	 na-moci
namésti 	 na-mést-i 	 na-més-ti
napočítal 	 na-po-čít-a-l 	 na-po-číta-l
narážím 	 na-ráž-í-m 	 na-ráž-ím
naskákat 	 na-skák-a-t 	 naskák-a-t
navyknout 	 na-vyk-nou-t 	 na-vyk-nout
naříci 	 na-říc-i 	 na-říci
naškrábnout 	 na-škráb-nou-t 	 na-škrábnou-t
nebaleného 	 ne-bal-en-ého 	 ne-balen-ého
nebalený 	 ne-bal-en-ý 	 ne-balený
nebrání 	 ne-brán-í 	 ne-br-án-í
nebyl 	 ne-by-l 	 ne-byl
nechybí 	 ne-chyb-í 	 ne-chybí
necítím 	 ne-cít-í-m 	 ne-cít-ím
nedaleko 	 ne-dal-ek-o 	 ne-dal-eko
nedefinovatelné 	 ne-de-fin-ova-teln-é 	 ne-de-fin-ova-telné
nedýchali 	 ne-dých-a-l-i 	 ne-dých-a-li
negativními 	 negat-iv-n-ími 	 neg-ativ-n-ími
neinkasoval 	 ne-in-kas-ova-l 	 ne-inkas-ova-l
nejaktivnější 	 nej-akt-iv-n-ějš-í 	 nejaktiv-n-ějš-í
nejcitlivějším 	 nej-cit-liv-ějš-ím 	 nejcitlivějším
nejdivočejší 	 nej-div-oč-ej-š-í 	 nej-divoč-ejš-í
nejkrásnějších 	 nej-krás-n-ěj-š-í-ch 	 nej-krás-n-ěj-š-ích
nejlíp 	 nej-líp 	 nejlíp
nejméně 	 nej-mén-ě 	 ne-j-mén-ě
nejpalčivější 	 nej-pal-č-iv-ěj-š-í 	 nej-pal-čivějš-í
nejpovolanějšímu 	 nej-po-vol-a-n-ějš-ímu 	 nej-povol-a-n-ějš-ímu
nejsladšího 	 nej-slad-š-í-ho 	 nej-slad-š-ího
nejsladším 	 nej-slad-š-í-m 	 nej-slad-ší-m
nejvzdálenější 	 nej-vz-dál-e-n-ěj-š-í 	 nej-vzdál-e-n-ějš-í
nejzřetelněji 	 nej-zř-e-tel-n-ěji 	 nej-zře-teln-ěji
nejčastějších 	 nej-čast-ěj-š-í-ch 	 nejčastěj-š-ích
nejžha 	 nej-žh-a 	 nej-žha
nekvete 	 ne-kvet-e 	 ne-kvete
nelegální 	 ne-leg-ál-n-í 	 ne-legál-ní
nemocenského 	 ne-moc-en-sk-ého 	 ne-mocen-sk-ého
nemálo 	 ne-mál-o 	 ne-málo
neměly 	 ne-m-ě-l-y 	 ne-m-ěl-y
nenamaže 	 ne-na-maž-e 	 ne-na-maže
neobtížím 	 ne-ob-tíž-í-m 	 ne-ob-tíž-ím
neodpovídající 	 ne-od-po-víd-aj-íc-í 	 neodpovídající
neodpovídala 	 ne-od-po-víd-a-l-a 	 ne-od-povíd-a-l-a
nepodaří 	 ne-po-dař-í 	 ne-podař-í
nepodnikl 	 ne-pod-nik-l 	 ne-podnikl
nepodpoří 	 ne-pod-poř-í 	 ne-podpoř-í
nepokusíte 	 ne-po-kus-í-te 	 ne-po-kusí-te
nepolemizujme 	 ne-polem-iz-uj-me 	 ne-polemiz-uj-me
nepolepší 	 ne-po-lep-š-í 	 ne-polepš-í
nepotápí 	 ne-po-táp-í 	 ne-potáp-í
nepotřebujete 	 ne-po-třeb-u-j-e-te 	 ne-po-třeb-uje-te
nepravdivých 	 ne-prav-d-iv-ých 	 ne-pravdivých
neprodejným 	 ne-pro-dej-n-ým 	 ne-prodej-n-ým
nepředepisují 	 ne-přede-pis-uj-í 	 nepředepis-uj-í
nepředpokládám 	 ne-před-po-klád-á-m 	 nepředpokládám
nepřidává 	 ne-při-d-á-v-á 	 ne-přid-á-v-á
nepřikážu 	 ne-při-káž-u 	 ne-přikážu
nepříjemná 	 ne-pří-jem-n-á 	 ne-pří-jemn-á
nereálný 	 ne-reál-n-ý 	 ne-reáln-ý
nerozlišuje 	 ne-roz-liš-uje 	 ne-rozliš-uje
netušícího 	 ne-tuš-íc-ího 	 ne-tušícího
neumožňuje 	 ne-u-možň-uje 	 ne-u-mož-ň-uje
neumí 	 ne-um-í 	 ne-umí
nevyskytly 	 ne-vy-skyt-l-y 	 ne-vyskyt-l-y
nezaměstnanosti 	 ne-za-měst-n-an-ost-i 	 ne-za-měst-n-an-osti
nezačínej 	 ne-za-č-ín-ej 	 ne-začínej
neznámého 	 ne-zn-á-m-é-ho 	 ne-zná-m-ého
neztratitelnost 	 ne-z-trat-i-tel-n-ost 	 nez-trat-i-teln-ost
nezávislý 	 ne-zá-vis-l-ý 	 ne-závisl-ý
neúplných 	 ne-ú-pln-ých 	 ne-ú-plných
nimiž 	 n-imi-ž 	 n-imiž
nitěných 	 nit-ěn-ý-ch 	 nit-ěn-ých
nocovávající 	 noc-ová-v-aj-íc-í 	 nocová-v-ající
nocí 	 noc-í 	 nocí
norem 	 norem 	 nor-em
nosem 	 nos-e-m 	 nos-em
nymburka 	 nymburk-a 	 nymburka
nábytek 	 ná-by-tek 	 ná-bytek
nálady 	 ná-lad-y 	 ná-lady
námořník 	 ná-moř-n-ík 	 ná-mořník
nápadný 	 ná-pad-n-ý 	 ná-padn-ý
nápady 	 ná-pad-y 	 ná-pady
náramného 	 ná-ram-n-é-ho 	 ná-ram-n-ého
nás 	 n-á-s 	 nás
následek 	 ná-sled-ek 	 ná-sledek
následujících 	 ná-sled-uj-íc-ích 	 následujíc-ích
následujícího 	 ná-sled-uj-íc-ího 	 následujíc-ího
návštěvnost 	 návštěv-n-ost 	 náv-štěv-n-ost
návštěvnosti 	 návštěv-n-ost-i 	 náv-štěv-n-ost-i
nějakém 	 ně-jak-é-m 	 ně-jakém
nějakými 	 ně-jak-ými 	 ně-jakými
něm 	 n-ě-m 	 n-ěm
německý 	 něm-ec-k-ý 	 německý
obal 	 o-bal 	 obal
obchodníkův 	 ob-chod-ník-ův 	 obchod-ník-ův
obchodu 	 ob-chod-u 	 ob-chodu
obcích 	 obc-ích 	 obcích
obemknout 	 obe-mk-nou-t 	 obemk-nou-t
obepnout 	 obe-pn-ou-t 	 obe-p-nou-t
objektem 	 ob-jekt-e-m 	 ob-jekt-em
oblažit 	 o-blaž-i-t 	 oblaž-i-t
oblíbený 	 ob-líb-en-ý 	 ob-líbený
obor 	 o-bor 	 obor
obouvatelný 	 ob-ouv-a-teln-ý 	 obouva-teln-ý
obrat 	 o-br-a-t 	 obr-a-t
obrátek 	 ob-rát-ek 	 ob-rátek
obsahující 	 ob-sah-uj-íc-í 	 obsahující
obydlet 	 o-bydl-e-t 	 o-bydl-et
obzvlášť 	 ob-zvlášť 	 obzvlášť
ocejchovávací 	 o-cejch-ová-v-a-c-í 	 ocejchováva-c-í
ochotna 	 ochot-n-a 	 o-chot-n-a
ochranka 	 o-chran-k-a 	 o-chrank-a
odborníky 	 od-bor-n-ík-y 	 od-borníky
odbytové 	 od-by-t-ov-é 	 od-bytov-é
odchylky 	 od-chyl-k-y 	 od-chylky
odevzdám 	 ode-vz-d-á-m 	 ode-vz-d-ám
odevšad 	 ode-vš-ad 	 ode-všad
odečte 	 ode-čt-e 	 odeč-te
odečtení 	 ode-čt-en-í 	 ode-čten-í
odečtou 	 ode-čt-ou 	 odečtou
odkopávat 	 od-kop-á-v-a-t 	 od-kopá-v-at
odkývat 	 od-kýv-a-t 	 od-kýva-t
odmalička 	 od-mal-ičk-a 	 od-maličk-a
odmésti 	 od-mést-i 	 od-més-ti
odpluje 	 od-plu-je 	 od-pluje
odsouvací 	 od-souv-a-c-í 	 od-souv-ací
odst 	 od-st 	 odst
ohořelému 	 o-hoř-e-l-é-mu 	 o-hoř-e-l-ému
ohřebelcovat 	 o-hřeb-el-c-ova-t 	 o-hřebel-c-ova-t
okamžitě 	 ok-a-mžit-ě 	 oka-mžit-ě
okartáčovat 	 o-kartáč-ova-t 	 okartáč-ova-t
okounět 	 okoun-ě-t 	 o-kou-n-ě-t
okrádal 	 o-krád-a-l 	 okrád-a-l
olšanech 	 olšan-e-ch 	 olšan-ech
omegou 	 omeg-ou 	 o-meg-ou
opačném 	 o-pač-n-é-m 	 o-pač-n-ém
operacích 	 oper-ac-ích 	 operac-ích
oplakávat 	 o-plak-á-v-a-t 	 o-plak-á-v-at
opláknout 	 o-plák-nou-t 	 o-plák-nout
oplésti 	 o-plést-i 	 o-plés-ti
opouští 	 o-pouš-t-í 	 o-poušt-í
opovažuješ 	 o-po-važ-u-j-e-š 	 o-po-važ-uje-š
orazítkovat 	 o-raz-í-tk-ova-t 	 o-razí-tk-ova-t
orchestrem 	 orchestr-e-m 	 orchestr-em
organismus 	 organismus 	 organ-ism-us
organizují 	 organ-iz-u-j-í 	 organiz-uj-í
orlik 	 orl-ik 	 orlik
osmitisícový 	 osm-i-tisíc-ov-ý 	 osm-itisíc-ov-ý
osmou 	 osm-ou 	 o-sm-ou
osobu 	 o-sob-u 	 osob-u
ospalost 	 o-sp-a-l-ost 	 o-spa-l-ost
ostatních 	 o-stat-n-í-ch 	 o-stat-ních
osudem 	 o-sud-e-m 	 o-sud-em
osvědčují 	 o-s-věd-č-u-j-í 	 osvědč-uj-í
oxfordského 	 oxford-sk-é-ho 	 oxford-sk-ého
ozřejmit 	 o-zřejm-i-t 	 o-zř-ejm-i-t
očarování 	 o-čar-ová-n-í 	 o-čar-ován-í
očekávají 	 o-ček-á-v-aj-í 	 oček-á-v-ají
očí 	 oč-í 	 očí
očíslit 	 o-čísl-i-t 	 očísl-i-t
očíslovat 	 o-čísl-ova-t 	 očísl-ova-t
oškrabat 	 o-škrab-a-t 	 oškrab-a-t
pacientovi 	 pac-i-ent-ovi 	 pacient-ovi
padesátku 	 pade-sát-k-u 	 pa-desátk-u
padly 	 pad-l-y 	 pad-ly
paláci 	 palác-i 	 paláci
panenka 	 pan-en-k-a 	 pan-enk-a
paničko 	 pan-ič-k-o 	 pan-ičk-o
panáček 	 pan-áč-ek 	 panáček
parukou 	 paruk-ou 	 parukou
pavlačí 	 pavlač-í 	 pavlačí
pavouček 	 pavouč-ek 	 pavouček
pekárenských 	 pek-ár-en-sk-ých 	 pekárenských
perly 	 perl-y 	 per-l-y
perunovy 	 perun-ov-y 	 perunov-y
perutková 	 perut-k-ov-á 	 perutk-ová
pestrý 	 pestr-ý 	 pestrý
petynce 	 pety-n-c-e 	 petync-e
pečiva 	 peč-iv-a 	 pečiv-a
pečivo 	 peč-iv-o 	 peči-v-o
pil 	 pi-l 	 pil
pilují 	 pil-u-j-í 	 pilují
pisklavě 	 pisk-l-av-ě 	 pisk-lav-ě
pitomej 	 pitom-ej 	 pito-mej
plakáty 	 plakát-y 	 plakáty
planul 	 plan-u-l 	 pla-nul
plat 	 plat 	 pla-t
platba 	 plat-b-a 	 plat-ba
plačící 	 plač-í-c-í 	 plačící
pleteného 	 plet-en-é-ho 	 plet-en-ého
plivám 	 pliv-á-m 	 plivám
plochy 	 ploch-y 	 plochy
plodem 	 plod-e-m 	 plod-em
plují 	 plu-j-í 	 plují
plukovník 	 pluk-ov-n-ík 	 pluk-ovník
plutokratismus 	 plut-o-krat-ism-us 	 pluto-krat-ism-us
plácající 	 plác-aj-íc-í 	 plácající
plínku 	 plín-k-u 	 plín-ku
pobočkové 	 po-boč-k-ov-é 	 po-boč-k-ové
pobožnější 	 po-bož-n-ěj-š-í 	 po-božnějš-í
pochází 	 po-cház-í 	 po-chází
pocházím 	 po-cház-í-m 	 po-cházím
podhrnout 	 pod-hrn-ou-t 	 pod-hr-nou-t
podnikatelskou 	 pod-nik-a-tel-sk-ou 	 pod-nik-atel-sk-ou
podnikám 	 pod-nik-á-m 	 pod-nik-ám
podobného 	 po-dob-n-é-ho 	 po-dob-n-ého
podotkl 	 po-do-tk-l 	 po-dotk-l
podvésti 	 pod-vést-i 	 pod-vés-ti
pohlíží 	 po-hlíž-í 	 po-hlíží
pohnutlivé 	 po-h-nu-t-l-i-v-é 	 po-h-nu-t-l-iv-é
pohotovějším 	 po-hotov-ějš-ím 	 pohotovějš-ím
pokročilejším 	 po-kroč-i-l-ejš-ím 	 pokroči-l-ejš-ím
pokývat 	 po-kýv-a-t 	 po-kývat
politických 	 polit-ic-k-ý-ch 	 politických
polska 	 pol-sk-a 	 polska
polská 	 pol-sk-á 	 polská
polských 	 pol-sk-ých 	 polských
pomlaskávat 	 po-mlask-á-v-a-t 	 po-mlaská-v-a-t
pomást 	 po-más-t 	 po-mást
poměrem 	 po-měr-e-m 	 po-měr-em
pomůcek 	 po-můc-ek 	 po-můcek
popelnic 	 po-pel-nic 	 po-pelnic
poplatků 	 po-plat-k-ů 	 po-platk-ů
poplatník 	 po-plat-ník 	 po-platník
poplatníka 	 po-plat-ník-a 	 po-plat-níka
poplatníky 	 po-plat-ník-y 	 po-platníky
poproduktivní 	 po-pro-duk-t-iv-n-í 	 po-produkt-iv-n-í
poptávky 	 po-pt-á-v-k-y 	 po-pt-áv-k-y
porculánu 	 porculán-u 	 porculá-n-u
porovnání 	 po-rovn-ání 	 po-rov-n-á-n-í
porůsti 	 po-růst-i 	 po-růs-ti
posily 	 po-sil-y 	 posil-y
poskytují 	 po-skyt-uj-í 	 poskytují
posluchače 	 po-sluch-a-č-e 	 po-sluch-ač-e
posluchačů 	 po-sluch-a-č-ů 	 po-sluchačů
pospícháme 	 po-spích-á-me 	 po-spíchá-me
postrádám 	 po-strád-á-m 	 po-strád-ám
postýlky 	 po-stýl-k-y 	 po-stýlky
potká 	 po-tk-á 	 potk-á
potraviny 	 po-trav-in-y 	 po-travin-y
potrefený 	 po-tref-en-ý 	 po-trefen-ý
potud 	 po-t-ud 	 pot-ud
pouhém 	 pouh-é-m 	 pouh-ém
poupátko 	 poup-át-k-o 	 po-up-át-k-o
povyrůsti 	 po-vy-růst-i 	 po-vy-růs-ti
povzbudivé 	 po-vz-bud-i-v-é 	 po-vz-bud-iv-é
povšimli 	 po-všim-l-i 	 po-všiml-i
pozdní 	 pozd-n-í 	 pozdní
poztrácet 	 po-z-trác-e-t 	 poz-trác-e-t
počkej 	 po-čk-ej 	 po-čkej
počkám 	 po-čk-á-m 	 počkám
počíhat 	 po-číh-a-t 	 po-číh-at
počítají 	 po-čít-aj-í 	 po-čít-ají
pošlete 	 po-šl-e-te 	 po-šlet-e
pracovníka 	 prac-ov-ník-a 	 prac-ovníka
pragokoncertu 	 prag-o-koncert-u 	 prago-koncert-u
praktickým 	 prakt-ic-k-ý-m 	 praktickým
praktikantům 	 prakt-ik-ant-ům 	 praktikant-ům
pramene 	 pramen-e 	 pra-men-e
pravd 	 prav-d 	 pravd
pravdy 	 prav-d-y 	 prav-dy
pravidel 	 prav-i-del 	 prav-idel
prchavý 	 prch-a-v-ý 	 prch-av-ý
premií 	 prem-i-í 	 premií
princezna 	 princ-ez-n-a 	 princez-n-a
princeznu 	 princ-ez-n-u 	 princez-n-u
princmetálovou 	 princ-metál-ov-ou 	 princmetál-ov-ou
princátky 	 princ-át-k-y 	 princátky
probudím 	 pro-bud-í-m 	 pro-bud-ím
procházka 	 pro-cház-k-a 	 pro-cházk-a
projednáním 	 pro-jed-n-án-ím 	 pro-jedn-á-n-ím
proklábosit 	 pro-klábos-i-t 	 proklábos-i-t
proklásti 	 pro-klást-i 	 pro-klásti
proklímat 	 pro-klím-a-t 	 pro-klím-at
proklímávání 	 pro-klím-á-v-á-n-í 	 pro-klímá-v-á-n-í
prokormidlovavší 	 pro-kormidl-ova-vš-í 	 pro-kormidlova-vší
promnout 	 pro-mn-ou-t 	 pro-m-nou-t
propagace 	 propag-ac-e 	 pro-pagac-e
propíchávat 	 pro-pích-á-v-a-t 	 pro-píchá-v-a-t
prosciutto 	 prosciutt-o 	 pro-sciutt-o
prostou 	 prost-ou 	 pro-st-ou
prostějovsko 	 prostějov-sk-o 	 pro-stěj-ov-sk-o
prostějově 	 prostějov-ě 	 pro-stěj-ov-ě
protiabcházský 	 proti-abcház-sk-ý 	 protiabcházský
protisluneční 	 proti-slun-eč-n-í 	 protisluneč-n-í
protkání 	 pro-tk-á-n-í 	 protká-n-í
proužek 	 prouž-ek 	 proužek
provincií 	 provinc-i-í 	 provincií
pročež 	 pro-č-e-ž 	 pro-č-ež
prošel 	 pro-še-l 	 pro-šel
prstíčky 	 prst-íč-k-y 	 prstíčky
pruhovat 	 pruh-ova-t 	 pruh-ovat
právem 	 práv-e-m 	 práv-em
právních 	 práv-n-ích 	 právních
prýsknout 	 prýsk-nou-t 	 prýsknou-t
psacím 	 ps-a-c-í-m 	 psac-ím
psaním 	 ps-a-n-í-m 	 ps-a-n-ím
psychično 	 psych-ič-n-o 	 psychično
psychologistickou 	 psycho-log-ist-ic-k-ou 	 psych-o-logist-ickou
psům 	 ps-ů-m 	 psům
ptejme 	 pt-ej-me 	 ptej-me
publicita 	 public-it-a 	 publicit-a
publikací 	 publik-ac-í 	 publikac-í
pusinka 	 pus-in-k-a 	 pus-ink-a
pzt 	 p-z-t 	 pzt
páchat 	 pách-a-t 	 pách-at
pápěrka 	 pá-pěr-k-a 	 pápěrk-a
písknout 	 písk-nou-t 	 písk-nout
píti 	 pít-i 	 píti
pódium 	 pódi-um 	 pódium
pěkné 	 pěkn-é 	 pěk-n-é
pěkném 	 pěkn-é-m 	 pěkn-ém
pěst 	 pěst 	 pěs-t
pětikorunovou 	 pět-i-korun-ov-ou 	 pět-ikorun-ov-ou
pětistovkou 	 pět-i-st-ovk-ou 	 pět-ist-ov-k-ou
předcházejí 	 před-cház-e-j-í 	 před-cház-ej-í
předepsanou 	 přede-ps-a-n-ou 	 přede-psan-ou
předepíše 	 přede-píš-e 	 přede-píše
předobjednávání 	 před-ob-jedn-á-v-á-n-í 	 před-objednává-n-í
předpojaté 	 před-po-j-a-t-é 	 před-poj-a-t-é
předpoklady 	 před-po-klad-y 	 před-poklad-y
předprodeje 	 před-pro-d-ej-e 	 před-prodeje
předrahá 	 pře-drah-á 	 předrah-á
předsedům 	 před-sed-ů-m 	 předsedům
předstihujícím 	 před-stih-uj-í-c-í-m 	 předstihujícím
předvýrobní 	 před-vý-rob-n-í 	 před-výrob-n-í
předvědecky 	 před-věd-ec-k-y 	 před-vědeck-y
předzpívat 	 před-zpí-v-a-t 	 před-zpív-a-t
přejímce 	 pře-j-í-m-c-e 	 pře-jím-c-e
překladatel 	 pře-klad-a-tel 	 pře-klad-atel
překážky 	 pře-káž-k-y 	 překážky
přemýšlivější 	 pře-mýšl-iv-ějš-í 	 pře-mýšlivějš-í
přepnout 	 pře-pn-ou-t 	 pře-p-nou-t
přesností 	 přesn-ost-í 	 přesnost-í
přesný 	 přesn-ý 	 pře-sn-ý
přesnější 	 přesn-ěj-š-í 	 přesnější
přesunuly 	 pře-su-nu-l-y 	 pře-sunu-l-y
přihřívat 	 při-hří-v-a-t 	 při-hří-v-at
přijdu 	 při-jd-u 	 při-jdu
připluje 	 při-plu-je 	 při-pluje
připomenout 	 při-po-men-ou-t 	 při-pome-nou-t
připomínky 	 při-po-mín-k-y 	 při-pomínk-y
přivydělávat 	 při-vy-děl-á-v-a-t 	 při-vyděl-á-v-a-t
přizpůsobivosti 	 při-z-pů-sob-i-v-ost-i 	 při-z-pů-sobivosti
přičouditelný 	 při-čoud-i-teln-ý 	 při-čoud-iteln-ý
přišinout 	 při-šin-ou-t 	 při-šinou-t
příjmy 	 pří-jm-y 	 příjmy
přímé 	 přím-é 	 pří-m-é
přímém 	 přím-é-m 	 přím-ém
přísní 	 přísn-í 	 přísní
přítomném 	 pří-t-o-m-n-é-m 	 pří-t-om-n-ém
přítomnými 	 pří-t-o-m-n-ý-m-i 	 pří-t-omn-ými
přízemí 	 pří-zem-í 	 přízem-í
příznivý 	 pří-zn-iv-ý 	 pří-zniv-ý
příštího 	 příšt-í-ho 	 příštího
příštím 	 příšt-ím 	 příštím
příště 	 příšt-ě 	 pří-ště
pšenka 	 pšen-k-a 	 pšenk-a
půlsnímkovost 	 půl-s-ním-k-ov-ost 	 půl-s-ním-kov-ost
působí 	 pů-sob-í 	 působí
québec 	 québec 	 québ-ec
radili 	 rad-i-l-i 	 rad-ili
radomír 	 radomír 	 rad-omír
raketu 	 raket-u 	 raketu
rakousku 	 rakous-k-u 	 rakousk-u
raneček 	 raneč-ek 	 raneček
razítky 	 raz-í-tk-y 	 razítky
regentíkův 	 regent-ík-ův 	 regentík-ův
regály 	 regál-y 	 regály
reklamace 	 reklam-ac-e 	 reklamac-e
reklamu 	 reklam-u 	 reklamu
rektorem 	 rekt-or-em 	 rektor-em
relativita 	 rel-at-iv-it-a 	 rel-ativ-it-a
reportáž 	 re-port-áž 	 reportáž
reprodukční 	 re-pro-duk-č-n-í 	 reproduk-č-n-í
restriktivní 	 re-strikt-iv-n-í 	 restrikt-iv-n-í
revolucí 	 revol-uc-í 	 revolucí
rider 	 rid-er 	 rider
rivalové 	 rival-ové 	 rival-ov-é
rodinný 	 rod-in-n-ý 	 rodin-n-ý
roháček 	 roh-áč-ek 	 roh-áček
rolling 	 roll-ing 	 rolling
rolničit 	 rol-n-ič-i-t 	 rol-nič-i-t
roxby 	 roxby 	 rox-by
rozdíly 	 roz-díl-y 	 rozdíl-y
rozeklát 	 roze-kl-á-t 	 roze-klát
rozhrnula 	 roz-hrn-u-l-a 	 roz-hrnu-l-a
rozkoukávat 	 roz-kouk-á-v-a-t 	 roz-kouká-v-a-t
rozkošným 	 roz-koš-n-ý-m 	 roz-koš-n-ým
rozkuckat 	 roz-kuc-k-a-t 	 roz-kuck-at
rozkývat 	 roz-kýv-a-t 	 roz-kývat
rozkřiknout 	 roz-křik-nou-t 	 roz-křiknou-t
rozpočísti 	 roz-po-číst-i 	 roz-po-čís-ti
rozprodávat 	 roz-pro-d-á-v-a-t 	 roz-prod-á-v-a-t
rozsáhlý 	 roz-sáh-l-ý 	 roz-sáhl-ý
rozumových 	 roz-um-ov-ý-ch 	 roz-umov-ých
rozumí 	 roz-um-í 	 roz-umí
rozutíkat 	 roz-utík-a-t 	 roz-u-tík-a-t
rozvíjí 	 roz-víj-í 	 rozvíj-í
rozšít 	 roz-ší-t 	 roz-šít
rozžhavil 	 roz-žh-av-i-l 	 roz-žhav-il
rupií 	 rupi-í 	 rup-i-í
rázem 	 ráz-e-m 	 ráz-em
ráčkovat 	 ráč-k-ova-t 	 ráč-k-ovat
různými 	 různ-ý-m-i 	 různ-ými
samcoložník 	 samc-o-lož-n-ík 	 samc-olož-ník
samotáři 	 sam-ot-ář-i 	 sam-otář-i
samozřejmá 	 sam-o-zř-ejm-á 	 sam-o-zř-ej-m-á
samsung 	 samsung 	 sam-sung
sankcemi 	 sankc-emi 	 sankcemi
sbíhat 	 s-bíh-a-t 	 sbíh-a-t
schodech 	 s-chod-e-ch 	 s-chod-ech
schody 	 s-chod-y 	 s-chody
schopných 	 s-chop-n-ých 	 schopných
schumlat 	 s-chuml-a-t 	 schuml-a-t
scorpions 	 scorpion-s 	 s-corpions
sebelepší 	 seb-e-lep-š-í 	 sebelepší
sebeničením 	 s-eb-e-ni-č-en-í-m 	 seb-e-nič-en-ím
sebevíce 	 seb-e-víc-e 	 seb-e-více
sedláková 	 sedl-ák-ov-á 	 sed-l-ák-ov-á
sedmihradsku 	 sedmihradsk-u 	 sedmihrad-sk-u
seminární 	 semin-ár-n-í 	 seminárn-í
separátní 	 se-par-át-n-í 	 separátn-í
sepnout 	 se-pn-ou-t 	 se-p-nou-t
setkal 	 se-tk-a-l 	 se-tk-al
seychelančin 	 seychel-an-č-in 	 seychelan-č-in
sešmajdat 	 se-šmajd-a-t 	 se-šmajd-at
sháňku 	 s-háň-k-u 	 s-háň-ku
signalizovali 	 signal-iz-ova-l-i 	 sign-al-iz-ova-l-i
silence 	 silence 	 sil-enc-e
sklapne 	 s-klap-n-e 	 s-klap-ne
skličovat 	 s-klič-ova-t 	 sklič-ovat
skládaly 	 s-klád-a-l-y 	 skládaly
skončil 	 s-konč-i-l 	 skonč-i-l
skončila 	 s-konč-i-l-a 	 skonč-i-l-a
skončí 	 s-konč-í 	 skončí
skrápnout 	 s-kráp-nou-t 	 s-kráp-nout
skrývala 	 s-krýv-a-l-a 	 skrývala
skutečnosti 	 s-kut-eč-n-ost-i 	 skuteč-n-ost-i
skutečném 	 s-kut-eč-n-é-m 	 skuteč-n-ém
skříní 	 skřín-í 	 skříní
skřípět 	 skříp-ě-t 	 skřípě-t
skříňce 	 skříň-c-e 	 skříňce
slavnějším 	 slav-n-ěj-š-í-m 	 slav-nější-m
sledovány 	 sled-ová-n-y 	 sled-ován-y
slibuji 	 s-lib-uj-i 	 slib-uj-i
sloupoví 	 sloup-ov-í 	 sloupoví
slovensko 	 sloven-sk-o 	 slov-en-sk-o
slovník 	 slov-n-ík 	 slovník
slovným 	 slov-n-ý-m 	 slov-n-ým
sluchu 	 sluch-u 	 sluchu
sluncí 	 slun-c-í 	 sluncí
smaragdy 	 smaragd-y 	 smaragdy
smrtelném 	 s-mr-tel-n-é-m 	 s-mr-teln-ém
smrtelnému 	 s-mr-tel-n-é-mu 	 s-mr-teln-ému
smyslových 	 s-mysl-ov-ý-ch 	 s-myslových
smésti 	 s-mést-i 	 s-més-ti
směrem 	 s-měr-e-m 	 s-měr-em
snahami 	 snah-a-m-i 	 snah-ami
snů 	 sn-ů 	 snů
sobectví 	 sob-ec-tv-í 	 sobectv-í
solarmax 	 solar-max 	 solarmax
solidních 	 solid-n-í-ch 	 solid-n-ích
sotva 	 sotva 	 sotv-a
soudním 	 soud-n-ím 	 soud-n-í-m
soukromník 	 sou-krom-ník 	 soukromník
sousedního 	 sou-sed-n-í-ho 	 sou-sed-n-ího
soutěže 	 sou-těž-e 	 sou-těže
soutěži 	 sou-těž-i 	 sou-těži
spaly 	 sp-a-l-y 	 spa-l-y
specialisté 	 speci-al-ist-é 	 special-ist-é
specifickým 	 speci-fic-k-ý-m 	 specifickým
speciál 	 speci-ál 	 speciál
spekulací 	 spekul-ac-í 	 spekulací
spekulantem 	 spek-ul-ant-e-m 	 spek-ul-ant-em
spojkami 	 s-poj-k-a-m-i 	 s-pojkami
spokojíte 	 s-pokoj-í-te 	 s-po-koj-í-te
spolupůsobit 	 spol-u-působ-i-t 	 spol-u-pů-sob-i-t
spolutvořit 	 spol-u-tvoř-i-t 	 spol-utvoř-i-t
sponzorsky 	 sponzor-sk-y 	 s-ponzorsk-y
spoří 	 s-poř-í 	 spoř-í
správních 	 s-práv-n-ích 	 s-práv-ních
spáchat 	 s-pách-a-t 	 s-pách-at
stanovil 	 stanov-i-l 	 stan-ov-i-l
stanovit 	 stan-ov-i-t 	 stanov-i-t
starobní 	 star-ob-n-í 	 star-ob-ní
starožitných 	 star-o-ži-t-n-ých 	 star-ožit-n-ých
starých 	 star-ý-ch 	 star-ých
stavení 	 sta-v-en-í 	 stav-en-í
stejkaně 	 s-tejk-a-n-ě 	 stejk-a-n-ě
stejném 	 stej-n-é-m 	 stejn-ém
stipendium 	 stipendi-um 	 stipendium
stojaté 	 stoj-at-é 	 stoj-a-t-é
stokorunovou 	 st-o-korun-ov-ou 	 stokorun-ov-ou
století 	 st-o-let-í 	 stol-et-í
stones 	 stone-s 	 stones
stovkou 	 st-ovk-ou 	 st-ov-k-ou
stovku 	 st-ovk-u 	 st-ov-k-u
strahov 	 strahov 	 strah-ov
strahova 	 strahov-a 	 strah-ov-a
strahově 	 strahov-ě 	 strah-ov-ě
strava 	 s-trav-a 	 strav-a
strašnicích 	 strašnic-í-ch 	 strašnicích
strnutí 	 s-trn-u-t-í 	 s-tr-nu-t-í
strojírenské 	 stroj-íren-sk-é 	 strojíren-sk-é
studijní 	 stud-ij-n-í 	 studij-n-í
studijních 	 stud-ij-n-ích 	 studij-n-ích
studiích 	 stud-i-í-ch 	 studiích
studovaný 	 stud-ova-n-ý 	 stud-ovan-ý
stužka 	 stuž-k-a 	 stuž-ka
stěžovatel 	 stěž-ova-tel 	 s-těž-ova-tel
střechách 	 střech-á-ch 	 střech-ách
stříbro 	 stříbr-o 	 stříbro
stříbrolesklého 	 stříbr-o-lesk-l-é-ho 	 stříbroleskl-ého
střílí 	 stříl-í 	 střílí
střízlivět 	 stříz-l-iv-ě-t 	 střízl-iv-ě-t
stůl 	 stůl 	 stů-l
superdobrý 	 super-dobr-ý 	 sup-erdobr-ý
supraphon 	 supra-phon 	 supraphon
svát 	 s-vá-t 	 svá-t
svídnici 	 svídnic-i 	 svídnici
svědomím 	 s-věd-om-í-m 	 s-věd-om-ím
světelné 	 svět-el-n-é 	 svět-eln-é
světelných 	 svět-el-n-ých 	 svět-elných
systematický 	 system-at-ic-k-ý 	 systematic-ký
systémem 	 systém-e-m 	 systém-em
sáňkovávací 	 sáň-k-ová-v-a-c-í 	 sáň-k-ováv-a-c-í
sít 	 sí-t 	 sít
sčítávat 	 s-čít-á-v-a-t 	 sčít-á-v-a-t
tabule 	 tabul-e 	 tabule
tajemství 	 taj-em-stv-í 	 taj-emstv-í
takzvaném 	 tak-zv-a-n-é-m 	 tak-zv-a-n-ém
také 	 také 	 tak-é
tati 	 tat-i 	 ta-ti
taxík 	 tax-ík 	 taxík
technickým 	 techn-ic-k-ým 	 technickým
technologického 	 techn-o-log-ick-ého 	 techn-o-logick-ého
telefonního 	 tele-fon-n-í-ho 	 tele-fon-n-ího
televize 	 televize 	 televiz-e
tendenci 	 tend-enc-i 	 tendenc-i
tenounkým 	 ten-oun-k-ý-m 	 ten-ounkým
tepichy 	 tepich-y 	 tepichy
tesklivých 	 tesk-l-iv-ý-ch 	 tesklivých
tetička 	 tet-ič-k-a 	 tet-ičk-a
tikem 	 tik-e-m 	 tik-em
tisknou 	 tisk-n-ou 	 tisk-nou
tiskárnu 	 tisk-árn-u 	 tisk-árnu
tisovitý 	 tis-ovit-ý 	 tisovitý
tj 	 t-j 	 tj
tkalcovnictví 	 tka-lc-ovnic-tv-í 	 tka-l-c-ovnic-tví
tlapkách 	 tlap-k-á-ch 	 tlap-k-ách
tops 	 tops 	 t-ops
treperendo 	 treper-end-o 	 treperend-o
trochu 	 troch-u 	 trochu
tropickém 	 trop-ick-ém 	 tropickém
truhlářský 	 truhl-ář-sk-ý 	 truhlářský
trutnovský 	 trutnov-sk-ý 	 trutnovsk-ý
turbodmychadlo 	 turbo-dmych-adl-o 	 turbodmych-adlo
turbovrtulových 	 turbo-vrt-ul-ov-ých 	 turbovrtul-ov-ých
turecký 	 turec-k-ý 	 turec-ký
turistiky 	 tur-ist-ik-y 	 tur-istik-y
turné 	 turné 	 turn-é
tušící 	 tuš-íc-í 	 tušící
tvrzeními 	 tvrz-en-í-m-i 	 tvrz-en-ími
téhož 	 t-é-ho-ž 	 t-ého-ž
tématu 	 tém-at-u 	 témat-u
tímhle 	 t-í-m-hle 	 t-ím-hle
tímto 	 t-í-m-t-o 	 t-ím-t-o
týdeníku 	 týden-ík-u 	 týd-eník-u
těmi 	 t-ě-m-i 	 t-ěmi
těšili 	 těš-i-l-i 	 těši-li
těší 	 těš-í 	 těší
třemi 	 tř-e-m-i 	 tř-emi
třesoucí 	 třes-ou-c-í 	 třesoucí
třetím 	 tř-e-t-í-m 	 tř-et-í-m
třineckých 	 třinec-k-ých 	 třineckých
třísla 	 třís-l-a 	 třísl-a
ubírat 	 u-bír-a-t 	 u-bír-at
uhlí 	 uhl-í 	 uhlí
ukazuju 	 u-kaz-u-j-u 	 u-kaz-uju
ukrutným 	 u-krut-n-ý-m 	 u-krut-ným
ukryl 	 u-kry-l 	 u-kryl
ukuckat 	 u-kuc-k-a-t 	 ukuckat
ukápnout 	 u-káp-nou-t 	 u-káp-nout
ulici 	 ul-ic-i 	 ulic-i
uloženými 	 u-lož-en-ý-m-i 	 u-lož-en-ými
umdlívat 	 u-mdl-í-v-a-t 	 umdl-í-v-a-t
umožnilo 	 u-možn-i-l-o 	 u-mož-n-i-l-o
uměle 	 u-m-ě-l-e 	 um-ě-l-e
umělostech 	 u-m-ě-l-ost-e-ch 	 um-ě-l-ost-ech
unikát 	 unik-át 	 unikát
univerzitního 	 uni-verz-it-n-ího 	 uni-verzit-n-ího
uplynulo 	 u-ply-nu-l-o 	 u-ply-nu-lo
upravili 	 u-prav-i-l-i 	 u-prav-il-i
upíchat 	 u-pích-a-t 	 u-pích-at
uriah 	 uriah 	 uri-ah
urychlila 	 u-rychl-i-l-a 	 urychli-la
určitě 	 urč-it-ě 	 u-rč-i-t-ě
uskladňovat 	 u-s-klad-ň-ova-t 	 us-klad-ň-ova-t
uskutečnily 	 u-s-kut-eč-n-i-l-y 	 u-skuteč-n-i-l-y
usoudí 	 u-soud-í 	 usoud-í
ustanoveními 	 u-stanov-en-ími 	 u-stanoven-ími
ustavičně 	 u-stav-ič-n-ě 	 u-stavič-n-ě
ustrnule 	 u-s-trn-u-l-e 	 u-s-tr-nu-l-e
uvádějí 	 u-vád-ěj-í 	 uváděj-í
uzavírá 	 u-za-vír-á 	 uza-vír-á
uzdraví 	 u-zdrav-í 	 u-zdraví
uzpůsobit 	 u-z-působ-i-t 	 u-z-pů-sob-i-t
učitel 	 uč-i-tel 	 uči-tel
učitelů 	 uč-i-tel-ů 	 uči-tel-ů
uštelovavší 	 u-štel-ova-vš-í 	 u-štelova-vš-í
užitečné 	 u-žit-eč-n-é 	 u-ži-t-eč-n-é
uživit 	 u-živ-i-t 	 u-ži-v-i-t
vajnar 	 vajnar 	 vaj-nar
vakuářskost 	 vaku-ář-sk-ost 	 vaku-ář-skost
valašské 	 valaš-sk-é 	 valašské
vatikánský 	 vatikán-sk-ý 	 vatikánský
velikost 	 vel-ik-ost 	 vel-ikost
velikou 	 vel-ik-ou 	 vel-ikou
velká 	 vel-k-á 	 velk-á
velkého 	 vel-k-é-ho 	 vel-k-ého
velvyslanectví 	 vel-vy-sl-a-n-ec-tv-í 	 velvyslanectví
ventures 	 venture-s 	 ventures
veslař 	 vesl-ař 	 veslař
vespolek 	 ve-s-pol-ek 	 ves-pol-ek
vezmeš 	 vez-m-e-š 	 vez-me-š
vezmou 	 vez-m-ou 	 vez-mou
veřejně 	 veř-ej-n-ě 	 veřej-n-ě
veškerým 	 veš-k-er-ý-m 	 veš-k-erým
vinohradského 	 vinohrad-sk-é-ho 	 vinohrad-sk-ého
vkládáme 	 v-klád-á-me 	 vklád-á-me
vlastního 	 vlast-n-í-ho 	 vlast-n-ího
vlaštovčí 	 vlašt-ov-č-í 	 vlaštovčí
vložkovací 	 v-lož-k-ova-c-í 	 vlož-kova-c-í
vloží 	 v-lož-í 	 vlož-í
vnitřnostech 	 v-nitř-n-ost-e-ch 	 v-nitř-n-ost-ech
vnucoval 	 v-nuc-ova-l 	 v-nuc-oval
vodolově 	 vodolov-ě 	 vod-olov-ě
vozidly 	 voz-i-dl-y 	 vozidly
vrabčí 	 vrab-č-í 	 vrabčí
vrtulníky 	 vrt-ul-ník-y 	 vrtulníky
vrátnice 	 vrát-nic-e 	 vrát-nice
vstoupnutelný 	 v-stoup-nu-teln-ý 	 v-st-oup-nu-teln-ý
vstupenek 	 vs-tup-en-ek 	 v-stup-en-ek
vstupenka 	 v-stup-enk-a 	 v-stup-enka
vstupenku 	 v-stup-enk-u 	 v-stup-en-ku
vstupenky 	 vstup-enk-y 	 v-stupenky
vtokový 	 v-tok-ov-ý 	 vtok-ov-ý
vychlastat 	 vy-chlast-a-t 	 vy-chlasta-t
vychládat 	 vy-chlád-a-t 	 vy-chlád-at
vychrtlý 	 vy-chrt-l-ý 	 vy-chrtl-ý
vycházejí 	 vy-cház-ej-í 	 vy-cház-ejí
vydařeném 	 vy-dař-en-ém 	 vy-dařen-ém
vydělávají 	 vy-děl-á-v-aj-í 	 vy-dělá-v-aj-í
vyjel 	 vy-je-l 	 vy-jel
vykonávali 	 vy-kon-á-v-a-l-i 	 vy-koná-v-a-l-i
vykrášlit 	 vy-kráš-l-i-t 	 vy-kráš-l-it
vymáčkl 	 vy-máčk-l 	 vy-máčkl
vymáčknout 	 vy-máčk-nou-t 	 vy-máčk-nout
vyměřovacímu 	 vy-měř-ova-c-ímu 	 vyměřova-c-ímu
vynaložením 	 vy-na-lož-en-í-m 	 vy-na-lož-en-ím
vynesla 	 vy-nes-l-a 	 vy-nesl-a
vynášejí 	 vy-náš-ej-í 	 vy-nášej-í
vyplul 	 vy-plu-l 	 vy-plul
vyplňující 	 vy-plň-uj-íc-í 	 vy-plňující
vypočísti 	 vy-po-číst-i 	 vy-po-čís-ti
vyprovokovat 	 vy-pro-vok-ova-t 	 vy-provok-ova-t
vypárovací 	 vy-pár-ova-c-í 	 vypárova-c-í
vyrýžovat 	 vy-rýž-ova-t 	 vy-rýž-ovat
vysedával 	 vy-sed-á-v-a-l 	 vy-sed-á-v-al
vysokoškolské 	 vys-ok-o-škol-sk-é 	 vysokoškol-sk-é
vysokoškolský 	 vys-ok-o-škol-sk-ý 	 vysokoškol-sk-ý
vysoká 	 vys-ok-á 	 vysok-á
vysokém 	 vys-ok-ém 	 vysok-ém
vyspinkat 	 vy-sp-ink-a-t 	 vy-spink-a-t
vyspělým 	 vy-spě-l-ým 	 vy-spěl-ým
vysílací 	 vy-síl-a-c-í 	 vy-sílací
vytýkáno 	 vy-týk-á-n-o 	 vy-týká-n-o
vyvrkávat 	 vy-vrk-á-v-a-t 	 vy-vrk-á-v-at
vyvážecí 	 vy-váž-e-c-í 	 vy-vážecí
vyčísti 	 vy-číst-i 	 vy-čísti
vyřinout 	 vy-řin-ou-t 	 vy-ři-nou-t
vzdělání 	 vz-děl-án-í 	 vz-děl-á-n-í
vzít 	 vz-í-t 	 v-zí-t
válka 	 válk-a 	 vál-k-a
vás 	 v-á-s 	 vás
vážný 	 váž-n-ý 	 váž-ný
víte 	 v-í-te 	 ví-te
vítkovice 	 vít-k-ov-ic-e 	 vítk-ovic-e
vítkovickém 	 vítk-ovic-k-ém 	 vítkovic-k-ém
vítězství 	 vítěz-ství 	 vítězstv-í
výcviku 	 vý-cvik-u 	 vý-cviku
výdělek 	 vý-děl-ek 	 vý-dělek
výdělečných 	 vý-děl-eč-n-ých 	 vý-děleč-n-ých
výhodnější 	 vý-hod-n-ějš-í 	 výhodnější
výluka 	 vý-luk-a 	 výluka
výpotek 	 vý-pot-ek 	 vý-potek
výsostným 	 výs-ost-n-ý-m 	 výs-ost-n-ým
výukových 	 vý-uk-ov-ých 	 vý-ukových
významu 	 vý-znam-u 	 vý-znamu
výčitek 	 vý-čit-e-k 	 výčitek
výší 	 výš-í 	 výší
větrovka 	 větr-ovk-a 	 větr-ov-k-a
vůnička 	 vůn-ič-k-a 	 vůn-ičk-a
vůní 	 vůn-í 	 vůní
westermannem 	 westermann-e-m 	 westermann-em
whitney 	 whitney 	 whit-ney
yse 	 y-s-e 	 yse
zachytila 	 za-chyt-i-l-a 	 za-chyt-i-la
zacloumat 	 za-cloum-a-t 	 za-cloum-at
zafilosofovat 	 za-filo-sof-ova-t 	 za-fil-o-sof-ova-t
zahozených 	 za-hoz-en-ý-ch 	 za-hoz-en-ých
zahradník 	 za-hrad-n-ík 	 za-hradník
zahrnutí 	 za-hr-nu-t-í 	 za-hrnu-t-í
zahynul 	 za-hyn-u-l 	 za-hy-nu-l
zakazujícími 	 za-kaz-uj-íc-ími 	 zakazujícími
zakopaný 	 za-kop-a-n-ý 	 za-kopan-ý
zakuklit 	 za-kukl-i-t 	 za-kukl-it
zakusitelno 	 za-kus-i-tel-n-o 	 za-kus-i-teln-o
zakysávat 	 za-kys-á-v-a-t 	 za-kys-á-v-at
zakázek 	 za-káz-ek 	 za-kázek
zakázku 	 za-káz-k-u 	 za-kázku
zakázky 	 za-káz-k-y 	 za-káz-ky
zakázkách 	 za-káz-k-ách 	 za-kázkách
zakývala 	 za-kýv-a-l-a 	 za-kýva-l-a
zakývat 	 za-kýv-a-t 	 za-kýva-t
zalítnout 	 za-lít-nou-t 	 za-lít-nout
zamkl 	 za-mk-l 	 zamkl
zamotávat 	 za-mot-á-v-a-t 	 za-mot-á-v-at
zaměstnancům 	 za-měst-n-an-c-ům 	 za-měst-n-anc-ům
zaměstnání 	 za-měst-n-á-n-í 	 za-měst-n-án-í
zanadávat 	 za-na-d-á-v-a-t 	 za-na-dá-v-a-t
zapadající 	 za-pad-aj-íc-í 	 zapadající
zapomínat 	 za-pomín-a-t 	 za-po-mín-a-t
započísti 	 za-po-číst-i 	 za-po-čís-ti
zapříčiněné 	 za-pří-čin-ěn-é 	 za-příčiněn-é
zasahují 	 za-sah-u-j-í 	 za-sah-uj-í
zasklít 	 za-skl-í-t 	 za-sklít
zasklívaně 	 za-skl-í-v-a-n-ě 	 za-sklí-v-a-n-ě
zaslíbeni 	 za-s-líb-en-i 	 za-slíb-en-i
zasykla 	 za-syk-l-a 	 za-sykl-a
zasypaný 	 za-syp-a-n-ý 	 za-sypa-n-ý
zatrubňovávatelnost 	 za-trub-ň-ová-v-a-teln-ost 	 zatrubň-ová-v-a-teln-ost
zatvrzují 	 za-tvrz-u-j-í 	 zatvrz-uj-í
zatáčka 	 za-táč-k-a 	 za-táčk-a
zaujatý 	 z-au-j-a-t-ý 	 za-u-j-a-t-ý
zaujmouti 	 zau-jm-ou-ti 	 za-u-j-mou-ti
zavřeny 	 za-vř-e-n-y 	 za-vř-en-y
zavřít 	 za-vř-í-t 	 za-vří-t
začpít 	 za-čp-í-t 	 za-čpít
zašmudlat 	 za-šmudl-a-t 	 za-šmudl-at
zblízka 	 z-blíz-k-a 	 zblízka
zchlapčilý 	 z-chlap-č-i-l-ý 	 zchlapčilý
zdaleka 	 z-dal-ek-a 	 zdalek-a
zdeničky 	 zden-ič-k-y 	 zdeničky
zdeněk 	 zdeněk 	 zden-ěk
zdi 	 zd-i 	 zdi
zemana 	 zeman-a 	 zemana
zemím 	 zem-ím 	 zemím
zemědělské 	 zem-ě-děl-sk-é 	 zem-ě-dělské
zemědělských 	 zem-ě-děl-sk-ých 	 zemědělských
zheroizovavší 	 z-hero-izova-vš-í 	 z-heroizova-vš-í
zjednodušení 	 z-jedn-o-duš-en-í 	 z-jedn-oduš-ení
zjednodušilo 	 z-jedn-o-duš-i-l-o 	 z-jedn-o-duš-i-lo
zkoksovat 	 z-koks-ova-t 	 z-koksova-t
zkušeností 	 z-kuš-en-ost-í 	 zkuš-en-ostí
zkypřovat 	 z-kypř-ova-t 	 zkypř-ovat
zlodějsku 	 zl-o-děj-sk-u 	 zlo-děj-sk-u
zločinem 	 zl-o-čin-e-m 	 zl-o-čin-em
zlákat 	 z-lák-a-t 	 zlák-a-t
zlí 	 zl-í 	 zlí
zmramorovatěnost 	 z-mramor-ovat-ě-n-ost 	 z-mramor-ova-t-ě-n-ost
zmultiplicírovaný 	 z-multi-plic-ír-ova-n-ý 	 zmultiplicírova-ný
změněném 	 z-měn-ěn-é-m 	 z-měn-ěn-ém
znalých 	 zn-a-l-ých 	 zna-l-ých
zneužití 	 z-ne-u-ži-t-í 	 z-ne-u-žit-í
znovuoživenost 	 z-nov-u-o-živ-en-ost 	 z-nov-u-oži-v-en-ost
známku 	 znám-k-u 	 znám-ku
znásobovaný 	 z-násob-ova-n-ý 	 znásob-ovan-ý
zněkolikanásobit 	 z-ně-kolik-a-násob-i-t 	 z-ně-kolik-anásobit
zorganizovaný 	 z-organ-iz-ova-n-ý 	 z-organ-izova-n-ý
zostoudit 	 z-o-stoud-i-t 	 z-ostoud-i-t
zpevnět 	 z-pevn-ě-t 	 z-pev-n-ě-t
zprostředkovatelské 	 z-pro-střed-k-ova-tel-sk-é 	 z-pro-středkova-telské
zpuchlý 	 z-puch-l-ý 	 z-puchlý
zpět 	 zpět 	 zpě-t
zpěvačka 	 z-pě-v-a-č-k-a 	 z-pěvačk-a
zrentgenovat 	 z-rentgen-ova-t 	 z-re-ntgen-ova-t
zveřejněné 	 z-veřej-n-ě-n-é 	 z-veřej-n-ěn-é
zveřejnění 	 z-veřej-n-ě-n-í 	 z-veřej-n-ěn-í
zvládnou 	 z-vlád-n-ou 	 z-vlád-nou
zvláště 	 zvláště 	 zvlášt-ě
zvyky 	 z-vyk-y 	 z-vy-k-y
zválcovat 	 z-válc-ova-t 	 z-vál-c-ovat
zvídavější 	 z-víd-a-v-ějš-í 	 z-víd-avější
zádech 	 zád-e-ch 	 zád-ech
zájemci 	 zá-jem-c-i 	 zá-jemc-i
zákazníka 	 zá-kaz-ník-a 	 zákazníka
základem 	 zá-klad-e-m 	 zá-klad-em
zákoníku 	 zá-kon-ík-u 	 zá-koník-u
zámek 	 zá-mek 	 zámek
západními 	 zá-pad-n-ími 	 zá-padn-ími
zápraží 	 zá-praž-í 	 zá-praží
zármutku 	 zá-rmut-k-u 	 zá-rmutk-u
zásobování 	 zá-sob-ová-n-í 	 zá-sobová-n-í
zásobováním 	 zá-sob-ová-n-ím 	 zá-sobován-ím
závazných 	 zá-vaz-n-ých 	 zá-vazných
závazným 	 zá-vaz-n-ým 	 zá-vazným
závislý 	 zá-vis-l-ý 	 zá-visl-ý
závojnatkách 	 zá-voj-n-at-k-á-ch 	 závoj-natk-ách
zčásti 	 z-část-i 	 z-části
zůstal 	 z-ů-sta-l 	 z-ů-stal
úspěchy 	 ú-spěch-y 	 ú-spěchy
úspěšnější 	 ú-spěš-n-ějš-í 	 úspěšnější
úzká 	 úz-k-á 	 úzk-á
účinky 	 ú-čin-k-y 	 účin-k-y
úžasem 	 ú-žas-e-m 	 ú-žas-em
časově 	 čas-ov-ě 	 čas-ově
častovat 	 čast-ova-t 	 čast-ovat
čechy 	 čech-y 	 čechy
čekají 	 ček-aj-í 	 ček-ají
čekal 	 ček-a-l 	 čekal
čekalo 	 ček-a-l-o 	 čeka-lo
čepice 	 čep-ic-e 	 čep-ice
čepici 	 čep-ic-i 	 čepici
černosrstý 	 čern-o-srst-ý 	 čern-osrst-ý
černým 	 čern-ý-m 	 čern-ým
černýšovice 	 čern-ýš-ov-ic-e 	 čern-ýš-ovic-e
českomalínský 	 česk-o-malín-sk-ý 	 čes-k-omalín-sk-ý
českého 	 čes-k-é-ho 	 čes-k-ého
českým 	 čes-k-ým 	 českým
činila 	 čin-i-l-a 	 čin-i-la
čistokrevnou 	 čist-o-krev-n-ou 	 čist-okrev-n-ou
článkem 	 člán-k-e-m 	 člán-kem
čsfr 	 č-s-f-r 	 č-sfr
čsn 	 č-s-n 	 č-sn
čssr 	 č-s-s-r 	 č-ssr
čtveračit 	 čtver-ač-i-t 	 čtverač-i-t
čtvrtletního 	 čtvrt-let-n-ího 	 čtvrtlet-n-ího
čtvrtletí 	 čtvrt-let-í 	 čtvrtlet-í
čtěte 	 čt-ě-te 	 čt-ět-e
čubička 	 čub-ič-k-a 	 čubička
čubičku 	 čub-ič-k-u 	 čubičku
čvaňhat 	 čvaňh-a-t 	 čvaňhat
čzpi 	 č-z-p-i 	 čzpi
částka 	 část-k-a 	 část-ka
částku 	 část-k-u 	 část-ku
čáča 	 čáč-a 	 čáča
číhal 	 číh-a-l 	 číhal
čímkoliv 	 č-í-m-koliv 	 čí-m-koliv
číslovat 	 čísl-ova-t 	 čísl-ovat
ďoubat 	 ďoub-a-t 	 ďoub-at
ďáblem 	 ďábl-em 	 ďáblem
řetězových 	 řetěz-ov-ých 	 řetězových
řezání 	 řez-á-n-í 	 řez-ání
řídkým 	 říd-k-ým 	 řídkým
šedivý 	 šed-iv-ý 	 šediv-ý
šeků 	 šek-ů 	 šeků
šel 	 še-l 	 šel
šestigólový 	 šest-i-gól-ov-ý 	 šest-igól-ov-ý
šibal 	 šib-a-l 	 šib-al
šifrovaných 	 šifr-ova-n-ý-ch 	 šifr-ovan-ých
šimůnek 	 šimůn-ek 	 šimůnek
škrtil 	 škrt-i-l 	 škrt-il
škudlit 	 škud-l-i-t 	 škudli-t
škádlit 	 škádl-i-t 	 škádli-t
šohajky 	 šohaj-k-y 	 šohajky
špicovat 	 špic-ova-t 	 špic-ovat
špionáže 	 špion-áž-e 	 špionáž-e
šplouná 	 šplou-n-á 	 šploun-á
šprýmovat 	 šprým-ova-t 	 šprýmovat
špásovat 	 špás-ova-t 	 špás-ovat
švýcarské 	 švýcar-sk-é 	 švýcar-ské
šílí 	 šíl-í 	 šílí
žehlit 	 žehl-i-t 	 žehli-t
žehrat 	 žehr-a-t 	 že-hr-a-t
žehravost 	 žehr-a-v-ost 	 že-hrav-ost
železárnách 	 želez-árn-ách 	 železárn-ách
ženatý 	 žen-at-ý 	 žen-atý
živelná 	 ži-v-el-n-á 	 ži-v-eln-á
živnostenského 	 ži-v-n-ost-ensk-ého 	 ži-v-nosten-sk-ého
životními 	 ži-v-ot-n-í-m-i 	 ži-v-ot-n-ími
žižkovák 	 žižkov-ák 	 žižkovák
žlábkovávající 	 žláb-k-ová-v-aj-íc-í 	 žláb-ková-v-ající
žáby 	 žáb-y 	 žáby
žádali 	 žád-a-l-i 	 žád-a-li
žádoucí 	 žád-ou-c-í 	 žádoucí
