abbé 	 abb-é 	 abbé
absolutno 	 absolut-n-o 	 absolut-no
absolventi 	 ab-solv-ent-i 	 absolv-enti
abychom 	 a-by-chom 	 abychom
achronisticky 	 a-chron-ist-ic-k-y 	 achron-ist-icky
adami 	 adami 	 adam-i
adaptabilní 	 adapt-abil-n-í 	 adaptabil-n-í
adresátů 	 adres-át-ů 	 adresát-ů
advokát 	 advok-át 	 advoká-t
aeromagneticky 	 aero-magnet-ic-k-y 	 aeromagnet-icky
agovávat 	 agov-á-v-a-t 	 agov-áv-a-t
aktivitami 	 akt-iv-it-ami 	 aktivit-ami
aktivní 	 akt-iv-n-í 	 aktivn-í
aktovce 	 akt-ov-c-e 	 aktovc-e
aktuálního 	 akt-uál-n-ího 	 aktuál-n-ího
alfou 	 alf-ou 	 alfou
aloise 	 alois-e 	 aloise
amerikanismem 	 amerik-an-ism-e-m 	 amerik-anismem
amerikánská 	 amerik-án-sk-á 	 amerik-ánsk-á
amplifikovat 	 ampli-fik-ova-t 	 amplifik-ova-t
anatólii 	 anatól-i-i 	 anatól-ii
anglosaskou 	 angl-o-sas-k-ou 	 anglosask-ou
antala 	 antal-a 	 anta-l-a
anthony 	 anthony 	 anthon-y
anticipovat 	 anti-cip-ova-t 	 anticipova-t
antidatujeme 	 anti-dat-uje-me 	 antidat-ujeme
architektury 	 archi-tekt-ur-y 	 architektury
arcilotras 	 arci-lotr-as 	 arcilotras
argentiny 	 argentin-y 	 argent-iny
aristokratismu 	 aristo-krat-ism-u 	 aristo-krat-ismu
asekurovat 	 a-sekur-ova-t 	 asekur-ova-t
asistentů 	 asist-ent-ů 	 asistent-ů
atamanem 	 ataman-e-m 	 atam-an-em
atlet 	 atlet 	 atle-t
austrálie 	 austrál-i-e 	 austrál-ie
autobazar 	 aut-o-bazar 	 autobazar
automobilka 	 automobil-k-a 	 auto-mobil-k-a
avšak 	 a-však 	 avšak
babičku 	 bab-ič-k-u 	 babičk-u
balený 	 bal-en-ý 	 balen-ý
balených 	 bal-en-ých 	 balen-ých
balit 	 bal-i-t 	 bali-t
bankovek 	 bank-ovek 	 bankovek
bankovním 	 bank-ovn-ím 	 bankovním
barikádovat 	 barik-ád-ova-t 	 barikád-ova-t
batňovic 	 batňovic 	 batň-ovic
baťa 	 bať-a 	 baťa
benediktýnů 	 benedikt-ýn-ů 	 benediktýn-ů
benzylchorid 	 benz-yl-chor-id 	 benzylchorid
berehovsky 	 bereh-ov-sk-y 	 berehovsk-y
bezchybný 	 bez-chyb-n-ý 	 bezchyb-n-ý
bezesných 	 beze-sn-ých 	 bezesn-ých
bezpečný 	 bezpeč-n-ý 	 bez-peč-n-ý
bezplatnou 	 bez-plat-n-ou 	 bezplat-n-ou
bezpředpokladová 	 bez-před-po-klad-ov-á 	 bez-před-pok-ladová
bečce 	 beč-c-e 	 bečc-e
bionaftu 	 bio-naft-u 	 bionaft-u
bionafty 	 bio-naft-y 	 bionafty
blahopřejeme 	 blah-o-pře-je-me 	 blahopřejeme
blekotat 	 blek-ot-a-t 	 blekot-a-t
bližší 	 bliž-š-í 	 bližš-í
bludišti 	 blud-išt-i 	 blud-išti
bláznivého 	 blázn-iv-ého 	 blázniv-ého
bobek 	 bob-ek 	 bobek
bodiny 	 bod-in-y 	 bodin-y
bolení 	 bol-e-n-í 	 bolen-í
bolest 	 bol-est 	 bolest
bolívie 	 bolív-i-e 	 bolívie
božínku 	 bož-ín-k-u 	 božínk-u
branka 	 bran-k-a 	 brank-a
brankář 	 bran-k-ář 	 brank-ář
brečeli 	 breč-e-l-i 	 breč-el-i
britské 	 brit-sk-é 	 britsk-é
britští 	 brit-št-í 	 britšt-í
brummellův 	 brummell-ův 	 brummellův
budoucnosti 	 bud-ou-c-n-ost-i 	 budouc-n-ost-i
budoucím 	 bud-ouc-ím 	 budouc-ím
budu 	 bud-u 	 budu
budweiserová 	 budweiser-ov-á 	 budweiser-ová
bujně 	 buj-n-ě 	 bujn-ě
bulletinu 	 bulletin-u 	 bullet-inu
bych 	 by-ch 	 bych
byla 	 by-l-a 	 byla
bytu 	 by-t-u 	 bytu
bytě 	 by-t-ě 	 bytě
bázlivá 	 bá-z-l-iv-á 	 bázliv-á
báša 	 báš-a 	 báša
bít 	 bí-t 	 bít
bývávaly 	 bý-v-á-v-a-l-y 	 býváva-l-y
běláskové 	 běl-ás-k-ové 	 běláskové
běžně 	 běž-ně 	 běž-n-ě
bříško 	 bříš-k-o 	 bříšk-o
celkovou 	 cel-k-ov-ou 	 celk-ov-ou
celková 	 cel-k-ov-á 	 celk-ov-á
celkové 	 cel-k-ov-é 	 celk-ov-é
celníky 	 cel-n-ík-y 	 celn-ík-y
celoživotní 	 cel-o-ži-v-ot-n-í 	 celoživot-n-í
celu 	 cel-u 	 celu
cennou 	 cen-n-ou 	 cenn-ou
cenou 	 cen-ou 	 cenou
cenovky 	 cen-ovk-y 	 cenovk-y
ceník 	 cen-ík 	 ceník
cephalocereus 	 cephalocereus 	 cephal-ocereus
cepovat 	 cep-ova-t 	 cepova-t
cestující 	 cest-uj-í-c-í 	 cest-uj-ící
chcete 	 chc-e-te 	 chce-te
chcíplá 	 chcíp-l-á 	 chcípl-á
chladná 	 chlad-n-á 	 chladn-á
chlapec 	 chlap-ec 	 chlapec
chlapík 	 chlap-ík 	 chlapík
chlácholil 	 chláchol-i-l 	 chlácholi-l
chrstat 	 chrst-a-t 	 chrsta-t
chtěli 	 cht-ě-l-i 	 chtě-l-i
chutnání 	 chut-n-á-n-í 	 chutnán-í
chvalořečit 	 chval-o-řeč-i-t 	 chvalořeč-i-t
chvilce 	 chvil-c-e 	 chvilc-e
chvílích 	 chvíl-í-ch 	 chvíl-ích
chystané 	 chyst-a-n-é 	 chystan-é
cigarety 	 cigar-et-y 	 cigarety
cimrmanovština 	 cimrman-ov-št-in-a 	 cimrmanovština
citlivostí 	 cit-l-iv-ost-í 	 citl-iv-ost-í
citovaného 	 cit-ova-n-ého 	 citovan-ého
cizince 	 ciz-in-c-e 	 cizinc-e
colubrina 	 colubrin-a 	 colubrina
cos 	 c-o-s 	 cos
courama 	 cour-ama 	 cour-am-a
ctihodnými 	 ct-i-hod-n-ý-m-i 	 ctihod-n-ými
cácorka 	 các-or-k-a 	 cácork-a
cílem 	 cíl-e-m 	 cílem
cílevědomý 	 cíl-e-věd-om-ý 	 cílevědom-ý
daktyloskopie 	 daktylo-skopi-e 	 daktyl-oskopie
dali 	 d-a-l-i 	 dali
daly 	 d-a-l-y 	 daly
dana 	 dan-a 	 dana
danost 	 d-a-n-ost 	 danost
dané 	 d-a-n-é 	 dané
daru 	 dar-u 	 daru
daty 	 dat-y 	 daty
degradovat 	 de-grad-ova-t 	 degrad-ova-t
deklarována 	 de-klar-ová-n-a 	 deklar-ová-n-a
deklarováno 	 de-klar-ová-n-o 	 deklar-ová-n-o
deklarují 	 de-klar-uj-í 	 deklar-ují
delikátnostem 	 delikát-n-ost-e-m 	 delikát-n-ostem
delonovsky 	 delon-ov-sk-y 	 delonovsk-y
demokratizovat 	 demo-krat-iz-ova-t 	 demo-krat-izovat
demoralizovat 	 de-moral-iz-ova-t 	 demoral-iz-ova-t
denní 	 den-n-í 	 denn-í
denním 	 den-n-í-m 	 denn-ím
desíti 	 desít-i 	 desí-ti
devět 	 devět 	 devě-t
dezinfikovat 	 dez-infik-ova-t 	 dezinfik-ova-t
dezinteresovat 	 dez-interes-ova-t 	 dezinteresovat
dezorganizovat 	 dez-organ-iz-ova-t 	 dezorgan-izovat
dešifrovat 	 de-šifr-ova-t 	 dešifr-ova-t
diavolo 	 diavolo 	 diavol-o
diky 	 dik-y 	 diky
diplomové 	 diplom-ov-é 	 diplom-ové
diskařský 	 disk-ař-sk-ý 	 diskař-sk-ý
diskreditovat 	 dis-kred-it-ova-t 	 diskredit-ovat
distanční 	 dis-tanč-n-í 	 distan-čn-í
divocí 	 div-oc-í 	 divoc-í
divoši 	 div-oš-i 	 divoš-i
divák 	 div-ák 	 divák
dkp 	 d-k-p 	 dkp
dlouhodobého 	 dlouh-o-dob-ého 	 dlouhodob-ého
dnešek 	 dneš-ek 	 dnešek
dno 	 dn-o 	 dno
dober 	 do-ber 	 dober
dobrodiní 	 dobr-o-di-n-í 	 dobrod-in-í
dobrozdání 	 dobr-o-zd-á-n-í 	 dobrozdán-í
dobráka 	 dobr-ák-a 	 dobrák-a
dobudovat 	 do-bud-ova-t 	 dobud-ova-t
dobyli 	 do-by-l-i 	 dobyl-i
dobytek 	 do-byt-ek 	 dobytek
dobytí 	 do-by-tí 	 dobyt-í
dobíhají 	 do-bíh-aj-í 	 dobíh-aj-í
docházela 	 do-cház-e-l-a 	 do-cház-el-a
dodacích 	 do-d-a-c-ích 	 dodac-ích
dodat 	 do-d-a-t 	 dod-a-t
dodavatel 	 do-d-a-v-a-tel 	 dodav-a-tel
dodavatelem 	 do-d-a-v-a-tel-em 	 doda-va-telem
dodiveně 	 do-div-en-ě 	 dodiv-en-ě
dodržovat 	 do-drž-ova-t 	 dodrž-ova-t
dodržování 	 do-drž-ová-n-í 	 dodrž-ová-n-í
dodáno 	 do-d-á-n-o 	 dod-án-o
dodávat 	 do-d-á-v-a-t 	 dodá-v-a-t
dodávka 	 do-d-á-v-k-a 	 dodáv-k-a
dohromady 	 do-hromad-y 	 dohromady
dojmů 	 do-jm-ů 	 dojm-ů
dokonaleji 	 do-kon-a-l-eji 	 dokonal-eji
dokonalého 	 do-kon-a-l-é-ho 	 do-kon-a-l-ého
dokonávat 	 do-kon-á-v-a-t 	 do-kon-á-va-t
dole 	 dol-e 	 dole
doletovat 	 do-let-ova-t 	 dolet-ova-t
dolnolužický 	 doln-o-luž-ick-ý 	 doln-oluž-ick-ý
doloudat 	 do-loud-a-t 	 doloud-a-t
domlouvat 	 do-mlouv-a-t 	 domlouva-t
domáknout 	 do-mák-nou-t 	 domák-nou-t
domílat 	 do-míl-a-t 	 domíl-a-t
dopít 	 do-pí-t 	 dopí-t
dorachtávatelnost 	 do-racht-á-v-a-teln-ost 	 dorachtá-v-a-teln-ost
dostavili 	 do-stav-i-l-i 	 do-stav-il-i
dostaviti 	 do-stav-i-ti 	 do-stav-iti
dostrkali 	 do-strk-a-l-i 	 dostrk-ali
dostávají 	 do-stá-v-aj-í 	 do-stáv-ají
dostává 	 do-stá-v-á 	 do-stáv-á
dostřelit 	 do-střel-i-t 	 dostřel-i-t
dosvědčíme 	 do-s-věd-č-í-me 	 do-svěd-č-íme
dotazníky 	 do-taz-ník-y 	 do-taz-n-ík-y
dotazy 	 do-taz-y 	 dotaz-y
dotloukat 	 do-tlouk-a-t 	 dotlouk-a-t
dovedeš 	 do-ved-e-š 	 dovedeš
dovinout 	 do-vi-nou-t 	 dovi-nou-t
dovnitř 	 do-v-nitř 	 dovnitř
dovozem 	 do-voz-em 	 dovoz-em
dovřít 	 do-vř-í-t 	 dovř-í-t
doznávala 	 do-zn-á-v-a-l-a 	 do-zná-v-a-l-a
dozvíte 	 do-z-v-í-te 	 dozví-te
dozvěděli 	 do-z-věd-ě-l-i 	 doz-věd-ě-l-i
dočtete 	 do-čt-e-te 	 dočt-e-te
dočíst 	 do-čís-t 	 dočís-t
dožebrat 	 do-žebr-a-t 	 dožebr-a-t
drbaný 	 drb-a-n-ý 	 drban-ý
drkotali 	 drk-ot-a-l-i 	 drkot-al-i
druhém 	 druh-é-m 	 druh-ém
družnosti 	 druž-n-ost-i 	 druž-n-osti
drápek 	 dráp-ek 	 drápek
duchovně 	 duch-ov-n-ě 	 duchov-n-ě
duní 	 dun-í 	 duní
dupání 	 dup-á-n-í 	 dupán-í
durajková 	 durajk-ov-á 	 durajk-ová
dušiček 	 duš-iček 	 dušiček
dvanáct 	 dv-a-náct 	 dvanác-t
dveřích 	 dveř-í-ch 	 dveř-ích
dvojnásobek 	 dv-oj-ná-sob-ek 	 dvoj-násobek
dvojí 	 dv-oj-í 	 dvoj-í
dvouměsíční 	 dv-ou-měsíč-n-í 	 dvouměsíč-n-í
dvoustraně 	 dv-ou-stran-ě 	 dvoustran-ě
dynamická 	 dynam-ic-k-á 	 dynam-ick-á
dynamika 	 dynam-ik-a 	 dynamik-a
dálkové 	 dál-k-ov-é 	 dálk-ov-é
dává 	 d-á-v-á 	 dáv-á
dávána 	 d-á-v-á-n-a 	 dáván-a
díra 	 dír-a 	 díra
dívají 	 dív-aj-í 	 dívaj-í
díváš 	 dív-á-š 	 dívá-š
dědečkův 	 děd-eč-k-ův 	 dědečk-ův
dějiny 	 děj-in-y 	 dějin-y
dělostřelec 	 děl-o-střel-ec 	 děl-ostřel-ec
děti 	 dět-i 	 děti
dětské 	 dět-sk-é 	 dětsk-é
dřevěný 	 dřev-ě-n-ý 	 dřev-ěn-ý
dřít 	 dř-í-t 	 dřít
dřívějších 	 dřív-ějš-ích 	 dřív-ěj-š-ích
důchod 	 dů-chod 	 důchod
důchodového 	 dů-chod-ov-ého 	 důchod-ov-ého
důkladněji 	 dů-klad-n-ěji 	 důklad-n-ěji
důležitá 	 dů-lež-it-á 	 důlež-it-á
důsledky 	 dů-sled-k-y 	 důsled-k-y
ekonomech 	 eko-nom-ech 	 ekonom-ech
ekonomickou 	 eko-nom-ick-ou 	 eko-nomick-ou
ekonomové 	 eko-nom-ov-é 	 ekonomové
empirických 	 empir-ic-k-ý-ch 	 empir-ick-ých
energie 	 energ-i-e 	 energie
eva 	 ev-a 	 eva
evropského 	 evrop-sk-ého 	 evropsk-ého
experiment 	 experi-ment 	 experiment
experimentaci 	 experi-ment-ac-i 	 exper-imentaci
exportu 	 ex-port-u 	 export-u
faktorů 	 fakt-or-ů 	 faktor-ů
faktury 	 fakt-ur-y 	 faktur-y
fanoušků 	 fan-oušk-ů 	 fanoušk-ů
farmaceutické 	 farmac-eut-ick-é 	 farmac-eut-ické
fastfood 	 fast-food 	 fastfood
finálním 	 fin-ál-n-ím 	 fináln-ím
fluorově 	 fluor-ov-ě 	 fluorov-ě
fondem 	 fondem 	 fond-em
formulací 	 form-ul-ac-í 	 formul-ac-í
formát 	 form-át 	 form-á-t
formátů 	 form-át-ů 	 formát-ů
fosforeskovat 	 fosfor-esk-ova-t 	 fosforesk-ovat
francouzsky 	 franc-ouz-sk-y 	 francouzsk-y
francouzského 	 franc-ouz-sk-ého 	 francouzsk-ého
františek 	 frant-iš-ek 	 františek
friesovský 	 fries-ov-sk-ý 	 friesovsk-ý
frotýrovat 	 frot-ýr-ova-t 	 frotýr-ova-t
ft 	 f-t 	 ft
fyzický 	 fyz-ic-k-ý 	 fyzick-ý
gastronomie 	 gastr-o-nom-i-e 	 gastronomie
generace 	 gener-ac-e 	 generace
generál 	 gener-ál 	 generál
gestikulovat 	 gestik-ul-ova-t 	 gestikul-ova-t
graessnerii 	 graessnerii 	 graessneri-i
graessneriji 	 graessneriji 	 graessner-iji
greenwalda 	 green-wald-a 	 greenwald-a
greenwaldovi 	 green-wald-ovi 	 greenwaldovi
halou 	 hal-ou 	 halou
halu 	 hal-u 	 halu
haly 	 hal-y 	 haly
haló 	 haló 	 hal-ó
hegelianism 	 hegelian-ism 	 hegelianism
hejkavec 	 hejkavec 	 hejkav-ec
hematologického 	 hemat-o-log-ick-ého 	 hemato-log-ick-ého
herní 	 her-n-í 	 hern-í
hladce 	 hlad-c-e 	 hladc-e
hladověli 	 hlad-ov-ě-l-i 	 hlad-ověl-i
hledám 	 hled-á-m 	 hled-ám
hmotnostech 	 hmot-n-ost-ech 	 hmotnost-ech
hmotnosti 	 hmot-n-ost-i 	 hmot-n-osti
hmotnostní 	 hmot-n-ost-n-í 	 hmot-n-ostn-í
hmotného 	 hmot-n-é-ho 	 hmot-n-ého
hnedle 	 hned-le 	 hnedle
hnutí 	 h-nu-t-í 	 hnut-í
hnízdech 	 hnízd-e-ch 	 hnízd-ech
hochschule 	 hoch-schule 	 hochschul-e
hodinek 	 hodin-ek 	 hodinek
hodláte 	 hodl-á-te 	 hodlá-te
hodnotu 	 hod-n-ot-u 	 hodnot-u
hodnotím 	 hod-n-ot-í-m 	 hodn-ot-ím
holandsku 	 holand-sk-u 	 holandsk-u
holanďan 	 holanď-an 	 holanďan
holiči 	 hol-i-č-i 	 holič-i
holčičkou 	 hol-č-ič-k-ou 	 holč-ičk-ou
honili 	 hon-i-l-i 	 honil-i
honoráře 	 honor-ář-e 	 honorář-e
horolezci 	 hor-o-lez-c-i 	 horolezci
horoucně 	 hor-ou-c-n-ě 	 horouc-n-ě
horálek 	 horálek 	 horál-ek
hotovostí 	 hotov-ost-í 	 hotovost-í
houževnatá 	 houžev-n-at-á 	 houževnat-á
hovět 	 hov-ě-t 	 hově-t
hra 	 hr-a 	 hra
hrbáčův 	 hrb-áč-ův 	 hrbáč-ův
hrdostí 	 hrd-ost-í 	 hrdost-í
hromková 	 hrom-k-ov-á 	 hromk-ová
hroznou 	 hrozn-ou 	 hroz-n-ou
hry 	 hr-y 	 hry
hrála 	 hrá-l-a 	 hrál-a
hrálo 	 hrá-l-o 	 hrál-o
hubatou 	 hub-at-ou 	 hubat-ou
huby 	 hub-y 	 huby
hudby 	 hud-b-y 	 hudb-y
hudební 	 hud-eb-n-í 	 hudeb-n-í
hudebníci 	 hud-eb-níc-i 	 hudebn-íc-i
hulit 	 hul-i-t 	 huli-t
husími 	 hus-í-m-i 	 hus-ími
huti 	 hut-i 	 huti
hvězdičky 	 hvězd-ič-k-y 	 hvězd-ičky
hádali 	 hád-a-l-i 	 hádal-i
hřbitov 	 hřbitov 	 hřbit-ov
hřmět 	 hřm-ě-t 	 hřmě-t
identifikační 	 identi-fik-ač-n-í 	 identifik-ační
imigraci 	 i-migr-ac-i 	 imigr-ac-i
imitovat 	 imit-ova-t 	 i-mit-ova-t
improvizovat 	 im-prov-iz-ova-t 	 improv-izova-t
imunoenzymatický 	 imun-o-enzym-at-ick-ý 	 imunoenzy-matický
inaugurován 	 inaugur-ová-n 	 inaugur-ován
indikátorem 	 in-dik-át-or-em 	 indikátor-em
individuální 	 in-divid-u-ál-n-í 	 individuáln-í
informačním 	 in-form-ač-n-ím 	 inform-ač-n-ím
informován 	 in-form-ová-n 	 inform-ován
informuje 	 in-form-uje 	 inform-uje
inkriminované 	 in-krimin-ova-n-é 	 inkrim-in-ované
inovace 	 inov-ace 	 inovac-e
inspektor 	 in-spekt-or 	 inspektor
inspirovat 	 in-spir-ova-t 	 inspir-ova-t
instalaci 	 in-stal-ac-i 	 instal-aci
instrumentovat 	 instrument-ova-t 	 instrumentovat
instrumentů 	 instru-ment-ů 	 instrument-ů
inteligenci 	 intelig-enc-i 	 inteligenc-i
interesovat 	 interes-ova-t 	 interesova-t
invalidní 	 in-valid-n-í 	 invalid-ní
investičními 	 in-vest-ič-n-ími 	 invest-ič-n-ími
investovalo 	 in-vest-ova-l-o 	 invest-ova-l-o
inzerátech 	 inzer-át-e-ch 	 inzerát-ech
inženýrském 	 inženýr-sk-ém 	 inženýrsk-ém
ivančic 	 ivan-č-ic 	 ivanč-ic
jablíčko 	 jablíč-k-o 	 jabl-íč-k-o
jací 	 jac-í 	 jací
jakoby 	 jak-o-by 	 jakob-y
jakost 	 jak-ost 	 jakost
jakoupak 	 jak-ou-pak 	 jakoupak
jakého 	 jak-é-ho 	 jak-ého
jakéhokoliv 	 jak-é-ho-koliv 	 jakéhokoliv
jakže 	 jak-že 	 jakž-e
janků 	 jan-k-ů 	 jank-ů
janské 	 jan-sk-é 	 jansk-é
javelin 	 javelin 	 javel-in
jazejček 	 jazejč-ek 	 jazejček
jděte 	 jd-ě-te 	 jděte
jednali 	 jedn-a-l-i 	 jedn-al-i
jednalo 	 jedn-a-l-o 	 jedn-al-o
jednatelem 	 jedn-a-tel-e-m 	 jedn-a-telem
jednom 	 jedn-o-m 	 jedn-om
jednomotorových 	 jedn-o-motor-ov-ých 	 jedn-omotorových
jednomu 	 jedn-o-mu 	 jedn-omu
jednoosý 	 jedn-o-os-ý 	 jednoosý
jednorázové 	 jedn-o-ráz-ov-é 	 jednorázové
jednota 	 jedn-ot-a 	 jednot-a
jednotlivina 	 jedn-ot-liv-in-a 	 jedn-ot-liv-ina
jedním 	 jedn-í-m 	 jedn-ím
jejích 	 je-j-í-ch 	 jej-ích
jela 	 je-l-a 	 jela
jenjen 	 jen-jen 	 jenjen
jenže 	 jen-že 	 jenže
jevil 	 jev-i-l 	 jevi-l
ješitnost 	 ješit-n-ost 	 ješitn-ost
ježatý 	 jež-at-ý 	 ježat-ý
ježibabo 	 ježibab-o 	 ježibabo
jimž 	 j-i-m-ž 	 jimž
jindy 	 jin-d-y 	 jind-y
jinonice 	 jinonic-e 	 jinon-ice
jiní 	 jin-í 	 jiní
jistota 	 jist-ot-a 	 jistot-a
jmenují 	 jmen-u-j-í 	 jmen-uj-í
jupiterovy 	 jupiter-ov-y 	 jupiterov-y
juránkův 	 jur-ánk-ův 	 jurán-k-ův
jídlo 	 jí-dl-o 	 jídl-o
kadidlo 	 kad-i-dl-o 	 kadidl-o
kalkulovat 	 kalk-ul-ova-t 	 kalkul-ova-t
kamera 	 kamera 	 kamer-a
kanadský 	 kanad-sk-ý 	 kanad-ský
kanadským 	 kanad-sk-ým 	 kanad-ským
kanonizovat 	 kanon-iz-ova-t 	 kanonizova-t
kapacity 	 kapacit-y 	 kapacity
kapely 	 kapel-y 	 kape-l-y
kapesníček 	 kapes-níč-ek 	 kapesn-íček
kapitální 	 kapitál-n-í 	 kapitál-ní
kardašovy 	 kardašov-y 	 kardaš-ovy
katalogy 	 kata-log-y 	 katalogy
katalozích 	 kata-loz-ích 	 kataloz-ích
kavalírem 	 kaval-ír-e-m 	 kaval-ír-em
kavkám 	 kav-k-ám 	 kavk-ám
kaše 	 kaš-e 	 kaše
každému 	 každ-é-mu 	 každ-ému
kdovíkdo 	 kd-o-v-í-kd-o 	 kdovík-do
kdož 	 kdo-ž 	 kdož
kg 	 k-g 	 kg
kina 	 kin-a 	 kina
klasifikaci 	 klasi-fik-ac-i 	 klasifik-ac-i
klausův 	 klaus-ův 	 klausův
kliniky 	 klinik-y 	 klin-ik-y
klnout 	 kl-nou-t 	 klnou-t
klouznout 	 klouz-nou-t 	 klouz-nout
klášterem 	 klášter-e-m 	 kláš-ter-em
klít 	 klí-t 	 klít
knížete 	 kníž-et-e 	 kníž-e-te
kocouří 	 koc-ouř-í 	 kocouř-í
kodrcat 	 kodrc-a-t 	 kodrca-t
koho 	 k-o-ho 	 koho
kompetence 	 kompetenc-e 	 kompet-enc-e
komu 	 k-o-mu 	 komu
konceptem 	 koncept-em 	 konceptem
koncertem 	 koncert-em 	 koncertem
koncipováním 	 kon-cip-ová-n-ím 	 koncip-ová-n-ím
kondenzátor 	 kondenz-átor 	 kondenzátor
konečná 	 koneč-n-á 	 konečn-á
konfederovat 	 kon-feder-ova-t 	 konfeder-ova-t
koninou 	 kon-in-ou 	 konin-ou
konkretizovat 	 kon-kret-iz-ova-t 	 kon-kret-iz-ovat
konkrétního 	 konkrét-n-ího 	 kon-krét-n-ího
konkrétnímu 	 kon-krét-n-í-mu 	 kon-krét-n-ímu
konstatování 	 kon-stat-ová-n-í 	 konstat-ová-n-í
kontaminovat 	 kon-tamin-ova-t 	 kontamin-ova-t
kontilití 	 konti-li-t-í 	 kontil-it-í
kontraindikace 	 kontra-in-dik-ac-e 	 kontraindikace
kontrolorů 	 kontrol-or-ů 	 kontrolor-ů
konviktem 	 kon-vikt-e-m 	 konviktem
konírny 	 kon-ír-n-y 	 konírn-y
kopce 	 kop-c-e 	 kopc-e
kopl 	 kop-l 	 kopl
kopřivnická 	 kopřiv-n-ic-k-á 	 kopřivnic-k-á
korat 	 kor-a-t 	 kora-t
korespondenčními 	 ko-re-spond-enč-n-ími 	 korespondenč-n-ími
korovatět 	 kor-ov-at-ě-t 	 korovat-ě-t
kosmického 	 kosm-ic-k-é-ho 	 kosmic-k-ého
kostička 	 kost-ič-k-a 	 kost-ičk-a
kostýmy 	 kostým-y 	 kostýmy
koňských 	 koň-sk-ý-ch 	 koňsk-ých
kožené 	 kož-en-é 	 kožen-é
kožiše 	 kož-iš-e 	 kožiš-e
krakově 	 krakov-ě 	 krak-ov-ě
kriminální 	 krimin-ál-n-í 	 krimin-áln-í
kristapána 	 krist-a-pán-a 	 kristapán-a
krumlova 	 krumlov-a 	 kruml-ova
krvavět 	 krv-av-ě-t 	 krvavě-t
krytý 	 kry-t-ý 	 kryt-ý
krásným 	 krás-n-ý-m 	 krás-n-ým
krátkodobé 	 krát-k-o-dob-é 	 krát-ko-dob-é
kterého 	 kter-é-ho 	 kter-ého
kudrnatět 	 kudr-n-at-ě-t 	 kudrnatět
kufříku 	 kufř-ík-u 	 kufřík-u
kunovice 	 kun-ovic-e 	 kunovice
kupkovat 	 kup-k-ova-t 	 kupk-ova-t
kupující 	 kup-uj-íc-í 	 kupuj-íc-í
kuriozity 	 kurioz-it-y 	 kuriozity
kučeravět 	 kučer-av-ě-t 	 kučer-av-ět
kydat 	 kyd-a-t 	 kyda-t
kyčel 	 kyčel 	 kyče-l
křepčit 	 křep-č-i-t 	 křepč-i-t
křestním 	 křest-n-í-m 	 křestn-ím
křivkami 	 křiv-k-a-m-i 	 křiv-k-ami
křivkách 	 křiv-k-ách 	 křivk-ách
křižovatce 	 křiž-ovat-c-e 	 křiž-ovatc-e
křídlem 	 kří-dl-e-m 	 křídl-em
kšeft 	 kšeft 	 kšef-t
kůzlátek 	 kůzl-át-ek 	 kůzlátek
lavina 	 lav-in-a 	 lavin-a
lavírovat 	 lav-ír-ova-t 	 lavír-ova-t
laťkovat 	 lať-k-ova-t 	 laťk-ova-t
lecčems 	 lec-č-e-m-s 	 lecč-ems
ledna 	 led-n-a 	 ledn-a
lehce 	 leh-c-e 	 lehc-e
lehko 	 leh-k-o 	 lehk-o
lehkým 	 leh-k-ý-m 	 leh-k-ým
lesa 	 les-a 	 lesa
lesním 	 les-n-ím 	 lesn-ím
letadel 	 let-a-del 	 letadel
letadlech 	 let-a-dl-ech 	 letadl-ech
letiště 	 let-išt-ě 	 letišt-ě
letouny 	 let-oun-y 	 letoun-y
letáky 	 let-ák-y 	 leták-y
letíš 	 let-í-š 	 letíš
ležákem 	 lež-ák-em 	 ležák-em
lhostejnět 	 lhostej-n-ě-t 	 lhostejně-t
lidem 	 lid-e-m 	 lidem
ligni 	 ligni 	 lign-i
lihem 	 lih-em 	 lihem
limit 	 limit 	 limi-t
limitováno 	 limit-ová-n-o 	 limit-ován-o
linkovat 	 lin-k-ova-t 	 link-ova-t
lkát 	 lk-á-t 	 lkát
logikou 	 log-ik-ou 	 logik-ou
loni 	 lon-i 	 loni
lotsenovu 	 lotsen-ov-u 	 lotsen-ovu
loupežníkem 	 loup-ež-n-ík-e-m 	 loup-ež-n-ík-em
loupežníkovi 	 loup-ež-n-ík-ovi 	 loupež-n-ík-ovi
loupežníku 	 loup-ež-n-ík-u 	 loup-ež-níku
ložnicový 	 lož-nic-ov-ý 	 ložnic-ový
ltd 	 l-t-d 	 ltd
lukách 	 luk-á-ch 	 luk-ách
lumpačit 	 lump-ač-i-t 	 lumpač-i-t
lupa 	 lup-a 	 lupa
látky 	 lát-k-y 	 látk-y
lékařem 	 lék-ař-e-m 	 lékař-em
lékem 	 lék-e-m 	 lékem
lékárnám 	 lék-ár-n-ám 	 lékárnám
lékárně 	 lék-ár-n-ě 	 lékár-n-ě
léčbě 	 léč-b-ě 	 léčb-ě
líbezně 	 líb-ez-n-ě 	 líbezn-ě
lístek 	 líst-ek 	 lístek
lístečcích 	 líst-ečc-ích 	 lísteč-c-ích
lístku 	 líst-k-u 	 lístk-u
lístky 	 líst-k-y 	 lístk-y
lístků 	 líst-k-ů 	 lístk-ů
lítosti 	 lít-ost-i 	 lítosti
majíce 	 m-aj-íc-e 	 majíc-e
makrokonvertor 	 makro-kon-ver-t-or 	 makrokonvertor
maličkosti 	 mal-ič-k-ost-i 	 maličk-ost-i
maličký 	 mal-ič-k-ý 	 maličk-ý
malkovského 	 malkovsk-ého 	 malk-ovsk-ého
malém 	 mal-ém 	 malém
mamlasovi 	 maml-as-ovi 	 mamlas-ovi
manager 	 manag-er 	 manager
manýrám 	 manýr-á-m 	 manýr-ám
manšestrovém 	 manšestr-ov-ém 	 manšestrovém
manšestrový 	 manšestr-ov-ý 	 manšestrový
mariánských 	 mari-án-sk-ých 	 marián-sk-ých
marketingový 	 market-ing-ov-ý 	 market-ingov-ý
marně 	 mar-n-ě 	 marn-ě
marrackův 	 marrack-ův 	 marrackův
masivní 	 mas-iv-n-í 	 masivn-í
materialisty 	 mater-i-al-ist-y 	 material-isty
materiálové 	 materi-ál-ov-é 	 materiálové
materiálu 	 mater-i-ál-u 	 materiálu
mazání 	 maz-á-n-í 	 mazán-í
melodie 	 melod-i-e 	 melodie
memnónovy 	 memnón-ov-y 	 memnón-ovy
metafyzických 	 meta-fyz-ic-k-ý-ch 	 meta-fyz-ic-k-ých
metafyziku 	 meta-fyz-ik-u 	 metafyzik-u
metodologicky 	 metodo-log-ic-k-y 	 metodo-log-icky
mezitím 	 mezi-t-ím 	 mezit-ím
meziříčí 	 mezi-říč-í 	 meziř-íč-í
mečení 	 meč-e-n-í 	 mečen-í
mikroorganismy 	 mikro-organ-ism-y 	 mikroorganismy
miliarda 	 miliard-a 	 miliarda
milionů 	 mili-on-ů 	 milion-ů
milo 	 mil-o 	 milo
milostpane 	 mil-ost-pan-e 	 milostpane
milování 	 mil-ová-n-í 	 mil-ován-í
mimoškolními 	 mimo-škol-n-ími 	 mimoškoln-ími
minerální 	 minerál-n-í 	 minerál-ní
minimem 	 minim-em 	 minimem
minimum 	 minim-um 	 minimum
ministerstva 	 minister-stv-a 	 ministerstva
ministři 	 ministř-i 	 ministři
minulý 	 min-ul-ý 	 minu-l-ý
mj 	 m-j 	 mj
mjasisčev 	 mjasisčev 	 mjas-isčev
mladého 	 mlad-é-ho 	 mlad-ého
mlhy 	 mlh-y 	 mlhy
mluvila 	 mluv-i-l-a 	 mluv-il-a
mlýna 	 ml-ýn-a 	 mlýn-a
mlčeli 	 mlč-e-l-i 	 mlče-l-i
mocná 	 moc-n-á 	 mocn-á
model 	 model 	 mode-l
moderního 	 modern-í-ho 	 modern-ího
mohutnět 	 moh-ut-n-ě-t 	 mohutn-ě-t
moje 	 moj-e 	 moje
mokro 	 mok-r-o 	 mokr-o
monopol 	 mono-pol 	 monopol
monopolu 	 mon-o-pol-u 	 monopol-u
morseovka 	 morse-ov-k-a 	 morseovk-a
motivací 	 motiv-ac-í 	 motivac-í
motorlet 	 motor-let 	 motorl-e-t
motorletu 	 motor-let-u 	 motorlet-u
možnostech 	 možn-ost-ech 	 mož-nost-ech
mrcho 	 mrch-o 	 mrcho
mrtvé 	 mr-tv-é 	 mrtv-é
musela 	 mus-e-l-a 	 musel-a
muselo 	 mus-e-l-o 	 musel-o
mučírna 	 muč-írn-a 	 mučírn-a
mužského 	 muž-sk-é-ho 	 muž-sk-ého
mužství 	 muž-stv-í 	 mužstv-í
mylná 	 myl-n-á 	 myln-á
mysleli 	 mysl-e-l-i 	 mysl-el-i
myslím 	 mysl-í-m 	 mysl-ím
mávne 	 máv-n-e 	 mávn-e
míli 	 míl-i 	 míli
míním 	 mín-í-m 	 míní-m
míra 	 mír-a 	 míra
míře 	 míř-e 	 míře
mířit 	 míř-i-t 	 míři-t
mých 	 m-ý-ch 	 mých
měli 	 mě-l-i 	 měli
měněn 	 měn-ěn 	 měněn
měřítka 	 měř-í-tk-a 	 měřítk-a
měřítku 	 měř-í-tk-u 	 měřítk-u
mřížovec 	 mříž-ov-ec 	 mříž-ovec
nabitý 	 na-bi-t-ý 	 na-bit-ý
nabyl 	 na-by-l 	 na-byl
nabytí 	 na-by-t-í 	 na-byt-í
nabídkových 	 na-bíd-k-ov-ých 	 na-bíd-k-ových
nachlemtat 	 na-chlemt-a-t 	 na-chlemta-t
nachomýtnout 	 na-chomýt-nou-t 	 nachomýt-nou-t
nacpávat 	 na-cp-á-v-a-t 	 na-cpá-v-a-t
nadbíhat 	 nad-bíh-a-t 	 nadbíh-a-t
nadcházející 	 nad-cház-ej-íc-í 	 nadcház-ej-íc-í
nadindividuálního 	 nad-in-divid-u-ál-n-í-ho 	 nadind-ividuáln-ího
nadklánět 	 nad-klán-ě-t 	 nadklán-ět
nadpočetné 	 nad-po-čet-n-é 	 nadpočetn-é
nadčlověctví 	 nad-člověc-tv-í 	 nadčl-ověctv-í
nadějemi 	 na-děj-e-m-i 	 na-děj-emi
nadřaděného 	 nad-řad-ěn-é-ho 	 nadřad-ěn-ého
nadšení 	 na-dš-en-í 	 nadš-en-í
nadšením 	 na-dš-en-í-m 	 nadš-en-ím
najatí 	 na-j-a-t-í 	 na-jat-í
nakolkovat 	 na-kol-k-ova-t 	 na-kolk-ova-t
namasírovat 	 na-mas-ír-ova-t 	 na-masír-ova-t
namlouvat 	 na-mlouv-a-t 	 na-mlouva-t
namésti 	 na-mést-i 	 na-més-ti
napočítal 	 na-po-čít-a-l 	 na-po-čít-al
naprosto 	 na-prost-o 	 na-prosto
narážím 	 na-ráž-í-m 	 na-ráž-ím
nasbíral 	 na-s-bír-a-l 	 na-sbír-a-l
naskicovat 	 na-skic-ova-t 	 naskic-ova-t
nasnídat 	 na-s-níd-a-t 	 na-sníd-a-t
navagónovávatelnost 	 na-vagón-ová-v-a-teln-ost 	 na-vagón-ová-v-a-telnost
naveskrz 	 na-ve-skrz 	 naveskrz
navyprávět 	 na-vy-práv-ě-t 	 na-vy-pr-ávě-t
navát 	 na-vá-t 	 navá-t
načal 	 na-č-a-l 	 nača-l
nařezávat 	 na-řez-á-v-a-t 	 na-řez-ávat
naškrábnout 	 na-škráb-nou-t 	 naškráb-nou-t
naštvat 	 na-štv-a-t 	 naštva-t
neboj 	 ne-boj 	 neboj
nebrat 	 ne-br-a-t 	 nebr-a-t
nebrání 	 ne-brán-í 	 nebrán-í
nebyl 	 ne-by-l 	 neby-l
nechtěj 	 ne-cht-ě-j 	 necht-ěj
nechuť 	 ne-chuť 	 nechuť
nechybí 	 ne-chyb-í 	 nechyb-í
nechává 	 nech-á-v-á 	 necháv-á
nedaleko 	 ne-dal-ek-o 	 ne-dal-eko
nedat 	 ne-d-a-t 	 neda-t
nedaří 	 ne-dař-í 	 nedař-í
nedefinovatelné 	 ne-de-fin-ova-teln-é 	 nede-fin-ova-teln-é
nedoceňuje 	 ne-do-ceň-uje 	 ne-doceň-uje
nedutnout 	 ne-dut-nou-t 	 nedut-nou-t
nedávají 	 ne-d-á-v-aj-í 	 nedáv-aj-í
neexistovalo 	 ne-exist-ova-l-o 	 neexist-ova-l-o
negativními 	 negat-iv-n-ími 	 negativ-ními
nehmotného 	 ne-hmot-n-ého 	 nehmot-n-ého
nehodlám 	 ne-hodl-á-m 	 ne-hodl-ám
neinkasoval 	 ne-in-kas-ova-l 	 neinkas-ova-l
nejaktivnější 	 nej-akt-iv-n-ějš-í 	 nejak-tiv-n-ěj-š-í
nejcitlivějším 	 nej-cit-liv-ějš-ím 	 nej-cit-l-iv-ějš-ím
nejdivočejší 	 nej-div-oč-ej-š-í 	 nejdiv-oč-ejš-í
nejdříve 	 nej-dřív-e 	 nejdříve
nejkrásnějších 	 nej-krás-n-ěj-š-í-ch 	 nej-krás-nějš-ích
nejlahodnější 	 nej-lahod-n-ěj-š-í 	 nejla-hod-n-ěj-š-í
nejlíp 	 nej-líp 	 nejlíp
nejmenší 	 nej-men-š-í 	 nejmen-š-í
nejméně 	 nej-mén-ě 	 nejmén-ě
nejpalčivější 	 nej-pal-č-iv-ěj-š-í 	 nej-pal-čiv-ěj-š-í
nejpovolanějšímu 	 nej-po-vol-a-n-ějš-ímu 	 nej-pov-olan-ějšímu
nejprve 	 nej-prv-e 	 nejprv-e
nejsladšího 	 nej-slad-š-í-ho 	 nejslad-šího
nejsladším 	 nej-slad-š-í-m 	 nejslad-ším
nejvzdálenější 	 nej-vz-dál-e-n-ěj-š-í 	 nej-vzdálen-ější
nejvzácnější 	 nej-vzácn-ějš-í 	 nejvzácnějš-í
nejzřetelněji 	 nej-zř-e-tel-n-ěji 	 nejzř-e-tel-n-ěji
nejčastějších 	 nej-čast-ěj-š-í-ch 	 nej-čast-ěj-š-ích
nejžha 	 nej-žh-a 	 nejžh-a
nekompetentní 	 ne-kompet-ent-n-í 	 ne-kompetentní
nekrytý 	 ne-kry-t-ý 	 ne-kryt-ý
nekvete 	 ne-kvet-e 	 ne-kve-te
nelegální 	 ne-leg-ál-n-í 	 nelegál-n-í
nelidské 	 ne-lid-sk-é 	 nelid-sk-é
nemluvně 	 ne-mluv-n-ě 	 nemluv-n-ě
nemocenského 	 ne-moc-en-sk-ého 	 nemoc-en-sk-ého
neměly 	 ne-m-ě-l-y 	 neměl-y
nemůže 	 ne-můž-e 	 nemůž-e
nenahradí 	 ne-na-hrad-í 	 nena-hrad-í
nenamaže 	 ne-na-maž-e 	 ne-namaže
nenech 	 ne-nech 	 nenech
neobtížím 	 ne-ob-tíž-í-m 	 neobtíž-ím
neodpovídající 	 ne-od-po-víd-aj-íc-í 	 neod-po-víd-aj-ící
neodpovídala 	 ne-od-po-víd-a-l-a 	 neod-po-víd-ala
neodvažujeme 	 ne-od-važ-uje-me 	 neodvaž-ujeme
neohrabané 	 ne-o-hrab-a-n-é 	 neohraban-é
nepobíral 	 ne-po-bír-a-l 	 nepo-bír-al
nepodaří 	 ne-po-dař-í 	 nepod-ař-í
nepodnikl 	 ne-pod-nik-l 	 ne-pod-n-ikl
nepohnutě 	 ne-po-h-nu-t-ě 	 ne-pohnutě
nepohodnout 	 ne-po-hod-nou-t 	 ne-po-hod-nout
nepolemizujme 	 ne-polem-iz-uj-me 	 ne-polemiz-ujme
nepolepší 	 ne-po-lep-š-í 	 ne-polepš-í
nepomohou 	 ne-po-moh-ou 	 ne-pomohou
neposkytnul 	 ne-po-skyt-nu-l 	 ne-poskytnul
nepotápí 	 ne-po-táp-í 	 nepotáp-í
nepotřebujete 	 ne-po-třeb-u-j-e-te 	 ne-po-třebuje-te
nepravdivých 	 ne-prav-d-iv-ých 	 ne-prav-div-ých
neprodejným 	 ne-pro-dej-n-ým 	 ne-prodejn-ým
neprodělá 	 ne-pro-děl-á 	 ne-prod-ěl-á
neprokáže 	 ne-pro-káž-e 	 neprokáže
nepředepisují 	 ne-přede-pis-uj-í 	 ne-před-episují
nepředpokládám 	 ne-před-po-klád-á-m 	 ne-před-pokl-ádám
nepřehlédněte 	 ne-pře-hléd-n-ě-te 	 ne-přeh-léd-n-ěte
nepřesných 	 ne-přesn-ých 	 ne-přes-n-ých
nepřidává 	 ne-při-d-á-v-á 	 ne-přid-áv-á
nepřijdou 	 ne-při-jd-ou 	 ne-přijd-ou
nepřikážu 	 ne-při-káž-u 	 nepřik-ážu
nepřipraví 	 ne-při-prav-í 	 ne-připrav-í
nepřišla 	 ne-při-š-l-a 	 ne-přiš-l-a
nepříjemná 	 ne-pří-jem-n-á 	 ne-pří-jemn-á
nereálný 	 ne-reál-n-ý 	 nereál-n-ý
nerozlišuje 	 ne-roz-liš-uje 	 ne-rozliš-uje
nerušili 	 ne-ruš-i-l-i 	 neruš-i-l-i
nervóznět 	 nerv-óz-n-ě-t 	 nervózn-ě-t
nesena 	 nes-en-a 	 nesen-a
nesesedl 	 ne-se-sed-l 	 nesesedl
neshoří 	 ne-s-hoř-í 	 neshoř-í
neskromně 	 ne-s-krom-n-ě 	 neskrom-n-ě
nesmírná 	 ne-s-mír-n-á 	 nesmír-n-á
nesnesitelna 	 ne-s-nes-i-teln-a 	 ne-snes-i-telna
nesprávné 	 ne-s-práv-n-é 	 nespráv-n-é
netušícího 	 ne-tuš-íc-ího 	 netuš-íc-ího
neudělal 	 ne-u-děl-a-l 	 ne-uděl-a-l
neukáže 	 ne-u-káž-e 	 neukáž-e
neumožňuje 	 ne-u-možň-uje 	 neumož-ň-uje
neumí 	 ne-um-í 	 neum-í
neuměla 	 ne-um-ě-l-a 	 ne-umě-l-a
neupije 	 ne-u-pi-je 	 neupije
neuteče 	 ne-u-teč-e 	 neuteč-e
neuznává 	 ne-u-zn-á-v-á 	 neuzn-áv-á
nevhodnost 	 ne-v-hod-n-ost 	 nevhod-n-ost
nevinen 	 ne-vin-en 	 nevin-en
nevrley 	 nevrley 	 nevrle-y
nevyhnutelné 	 ne-vy-h-nu-teln-é 	 ne-vy-hn-u-telné
nevyskytly 	 ne-vy-skyt-l-y 	 ne-vyskytl-y
nevysvětlíš 	 ne-vy-svět-l-í-š 	 ne-vy-světl-íš
nevyznám 	 ne-vy-zn-á-m 	 ne-vy-zn-ám
nezahořeli 	 ne-za-hoř-e-l-i 	 ne-za-hořel-i
nezaměstnanosti 	 ne-za-měst-n-an-ost-i 	 ne-za-městn-an-osti
nezaoblená 	 ne-za-obl-en-á 	 neza-oblen-á
nezapsané 	 ne-za-ps-a-n-é 	 ne-za-psan-é
nezapíchnul 	 ne-za-pích-nu-l 	 ne-za-píchnul
nezavolali 	 ne-za-vol-a-l-i 	 ne-za-volal-i
nezačínej 	 ne-za-č-ín-ej 	 ne-začín-ej
nezbytné 	 ne-z-by-t-n-é 	 nez-byt-n-é
nezbytnými 	 ne-z-by-t-n-ými 	 nez-byt-n-ými
nezlob 	 ne-zlob 	 nezl-ob
neznámého 	 ne-zn-á-m-é-ho 	 ne-zn-ám-ého
neztratitelnost 	 ne-z-trat-i-tel-n-ost 	 nez-trat-i-telnost
nezávislý 	 ne-zá-vis-l-ý 	 ne-zá-visl-ý
neúplných 	 ne-ú-pln-ých 	 neúpln-ých
nečervená 	 ne-červen-á 	 nečerv-en-á
neříkejte 	 ne-řík-ej-te 	 ne-říkej-te
neškodné 	 ne-škod-n-é 	 neškod-n-é
neštěstí 	 ne-štěst-í 	 neštěst-í
nijetzscheovi 	 nijetzsche-ovi 	 nijetzscheovi
nimiž 	 n-imi-ž 	 nimiž
nitěných 	 nit-ěn-ý-ch 	 nitěn-ých
nocovávající 	 noc-ová-v-aj-íc-í 	 nocová-v-aj-íc-í
noetika 	 noet-ik-a 	 noetik-a
nohou 	 noh-ou 	 nohou
norbert 	 norbert 	 norber-t
nosatá 	 nos-at-á 	 nosat-á
nosaté 	 nos-at-é 	 nosat-é
nosem 	 nos-e-m 	 nosem
novinám 	 nov-in-á-m 	 novin-ám
novými 	 nov-ými 	 novými
nula 	 nul-a 	 nula
nuly 	 nul-y 	 nuly
nutným 	 nut-n-ým 	 nutn-ým
nymburka 	 nymburk-a 	 nymbur-k-a
náborové 	 ná-bor-ov-é 	 ná-bor-ové
nábytek 	 ná-by-tek 	 ná-bytek
náramného 	 ná-ram-n-é-ho 	 ná-ram-n-ého
nás 	 n-á-s 	 ná-s
následujících 	 ná-sled-uj-íc-ích 	 ná-sled-ujíc-ích
návštěvnost 	 návštěv-n-ost 	 návštěvnost
návštěvnosti 	 návštěv-n-ost-i 	 návštěvn-ost-i
nítit 	 nít-i-t 	 níti-t
ně 	 n-ě 	 ně
nějakém 	 ně-jak-é-m 	 nějak-ém
nějakými 	 ně-jak-ými 	 nějak-ými
někde 	 ně-kd-e 	 někde
něm 	 n-ě-m 	 něm
německý 	 něm-ec-k-ý 	 německ-ý
němé 	 něm-é 	 němé
oba 	 ob-a 	 oba
obal 	 o-bal 	 obal
obalu 	 o-bal-u 	 obal-u
obchod 	 ob-chod 	 obchod
obci 	 obc-i 	 ob-ci
obcích 	 obc-ích 	 ob-cích
obemknout 	 obe-mk-nou-t 	 obemk-nou-t
obepnout 	 obe-pn-ou-t 	 obe-pnou-t
obetkat 	 obe-tk-a-t 	 obetk-a-t
obeznámit 	 obe-znám-i-t 	 obeznámi-t
objektem 	 ob-jekt-e-m 	 ob-jekt-em
oblastech 	 oblast-ech 	 ob-last-ech
oblažit 	 o-blaž-i-t 	 ob-laž-i-t
obnitkovat 	 ob-nit-k-ova-t 	 ob-nitk-ova-t
obor 	 o-bor 	 obor
oborat 	 ob-or-a-t 	 obor-a-t
obouvatelný 	 ob-ouv-a-teln-ý 	 obouva-telný
obrali 	 o-br-a-l-i 	 obral-i
obrat 	 o-br-a-t 	 obra-t
obrátek 	 ob-rát-ek 	 obrátek
obtěžkávat 	 ob-těž-k-á-v-a-t 	 ob-těžk-á-va-t
obydlet 	 o-bydl-e-t 	 obydle-t
obzvlášť 	 ob-zvlášť 	 obzvlášť
občanského 	 obč-an-sk-ého 	 ob-čan-sk-ého
ocejchovat 	 o-cejch-ova-t 	 ocejch-ova-t
ocejchovávací 	 o-cejch-ová-v-a-c-í 	 ocej-ch-ová-v-a-c-í
ocenzurovávanost 	 o-cenzur-ová-v-a-n-ost 	 ocenzur-ová-v-anost
ochotna 	 ochot-n-a 	 ochotn-a
ochrannému 	 o-chran-n-ému 	 o-chran-nému
ochraně 	 o-chran-ě 	 o-chr-an-ě
octovat 	 oct-ova-t 	 octova-t
odbelhávat 	 od-belh-á-v-a-t 	 od-belh-á-va-t
odbytové 	 od-by-t-ov-é 	 od-byt-ov-é
odběratelem 	 od-běr-a-tel-em 	 od-běr-a-telem
oddanosti 	 od-d-a-n-ost-i 	 od-dan-osti
oddat 	 od-d-a-t 	 odda-t
oddati 	 od-d-a-ti 	 od-da-t-i
oddávat 	 od-d-á-v-a-t 	 od-dáv-a-t
odehnat 	 ode-hn-a-t 	 odehn-a-t
odehrávají 	 ode-hrá-v-aj-í 	 ode-hráv-aj-í
odepřela 	 ode-př-e-l-a 	 ode-pře-l-a
odervat 	 ode-rv-a-t 	 ode-rva-t
odeslaném 	 ode-sl-a-n-ém 	 ode-sla-n-ém
odevzdám 	 ode-vz-d-á-m 	 ode-vzd-ám
odevšad 	 ode-vš-ad 	 ode-všad
odečte 	 ode-čt-e 	 ode-č-te
odečtení 	 ode-čt-en-í 	 ode-čten-í
odečtou 	 ode-čt-ou 	 odečt-ou
odloupávat 	 od-loup-á-v-a-t 	 od-loup-á-va-t
odmésti 	 od-mést-i 	 od-més-ti
odměňujeme 	 od-měň-uje-me 	 od-měň-ujeme
odpluje 	 od-plu-je 	 od-pluje
odpomoci 	 od-po-moc-i 	 od-pomoc-i
odpověď 	 od-po-věď 	 od-pověď
odsoudcovat 	 od-soud-c-ova-t 	 od-soudc-ova-t
odsouvací 	 od-souv-a-c-í 	 od-souv-ac-í
odstrkávat 	 od-strk-á-v-a-t 	 od-strk-á-va-t
oduševnit 	 o-duš-ev-n-i-t 	 oduševn-i-t
odvažuješ 	 od-važ-uje-š 	 od-važ-uješ
odřít 	 o-dř-í-t 	 odří-t
ohlodat 	 o-hlod-a-t 	 o-hloda-t
ohořelému 	 o-hoř-e-l-é-mu 	 ohoř-el-ému
ohromně 	 o-hrom-n-ě 	 ohromn-ě
ohřebelcovat 	 o-hřeb-el-c-ova-t 	 ohřebelc-ova-t
okamžitě 	 ok-a-mžit-ě 	 okamžit-ě
okartáčovat 	 o-kartáč-ova-t 	 okartáč-ova-t
okounět 	 okoun-ě-t 	 o-koun-ě-t
okozlit 	 o-koz-l-i-t 	 o-kozl-i-t
okrajovým 	 o-kraj-ov-ým 	 okraj-ovým
okrádal 	 o-krád-a-l 	 okrád-a-l
oloupil 	 o-loup-i-l 	 oloup-i-l
olšanech 	 olšan-e-ch 	 olšan-ech
omdlívat 	 o-mdl-í-v-a-t 	 o-mdl-ív-a-t
omlouval 	 o-mlouv-a-l 	 o-mlouv-al
omítce 	 o-mít-c-e 	 omít-c-e
omžít 	 o-mž-í-t 	 omží-t
onen 	 on-en 	 onen
opatrností 	 o-patr-n-ost-í 	 opatrn-ost-í
opatrný 	 o-patr-n-ý 	 opatrn-ý
opačném 	 o-pač-n-é-m 	 opač-n-ém
opelichat 	 o-pelich-a-t 	 opelich-a-t
oplodňovat 	 o-plod-ň-ova-t 	 o-plodň-ova-t
opláknout 	 o-plák-nou-t 	 oplák-nou-t
oplésti 	 o-plést-i 	 oplésti
opotřebovat 	 o-po-třeb-ova-t 	 opotřeb-ova-t
opouští 	 o-pouš-t-í 	 o-poušt-í
opouštěl 	 o-poušt-ě-l 	 o-poušt-ěl
opovažuješ 	 o-po-važ-u-j-e-š 	 o-považ-uješ
oranžista 	 oranž-ist-a 	 oranžist-a
orazítkovat 	 o-raz-í-tk-ova-t 	 orazít-k-ova-t
orchestrem 	 orchestr-e-m 	 orchestrem
organizují 	 organ-iz-u-j-í 	 organiz-uj-í
orlik 	 orl-ik 	 orlik
oroubovat 	 o-roub-ova-t 	 oroub-ova-t
osednout 	 o-sed-nou-t 	 osed-nou-t
osekat 	 o-sek-a-t 	 osek-a-t
oslepit 	 o-slep-i-t 	 oslep-i-t
oslintat 	 o-slint-a-t 	 oslint-a-t
osmitisícový 	 osm-i-tisíc-ov-ý 	 osmitisícový
osmnácté 	 osm-náct-é 	 osmnáct-é
osmou 	 osm-ou 	 osmou
osobu 	 o-sob-u 	 osob-u
ospalost 	 o-sp-a-l-ost 	 ospal-ost
ostatních 	 o-stat-n-í-ch 	 ostatn-ích
ostrouhat 	 o-strouh-a-t 	 ostrouh-a-t
osudem 	 o-sud-e-m 	 osud-em
osušovanost 	 o-suš-ova-n-ost 	 o-suš-ovanost
osvobození 	 o-svoboz-en-í 	 o-svobozen-í
osvědčují 	 o-s-věd-č-u-j-í 	 osvědč-ují
otevřel 	 ote-vř-e-l 	 ote-vře-l
otevřena 	 ote-vř-en-a 	 ote-vřena
otevřít 	 ote-vř-í-t 	 ote-vří-t
otravovat 	 o-trav-ova-t 	 otrav-ova-t
otvírá 	 ot-vír-á 	 otvír-á
otěhotnět 	 o-těhot-n-ě-t 	 o-těhot-n-ět
ovládnout 	 o-vlád-nou-t 	 ovlád-nou-t
ovládání 	 o-vlád-á-n-í 	 ovlád-á-n-í
ovít 	 o-ví-t 	 ovít
ověnčil 	 o-věn-č-i-l 	 ověnč-i-l
ověřit 	 o-věř-i-t 	 ověř-i-t
oxfordského 	 oxford-sk-é-ho 	 oxford-sk-ého
ozdobovat 	 o-z-dob-ova-t 	 ozdob-ova-t
oznobovat 	 o-znob-ova-t 	 oznob-ova-t
ozvalo 	 o-zv-a-l-o 	 ozval-o
ozřejmit 	 o-zřejm-i-t 	 ozřejm-i-t
očekávají 	 o-ček-á-v-aj-í 	 oček-áv-aj-í
očenichat 	 o-čenich-a-t 	 očenich-a-t
očima 	 oč-ima 	 očim-a
očí 	 oč-í 	 očí
očíslit 	 o-čísl-i-t 	 očísl-i-t
očíslovat 	 o-čísl-ova-t 	 očísl-ova-t
ošukat 	 ošuk-a-t 	 o-šuk-a-t
ošvindlovat 	 o-švindl-ova-t 	 o-švindlova-t
ošívat 	 o-ší-v-a-t 	 o-šív-a-t
paběrkovat 	 pa-běr-k-ova-t 	 paběrk-ova-t
pacientovi 	 pac-i-ent-ovi 	 pacient-ovi
padesát 	 pa-desát 	 padesá-t
padesátku 	 pade-sát-k-u 	 padesátk-u
padly 	 pad-l-y 	 padl-y
pageův 	 page-ův 	 pageův
palba 	 pal-b-a 	 palb-a
panenka 	 pan-en-k-a 	 panenk-a
paničko 	 pan-ič-k-o 	 paničk-o
panoval 	 pan-ova-l 	 pan-oval
panáček 	 pan-áč-ek 	 panáč-ek
papouškovat 	 papouš-k-ova-t 	 papoušk-ova-t
parasoudně 	 para-soud-n-ě 	 paras-oud-n-ě
patroni 	 patr-on-i 	 patron-i
pavlačí 	 pavlač-í 	 pavl-ač-í
pavouček 	 pavouč-ek 	 pavouček
pekárenských 	 pek-ár-en-sk-ých 	 pekáren-sk-ých
perfektně 	 per-fekt-n-ě 	 perfektn-ě
perunovy 	 perun-ov-y 	 perun-ovy
perutková 	 perut-k-ov-á 	 perutk-ová
petrolejově 	 petrolej-ov-ě 	 petrol-ejově
petynce 	 pety-n-c-e 	 petync-e
pečiva 	 peč-iv-a 	 pečiv-a
pečivo 	 peč-iv-o 	 pečiv-o
peřině 	 peř-in-ě 	 peřin-ě
pf 	 p-f 	 pf
pfeffermann 	 pfeffer-mann 	 pfeffermann
pil 	 pi-l 	 pil
pilují 	 pil-u-j-í 	 piluj-í
pisklavě 	 pisk-l-av-ě 	 pisklav-ě
pitomej 	 pitom-ej 	 pitomej
plakáty 	 plakát-y 	 plak-át-y
planul 	 plan-u-l 	 planu-l
platba 	 plat-b-a 	 platb-a
plačící 	 plač-í-c-í 	 plač-íc-í
pleteného 	 plet-en-é-ho 	 plet-en-ého
plivám 	 pliv-á-m 	 pliv-ám
plnohodnotné 	 pln-o-hod-n-ot-n-é 	 plno-hod-not-n-é
plnou 	 pln-ou 	 plnou
plnění 	 pln-ěn-í 	 plněn-í
plodem 	 plod-e-m 	 plod-em
plují 	 plu-j-í 	 pluj-í
plukovník 	 pluk-ov-n-ík 	 pluk-ov-ník
plutokratismus 	 plut-o-krat-ism-us 	 pluto-krat-ismus
plynulé 	 ply-nu-l-é 	 plynul-é
plátcem 	 plát-c-em 	 plátc-em
pobočkové 	 po-boč-k-ov-é 	 po-boč-k-ové
pobožnější 	 po-bož-n-ěj-š-í 	 po-bož-n-ějš-í
pobírali 	 po-bír-a-l-i 	 po-bír-al-i
pochutnal 	 po-chut-n-a-l 	 po-chut-nal
pochutnatelný 	 po-chut-n-a-teln-ý 	 po-chut-n-a-telný
pochválena 	 po-chvál-en-a 	 pochvál-en-a
pochytávat 	 po-chyt-á-v-a-t 	 po-chyt-á-va-t
pocházím 	 po-cház-í-m 	 po-cház-ím
podařilo 	 po-dař-i-l-o 	 podař-i-l-o
podaří 	 po-dař-í 	 pod-ař-í
podepsat 	 pode-ps-a-t 	 podeps-a-t
podhrnout 	 pod-hrn-ou-t 	 podhr-nou-t
podivila 	 po-div-i-l-a 	 podiv-i-l-a
podivně 	 po-div-n-ě 	 podivn-ě
podivuhodné 	 po-div-u-hod-n-é 	 po-divu-hod-n-é
podlitina 	 pod-li-t-in-a 	 podlit-ina
podmíněny 	 pod-mín-ěn-y 	 podmín-ěn-y
podnikatelskou 	 pod-nik-a-tel-sk-ou 	 pod-nik-atel-skou
podnikám 	 pod-nik-á-m 	 pod-nik-ám
podobalo 	 po-dob-a-l-o 	 podob-a-l-o
podobného 	 po-dob-n-é-ho 	 po-dob-n-ého
podobě 	 po-dob-ě 	 podob-ě
podotkl 	 po-do-tk-l 	 podotk-l
podružstevnit 	 po-druž-stev-n-i-t 	 podruž-stevn-i-t
podráždění 	 po-drážd-ěn-í 	 podrážděn-í
podtít 	 pod-t-í-t 	 podtí-t
podupovat 	 po-dup-ova-t 	 podupovat
podupávat 	 po-dup-á-v-a-t 	 podupá-v-a-t
podvésti 	 pod-vést-i 	 pod-vés-ti
podělí 	 po-děl-í 	 poděl-í
podřazovat 	 pod-řaz-ova-t 	 podřaz-ova-t
podřeknout 	 pod-řek-nou-t 	 podřek-nou-t
pohaněné 	 po-han-ě-n-é 	 po-han-ěn-é
pohlíželo 	 po-hlíž-e-l-o 	 po-hlíž-e-lo
pohnuly 	 po-h-nu-l-y 	 po-hnu-l-y
pohnutlivé 	 po-h-nu-t-l-i-v-é 	 pohnut-liv-é
pohotovějším 	 po-hotov-ějš-ím 	 pohotověj-š-ím
pojaty 	 po-j-a-t-y 	 pojat-y
pojísti 	 po-jíst-i 	 po-jís-ti
pokročilejším 	 po-kroč-i-l-ejš-ím 	 po-kroč-il-ejš-ím
pokývat 	 po-kýv-a-t 	 po-kýva-t
politických 	 polit-ic-k-ý-ch 	 polit-ick-ých
polska 	 pol-sk-a 	 polsk-a
polská 	 pol-sk-á 	 polsk-á
polských 	 pol-sk-ých 	 polsk-ých
polyvalence 	 poly-valenc-e 	 polyvalenc-e
polít 	 po-lí-t 	 polí-t
pomatený 	 po-mat-en-ý 	 pomat-en-ý
pomlaskávat 	 po-mlask-á-v-a-t 	 po-mlask-áv-a-t
pomáhám 	 po-máh-á-m 	 po-máh-ám
poměrem 	 po-měr-e-m 	 po-měr-em
pomůcek 	 po-můc-ek 	 pomůcek
poobědvat 	 po-oběd-v-a-t 	 poobědva-t
pooddychnout 	 po-od-dych-nou-t 	 pood-dychnou-t
poodhalit 	 po-od-hal-i-t 	 poodhal-i-t
popelnic 	 po-pel-nic 	 popeln-ic
popkultura 	 pop-kult-ur-a 	 popkultura
poplatník 	 po-plat-ník 	 po-plat-n-ík
popoběhnout 	 po-po-běh-nou-t 	 po-po-běh-nout
poproduktivní 	 po-pro-duk-t-iv-n-í 	 po-prod-uktivní
poptat 	 po-pt-a-t 	 popt-a-t
poptávky 	 po-pt-á-v-k-y 	 poptáv-k-y
poradců 	 po-rad-c-ů 	 po-radc-ů
porculánu 	 porculán-u 	 porcul-án-u
porovnání 	 po-rovn-ání 	 porovn-án-í
porozhlédnout 	 po-roz-hléd-nou-t 	 po-rozhléd-nout
porubat 	 po-rub-a-t 	 porub-a-t
porůsti 	 po-růst-i 	 po-růs-ti
posily 	 po-sil-y 	 po-si-l-y
poskočit 	 po-skoč-i-t 	 poskoč-i-t
poskytují 	 po-skyt-uj-í 	 poskyt-uj-í
poslouchej 	 po-slouch-ej 	 poslouchej
posluchače 	 po-sluch-a-č-e 	 po-sluch-ač-e
posluchačů 	 po-sluch-a-č-ů 	 po-sluchač-ů
posmyknout 	 po-s-myk-nou-t 	 po-smyk-nou-t
postačit 	 po-stač-i-t 	 postač-i-t
postih 	 po-stih 	 postih
postrádám 	 po-strád-á-m 	 postrád-ám
postup 	 po-stup 	 postup
postupně 	 po-stup-n-ě 	 postup-n-ě
postupů 	 po-stup-ů 	 postup-ů
postávalo 	 po-stá-v-a-l-o 	 po-stáv-a-l-o
postýlky 	 po-stýl-k-y 	 postýl-k-y
postříknout 	 po-střík-nou-t 	 postřík-nou-t
posuzování 	 po-suz-ová-n-í 	 po-suz-ován-í
potit 	 pot-i-t 	 poti-t
potká 	 po-tk-á 	 potk-á
potkáme 	 po-tk-á-me 	 potk-á-me
potkáte 	 po-tk-á-te 	 potk-á-te
potravin 	 po-trav-in 	 potrav-in
potraviny 	 po-trav-in-y 	 potrav-iny
potrefený 	 po-tref-en-ý 	 potref-en-ý
potud 	 po-t-ud 	 potud
potulují 	 po-tul-uj-í 	 potul-uj-í
potvrdili 	 po-tvrd-i-l-i 	 po-tvrd-il-i
potěžkat 	 po-těž-k-a-t 	 po-těžk-a-t
pouhém 	 pouh-é-m 	 pouh-ém
poupátko 	 poup-át-k-o 	 poupát-k-o
poučit 	 po-uč-i-t 	 pouč-i-t
použije 	 po-u-ži-je 	 použije
použito 	 po-u-ži-t-o 	 použito
považovány 	 po-važ-ová-n-y 	 po-važ-ován-y
povinny 	 po-vin-n-y 	 po-vinn-y
povolaný 	 po-vol-an-ý 	 po-vol-a-n-ý
povyrůsti 	 po-vy-růst-i 	 povyrůsti
povyskakovat 	 po-vy-skak-ova-t 	 po-vyskak-ova-t
povzbudivé 	 po-vz-bud-i-v-é 	 povz-budiv-é
povzbuzení 	 po-vz-buz-en-í 	 povz-buzen-í
povzdychnout 	 po-vz-dych-nou-t 	 povz-dychnou-t
povznáší 	 po-vz-náš-í 	 povzn-áš-í
povšimli 	 po-všim-l-i 	 povšiml-i
pozamykat 	 po-za-myk-a-t 	 po-zamyk-a-t
pozdní 	 pozd-n-í 	 pozdn-í
pozitivně 	 pozit-iv-n-ě 	 pozitiv-n-ě
pozměňovat 	 po-z-měň-ova-t 	 po-změň-ova-t
poznatku 	 po-zn-a-t-k-u 	 po-znat-k-u
poztrácet 	 po-z-trác-e-t 	 poztrác-et
početí 	 po-č-e-t-í 	 po-čet-í
počkal 	 po-čk-a-l 	 počk-a-l
počkej 	 po-čk-ej 	 počk-ej
počkám 	 po-čk-á-m 	 počk-ám
počnu 	 po-č-n-u 	 počn-u
počtu 	 po-čt-u 	 počt-u
pořadatele 	 po-řad-a-tel-e 	 po-řad-a-tele
pořadatelů 	 po-řad-a-tel-ů 	 po-řada-tel-ů
poškozovat 	 po-škoz-ova-t 	 poškoz-ova-t
pošla 	 po-š-l-a 	 pošl-a
pošlapávat 	 po-šlap-á-v-a-t 	 po-šlap-á-va-t
pošle 	 po-šl-e 	 pošl-e
pošlete 	 po-šl-e-te 	 pošl-e-te
pošlu 	 po-šl-u 	 pošl-u
poštípat 	 po-štíp-a-t 	 poštíp-a-t
pragmatism 	 pragm-at-ism 	 pragmat-ism
pragmatismus 	 pragm-at-ism-us 	 pragmat-ism-us
pragokoncertu 	 prag-o-koncert-u 	 pragokoncertu
praktickým 	 prakt-ic-k-ý-m 	 prakt-ick-ým
praktikantům 	 prakt-ik-ant-ům 	 praktikant-ům
pravd 	 prav-d 	 pravd
pravdy 	 prav-d-y 	 pravd-y
pravidel 	 prav-i-del 	 pravidel
prchavý 	 prch-a-v-ý 	 prch-av-ý
prejudikovat 	 pre-ju-dik-ova-t 	 prejudik-ova-t
premií 	 prem-i-í 	 premi-í
prezidentů 	 prezid-ent-ů 	 prezident-ů
princezna 	 princ-ez-n-a 	 princezna
princeznu 	 princ-ez-n-u 	 princeznu
princmetálovou 	 princ-metál-ov-ou 	 princmetál-ovou
princátky 	 princ-át-k-y 	 princátky
probudila 	 pro-bud-i-l-a 	 probud-i-l-a
probudím 	 pro-bud-í-m 	 probud-ím
procházka 	 pro-cház-k-a 	 procházk-a
prodejce 	 pro-d-ej-c-e 	 prodejc-e
prodejna 	 pro-d-ej-n-a 	 prodejn-a
prodejně 	 pro-d-ej-n-ě 	 prodej-n-ě
prodlužit 	 pro-dluž-i-t 	 prodluž-i-t
prodlužuje 	 pro-dluž-uje 	 prodluž-uje
producent 	 pro-duc-ent 	 produc-ent
produkty 	 pro-dukt-y 	 produkt-y
produktů 	 pro-dukt-ů 	 produkt-ů
produševňovat 	 pro-duš-ev-ň-ova-t 	 pro-duševň-ova-t
prodával 	 pro-d-á-v-a-l 	 prodáv-a-l
prodávaná 	 pro-d-á-v-a-n-á 	 pro-dáva-n-á
prodávaných 	 pro-d-á-v-a-n-ých 	 prodáva-n-ých
prodávám 	 pro-d-á-v-á-m 	 prodáv-á-m
prodělek 	 pro-děl-ek 	 prodělek
proděravět 	 pro-děr-av-ě-t 	 pro-děr-avě-t
profesora 	 pro-fes-or-a 	 pro-fesora
profesory 	 pro-fes-or-y 	 pro-fesory
profoukávat 	 pro-fouk-á-v-a-t 	 pro-fouk-áv-a-t
prohlásila 	 pro-hlás-i-l-a 	 pro-hlásil-a
prohlížet 	 pro-hlíž-e-t 	 prohlíž-et
prohrával 	 pro-hrá-v-a-l 	 pro-hrával
projede 	 pro-jed-e 	 pro-jede
projednáním 	 pro-jed-n-án-ím 	 pro-jednán-ím
prokazují 	 pro-kaz-uj-í 	 pro-kaz-ují
prokládkovost 	 pro-klád-k-ov-ost 	 pro-klád-kovost
proklásti 	 pro-klást-i 	 pro-klás-ti
proklímávání 	 pro-klím-á-v-á-n-í 	 pro-klím-áv-á-n-í
prokopávat 	 pro-kop-á-v-a-t 	 pro-kop-á-va-t
prokormidlovavší 	 pro-kormidl-ova-vš-í 	 pro-kormidl-ovavší
prokrindapána 	 pro-krind-a-pán-a 	 pro-krinda-pán-a
promarnit 	 pro-mar-n-i-t 	 pro-marn-i-t
promnout 	 pro-mn-ou-t 	 prom-nou-t
propagace 	 propag-ac-e 	 pro-pagace
propíchávat 	 pro-pích-á-v-a-t 	 pro-pích-áv-a-t
prosciutto 	 prosciutt-o 	 prosciutto
prosekat 	 pro-sek-a-t 	 prosek-a-t
proset 	 pro-se-t 	 prose-t
proslulá 	 pro-slu-l-á 	 proslul-á
prospěch 	 pro-spěch 	 prosp-ěch
prostorově 	 pro-stor-ov-ě 	 prostorov-ě
prostrkovat 	 pro-strk-ova-t 	 prostrk-ova-t
prostějovsko 	 prostějov-sk-o 	 prostějovsko
prostředky 	 pro-střed-k-y 	 pro-středk-y
prosířit 	 pro-síř-i-t 	 prosíř-i-t
protagorovi 	 protagor-ovi 	 protagorovi
protahuje 	 pro-tah-uje 	 protah-uje
proteplit 	 pro-tep-l-i-t 	 protepl-i-t
protiabcházský 	 proti-abcház-sk-ý 	 protiabcház-ský
protisluneční 	 proti-slun-eč-n-í 	 pro-tislun-eč-n-í
protkání 	 pro-tk-á-n-í 	 protkán-í
proto 	 pro-t-o 	 proto
protrhat 	 pro-trh-a-t 	 protrh-a-t
proužek 	 prouž-ek 	 proužek
provedeny 	 pro-ved-en-y 	 pro-ved-eny
provincií 	 provinc-i-í 	 pro-vinc-ií
provzdychat 	 pro-vz-dych-a-t 	 provzdych-a-t
prováděný 	 pro-vád-ě-n-ý 	 pro-vád-ěn-ý
prozradit 	 pro-z-rad-i-t 	 prozrad-it
pročež 	 pro-č-e-ž 	 pročež
pročpak 	 proč-pak 	 pročpak
prošel 	 pro-še-l 	 proše-l
prožívám 	 pro-ží-v-á-m 	 prožív-ám
právem 	 práv-e-m 	 práv-em
pršelo 	 prš-e-l-o 	 prš-el-o
průhledy 	 prů-hled-y 	 průhled-y
psacím 	 ps-a-c-í-m 	 psac-í-m
psali 	 ps-a-l-i 	 psal-i
psaním 	 ps-a-n-í-m 	 psan-ím
psychično 	 psych-ič-n-o 	 psych-ično
psychologistickou 	 psycho-log-ist-ic-k-ou 	 psycho-log-ist-ickou
psům 	 ps-ů-m 	 psům
ptejme 	 pt-ej-me 	 ptej-me
publicita 	 public-it-a 	 public-ita
purple 	 purple 	 purpl-e
pusinka 	 pus-in-k-a 	 pusink-a
pučálka 	 pučálk-a 	 pučál-k-a
pyšnit 	 pyš-n-i-t 	 pyšn-i-t
pzt 	 p-z-t 	 pzt
pánové 	 pán-ové 	 pánov-é
pápěrka 	 pá-pěr-k-a 	 pápěr-k-a
párkovat 	 pár-k-ova-t 	 párk-ova-t
páté 	 pát-é 	 páté
píti 	 pít-i 	 píti
pěkném 	 pěkn-é-m 	 pěkn-ém
pětikorunovou 	 pět-i-korun-ov-ou 	 pětikorunov-ou
pětistovkou 	 pět-i-st-ovk-ou 	 pětistovk-ou
pětník 	 pět-ník 	 pět-n-ík
přebásnitelně 	 pře-básn-i-teln-ě 	 pře-básn-i-telně
přechodná 	 pře-chod-n-á 	 přechod-n-á
předcházejí 	 před-cház-e-j-í 	 před-cház-ejí
předcházet 	 před-cház-e-t 	 před-cháze-t
předepsanou 	 přede-ps-a-n-ou 	 před-epsan-ou
předepíše 	 přede-píš-e 	 před-epíše
předobjednávání 	 před-ob-jedn-á-v-á-n-í 	 před-objed-náv-án-í
předpojaté 	 před-po-j-a-t-é 	 před-pojat-é
předpoklady 	 před-po-klad-y 	 před-poklady
předprodeje 	 před-pro-d-ej-e 	 před-prodeje
předrahá 	 pře-drah-á 	 předrah-á
předražit 	 pře-draž-i-t 	 předraž-i-t
předražovat 	 pře-draž-ova-t 	 předraž-ova-t
předsedům 	 před-sed-ů-m 	 před-sed-ům
předstihujícím 	 před-stih-uj-í-c-í-m 	 před-stih-ujícím
předvýrobní 	 před-vý-rob-n-í 	 před-výrob-n-í
předvědecky 	 před-věd-ec-k-y 	 před-věd-eck-y
předzpívat 	 před-zpí-v-a-t 	 před-zpí-va-t
předělati 	 pře-děl-a-ti 	 předěl-a-ti
přehazoval 	 pře-haz-ova-l 	 přehaz-ova-l
přehled 	 pře-hled 	 přehled
přehlušováno 	 pře-hluš-ová-n-o 	 přehluš-ová-n-o
přehlédl 	 pře-hléd-l 	 přehléd-l
přehnojit 	 pře-hnoj-i-t 	 přehnoj-i-t
přehrada 	 pře-hrad-a 	 přehrad-a
přehrazovat 	 pře-hraz-ova-t 	 přehraz-ova-t
přehryzovat 	 pře-hryz-ova-t 	 přehryz-ova-t
přehrát 	 pře-hrá-t 	 přehrát
přejmenovat 	 pře-jmen-ova-t 	 přejmen-ova-t
přejímce 	 pře-j-í-m-c-e 	 přejímc-e
překladatel 	 pře-klad-a-tel 	 překlad-atel
překlonit 	 pře-klon-i-t 	 překlon-i-t
překontrolovat 	 pře-kontrol-ova-t 	 překontrolovat
překontrolována 	 pře-kontrol-ová-n-a 	 překontrolována
překonávat 	 pře-kon-á-v-a-t 	 pře-kon-á-va-t
překrájet 	 pře-kráj-e-t 	 překráj-et
překrýt 	 pře-krý-t 	 překrýt
překvapen 	 pře-kvap-en 	 překvapen
překvapíme 	 pře-kvap-í-me 	 překvap-íme
přelhat 	 pře-lh-a-t 	 přelha-t
přemalovat 	 pře-mal-ova-t 	 přemal-ova-t
přemnohý 	 pře-mnoh-ý 	 přemnoh-ý
přemotávat 	 pře-mot-á-v-a-t 	 pře-mot-á-va-t
přemýšlel 	 pře-mýšl-e-l 	 pře-mýšlel
přemýšlivější 	 pře-mýšl-iv-ějš-í 	 pře-mýšl-iv-ěj-š-í
přeorientovat 	 pře-orient-ova-t 	 pře-orient-ovat
přepnout 	 pře-pn-ou-t 	 přep-nou-t
přeroubovat 	 pře-roub-ova-t 	 přeroub-ova-t
přesností 	 přesn-ost-í 	 přesnost-í
přesnější 	 přesn-ěj-š-í 	 přesnějš-í
přestanou 	 pře-sta-n-ou 	 přestan-ou
přestoupnout 	 pře-stoup-nou-t 	 přes-toup-nou-t
přesunovat 	 pře-sun-ova-t 	 přesun-ova-t
přesunuly 	 pře-su-nu-l-y 	 přesunu-l-y
přesáhl 	 pře-sáh-l 	 přesáh-l
přesáhla 	 pře-sáh-l-a 	 přesáh-l-a
přetisknout 	 pře-tisk-nou-t 	 přetisk-nou-t
přetrhnout 	 pře-trh-nou-t 	 přetrh-nou-t
přetřásat 	 pře-třás-a-t 	 přetřás-a-t
převedeny 	 pře-ved-en-y 	 převed-eny
převléknout 	 pře-vlék-nou-t 	 převlék-nou-t
převlíkat 	 pře-vlík-a-t 	 převlík-a-t
převodem 	 pře-vod-em 	 převod-em
převívat 	 pře-ví-v-a-t 	 pře-vív-a-t
přezdít 	 pře-zd-í-t 	 přezdí-t
přečin 	 pře-čin 	 přečin
přeříkávat 	 pře-řík-á-v-a-t 	 pře-řík-á-va-t
přežití 	 pře-ži-t-í 	 přežit-í
přihřívat 	 při-hří-v-a-t 	 při-hřív-a-t
přijali 	 při-j-a-l-i 	 při-jal-i
přijdu 	 při-jd-u 	 přijd-u
přijmout 	 při-j-mou-t 	 při-jmou-t
přilepšit 	 při-lep-š-i-t 	 při-lepš-i-t
přilétávat 	 při-lét-á-v-a-t 	 při-lét-á-va-t
připluje 	 při-plu-je 	 připl-uje
připochodovat 	 při-po-chod-ova-t 	 při-pochod-ovat
připodobit 	 při-po-dob-i-t 	 při-podob-i-t
připomenout 	 při-po-men-ou-t 	 při-pomenou-t
připomínky 	 při-po-mín-k-y 	 při-pomínk-y
přirovnat 	 při-rov-n-a-t 	 přirovn-a-t
přispořit 	 při-spoř-i-t 	 přispoř-i-t
přistrojit 	 při-stroj-i-t 	 při-stroji-t
přitiskne 	 při-tisk-ne 	 přitiskne
přivydělávat 	 při-vy-děl-á-v-a-t 	 při-vyděl-á-v-a-t
přiznej 	 při-zn-e-j 	 přizn-ej
přizpůsobení 	 při-z-pů-sob-en-í 	 přiz-pů-sob-en-í
přizpůsobivosti 	 při-z-pů-sob-i-v-ost-i 	 přiz-pů-sob-iv-osti
přičouditelný 	 při-čoud-i-teln-ý 	 při-čoud-i-telný
přišinout 	 při-šin-ou-t 	 přišinou-t
přání 	 přá-n-í 	 přán-í
přídavky 	 pří-d-a-v-k-y 	 přídav-k-y
příjmy 	 pří-jm-y 	 příjm-y
příkladně 	 pří-klad-n-ě 	 pří-klad-ně
příležitost 	 pří-lež-it-ost 	 přílež-itost
přímém 	 přím-é-m 	 přím-ém
přísaze 	 pří-saz-e 	 přísaze
přístupna 	 pří-stup-n-a 	 pří-stupna
přístupy 	 pří-stup-y 	 přístup-y
přístřeší 	 pří-střeš-í 	 přístřeš-í
přítomny 	 pří-t-o-m-n-y 	 přítomn-y
přítomném 	 pří-t-o-m-n-é-m 	 přítom-n-ém
přítomnými 	 pří-t-o-m-n-ý-m-i 	 pří-tomn-ými
přízemí 	 pří-zem-í 	 přízem-í
příznivý 	 pří-zn-iv-ý 	 přízn-iv-ý
příštipkovat 	 pří-štip-k-ova-t 	 příštipk-ova-t
příštího 	 příšt-í-ho 	 příšt-ího
příštím 	 příšt-ím 	 příštím
pšeničné 	 pšen-ič-n-é 	 pšenič-n-é
pšenka 	 pšen-k-a 	 pšenk-a
půdu 	 půd-u 	 půdu
půjdu 	 pů-jd-u 	 půjd-u
půlsnímkovost 	 půl-s-ním-k-ov-ost 	 půls-nímkov-ost
působí 	 pů-sob-í 	 působ-í
původ 	 pů-vod 	 původ
québec 	 québec 	 québ-ec
rachotit 	 rach-ot-i-t 	 rachot-i-t
rada 	 rad-a 	 rada
radikalizovat 	 radik-al-iz-ova-t 	 radikal-iz-ova-t
radili 	 rad-i-l-i 	 radil-i
radu 	 rad-u 	 radu
raději 	 rad-ěji 	 raděj-i
rakousku 	 rakous-k-u 	 rakousk-u
rallye 	 rallye 	 rall-ye
rameni 	 ram-en-i 	 ramen-i
raneček 	 raneč-ek 	 raneček
rasy 	 ras-y 	 rasy
razítky 	 raz-í-tk-y 	 razít-k-y
referát 	 re-fer-át 	 referá-t
reflex 	 re-flex 	 reflex
reklamace 	 reklam-ac-e 	 reklam-ace
rektorem 	 rekt-or-em 	 rektor-em
relativita 	 rel-at-iv-it-a 	 relativit-a
repeal 	 repeal 	 repe-a-l
replikovat 	 re-plik-ova-t 	 replik-ova-t
reportáž 	 re-port-áž 	 report-áž
reprodukční 	 re-pro-duk-č-n-í 	 reprodukč-n-í
republikou 	 republik-ou 	 republ-ikou
resignovat 	 re-sign-ova-t 	 resign-ova-t
restriktivní 	 re-strikt-iv-n-í 	 restriktivní
revidovat 	 re-vid-ova-t 	 revid-ova-t
rezervy 	 re-zerv-y 	 rezerv-y
rider 	 rid-er 	 rider
rodinný 	 rod-in-n-ý 	 rodinn-ý
rohovatět 	 roh-ov-at-ě-t 	 rohovat-ě-t
roháček 	 roh-áč-ek 	 roháček
roky 	 rok-y 	 roky
rolničit 	 rol-n-ič-i-t 	 rolnič-i-t
rostl 	 rost-l 	 rostl
roxby 	 roxby 	 roxb-y
rozchraptit 	 roz-chrap-t-i-t 	 roz-chrapt-i-t
rozdivit 	 roz-div-i-t 	 rozdiv-i-t
rozdávat 	 roz-d-á-v-a-t 	 roz-dá-v-a-t
rozdíly 	 roz-díl-y 	 roz-dí-l-y
rozecpávat 	 roze-cp-á-v-a-t 	 rozecp-á-v-a-t
rozehřívat 	 roze-hří-v-a-t 	 roze-hř-íva-t
rozeklát 	 roze-kl-á-t 	 rozekl-á-t
rozeskupit 	 roze-skup-i-t 	 rozeskupi-t
rozestírat 	 roze-stír-a-t 	 rozestír-a-t
rozestřel 	 roze-stř-e-l 	 roze-střel
rozestřít 	 roze-stř-í-t 	 rozestří-t
rozesílán 	 roze-síl-á-n 	 roze-síl-án
rozevírat 	 roze-vír-a-t 	 rozevír-a-t
rozhlas 	 roz-hlas 	 rozhlas
rozhled 	 roz-hled 	 rozhled
rozhovoru 	 roz-hovor-u 	 rozhovoru
rozhozený 	 roz-hoz-en-ý 	 roz-hoz-ený
rozhrnula 	 roz-hrn-u-l-a 	 roz-hrnu-l-a
rozkloktat 	 roz-klokt-a-t 	 roz-klokta-t
rozkopávat 	 roz-kop-á-v-a-t 	 roz-kop-á-va-t
rozkošným 	 roz-koš-n-ý-m 	 roz-koš-n-ým
rozkuckat 	 roz-kuc-k-a-t 	 roz-kuck-a-t
rozleptávat 	 roz-lept-á-v-a-t 	 roz-lept-áv-a-t
rozluky 	 roz-luk-y 	 rozluk-y
rozmrzávat 	 roz-mrz-á-v-a-t 	 roz-mrz-á-va-t
rozplýtvat 	 roz-plýtv-a-t 	 roz-plý-tva-t
rozplývat 	 roz-plý-v-a-t 	 roz-plýv-a-t
rozpočísti 	 roz-po-číst-i 	 roz-počísti
rozprodávat 	 roz-pro-d-á-v-a-t 	 roz-prodáv-a-t
rozteskňovat 	 roz-tesk-ň-ova-t 	 roz-teskň-ova-t
roztroubit 	 roz-troub-i-t 	 roz-troubi-t
rozumových 	 roz-um-ov-ý-ch 	 rozum-ov-ých
rozumí 	 roz-um-í 	 rozum-í
rozutíkat 	 roz-utík-a-t 	 rozutík-a-t
rozuzlovat 	 roz-uzl-ova-t 	 rozuzl-ova-t
rozvinovat 	 roz-vi-n-ova-t 	 roz-vin-ova-t
rozvíjeny 	 roz-víj-en-y 	 roz-víj-eny
rozvětvené 	 roz-větv-en-é 	 roz-větven-é
rozčechrávat 	 roz-čechr-á-v-a-t 	 roz-čechrá-v-a-t
rozškvařovat 	 roz-škvař-ova-t 	 rozškvař-ova-t
rozžhavil 	 roz-žh-av-i-l 	 rozžhavil
ruka 	 ruk-a 	 ruka
ruku 	 ruk-u 	 ruku
ruské 	 rus-k-é 	 rusk-é
rusové 	 rus-ové 	 rus-ov-é
ručkovat 	 ruč-k-ova-t 	 ručk-ova-t
ryzost 	 ryz-ost 	 ryzost
rádi 	 rád-i 	 rádi
rána 	 rán-a 	 rána
ráno 	 rán-o 	 ráno
rázem 	 ráz-e-m 	 rázem
rázná 	 ráz-n-á 	 rázn-á
ráčkovat 	 ráč-k-ova-t 	 ráčk-ova-t
různými 	 různ-ý-m-i 	 různ-ými
různě 	 různ-ě 	 růz-n-ě
růže 	 růž-e 	 růže
sagnac 	 sagnac 	 sagn-ac
salonku 	 salon-k-u 	 salonk-u
salutuju 	 salut-uj-u 	 salutuju
samcoložník 	 samc-o-lož-n-ík 	 samcol-ožník
sametově 	 samet-ov-ě 	 samet-ově
samostatnější 	 sam-o-stat-n-ějš-í 	 sam-ostat-n-ěj-š-í
samotáři 	 sam-ot-ář-i 	 samot-ář-i
samozřejmá 	 sam-o-zř-ejm-á 	 samozřejm-á
sazeb 	 saz-eb 	 sazeb
sbratřit 	 s-bratř-i-t 	 sbratř-i-t
sbubnovat 	 s-bubn-ova-t 	 sbubn-ova-t
sbuntován 	 s-bunt-ová-n 	 sbunt-ován
sbírala 	 s-bír-a-l-a 	 s-bír-al-a
schodech 	 s-chod-e-ch 	 schod-ech
schody 	 s-chod-y 	 schody
schopných 	 s-chop-n-ých 	 s-chopn-ých
schovat 	 s-chov-a-t 	 s-chova-t
scienza 	 scienza 	 scienz-a
scorpions 	 scorpion-s 	 scorpions
sdružil 	 s-druž-i-l 	 sdruž-i-l
sebelepší 	 seb-e-lep-š-í 	 sebelepš-í
sebeničením 	 s-eb-e-ni-č-en-í-m 	 sebeničen-ím
sebevíce 	 seb-e-víc-e 	 sebev-íce
sebral 	 se-br-a-l 	 sebr-a-l
secvičit 	 se-cvič-i-t 	 secvič-i-t
sedla 	 sed-l-a 	 sedl-a
sedláková 	 sedl-ák-ov-á 	 sedlák-ová
sedmihradsku 	 sedmihradsk-u 	 sedm-ihradsk-u
sehrávat 	 se-hrá-v-a-t 	 sehráv-a-t
seminární 	 semin-ár-n-í 	 semin-ární
semílat 	 se-míl-a-t 	 semíl-a-t
separátní 	 se-par-át-n-í 	 separát-n-í
sepnout 	 se-pn-ou-t 	 sep-nou-t
sesekat 	 se-sek-a-t 	 sesek-a-t
seskupit 	 se-skup-i-t 	 seskup-i-t
sesmyknout 	 se-s-myk-nou-t 	 sesmyk-nou-t
sestrkávat 	 se-strk-á-v-a-t 	 se-strk-á-va-t
sestává 	 se-stá-v-á 	 sestáv-á
sestříhat 	 se-stříh-a-t 	 sestříh-a-t
setkal 	 se-tk-a-l 	 setk-a-l
seychelančin 	 seychel-an-č-in 	 seychelan-č-in
seznamuji 	 se-znam-uj-i 	 seznam-uji
seznámit 	 se-znám-i-t 	 seznám-i-t
seřizovat 	 se-řiz-ova-t 	 seřiz-ova-t
seškrabovat 	 se-škrab-ova-t 	 seškrab-ova-t
sešmajdat 	 se-šmajd-a-t 	 sešmajd-a-t
shrnout 	 s-hr-nou-t 	 shr-nou-t
signalizovali 	 signal-iz-ova-l-i 	 signal-iz-ovali
silence 	 silence 	 silenc-e
silná 	 sil-n-á 	 siln-á
sklapne 	 s-klap-n-e 	 sklapne
skličovat 	 s-klič-ova-t 	 sklič-ova-t
skládala 	 s-klád-a-l-a 	 s-klád-a-la
skládaly 	 s-klád-a-l-y 	 s-klád-a-ly
skomírat 	 s-ko-mír-a-t 	 skomír-a-t
skončení 	 s-konč-en-í 	 skonč-en-í
skončil 	 s-konč-i-l 	 skonč-i-l
skončila 	 s-konč-i-l-a 	 skonč-i-la
skončí 	 s-konč-í 	 skonč-í
skrápnout 	 s-kráp-nou-t 	 skráp-nou-t
skrývala 	 s-krýv-a-l-a 	 skrýva-la
skutečnosti 	 s-kut-eč-n-ost-i 	 skuteč-n-ost-i
skutečném 	 s-kut-eč-n-é-m 	 skuteč-n-ém
skříňce 	 skříň-c-e 	 skříňc-e
sladovat 	 slad-ova-t 	 s-lad-ova-t
slavnějším 	 slav-n-ěj-š-í-m 	 slav-nějším
sledovány 	 sled-ová-n-y 	 sled-ován-y
slejvat 	 s-lej-v-a-t 	 slejva-t
slev 	 s-lev 	 slev
slevu 	 s-lev-u 	 slev-u
slez 	 s-lez 	 slez
slibuji 	 s-lib-uj-i 	 slib-uj-i
sloupoví 	 sloup-ov-í 	 sloupoví
slovensko 	 sloven-sk-o 	 sloven-sko
slovník 	 slov-n-ík 	 slov-ník
slovným 	 slov-n-ý-m 	 slov-n-ým
slunce 	 slun-c-e 	 slunc-e
sluncí 	 slun-c-í 	 slunc-í
slízal 	 s-líz-a-l 	 slíz-a-l
smaragdy 	 smaragd-y 	 smaragdy
smekl 	 s-mek-l 	 smek-l
smrtelném 	 s-mr-tel-n-é-m 	 smrteln-ém
smrtelnému 	 s-mr-tel-n-é-mu 	 smrtelnému
smyslových 	 s-mysl-ov-ý-ch 	 s-mysl-ov-ých
smésti 	 s-mést-i 	 s-més-ti
směl 	 smě-l 	 směl
směrem 	 s-měr-e-m 	 směr-em
snahami 	 snah-a-m-i 	 snah-ami
snídaně 	 s-níd-a-n-ě 	 sníd-an-ě
snů 	 sn-ů 	 snů
sobectví 	 sob-ec-tv-í 	 sobectv-í
sobě 	 s-ob-ě 	 sob-ě
socializovat 	 soci-al-iz-ova-t 	 social-izova-t
solarmax 	 solar-max 	 solarmax
solidnost 	 solid-n-ost 	 solidn-ost
solidní 	 solid-n-í 	 solidn-í
solidních 	 solid-n-í-ch 	 solidn-ích
sotva 	 sotva 	 sotv-a
souboj 	 sou-boj 	 souboj
souborů 	 sou-bor-ů 	 soubor-ů
soucitně 	 sou-cit-n-ě 	 soucit-n-ě
soudním 	 soud-n-ím 	 soudn-ím
souhlasný 	 sou-hlas-n-ý 	 souhlas-n-ý
souhlasí 	 sou-hlas-í 	 souhlas-í
soukromník 	 sou-krom-ník 	 soukrom-ník
soused 	 sou-sed 	 soused
sousedit 	 sou-sed-i-t 	 soused-i-t
sousedního 	 sou-sed-n-í-ho 	 soused-n-ího
soustava 	 sou-stav-a 	 soustav-a
soustružit 	 sou-struž-i-t 	 sou-struži-t
soutěž 	 sou-těž 	 soutěž
soutěže 	 sou-těž-e 	 soutěž-e
soutěži 	 sou-těž-i 	 soutěž-i
soutěžit 	 sou-těž-i-t 	 soutěž-i-t
souvislost 	 sou-vis-l-ost 	 souvisl-ost
současná 	 sou-čas-n-á 	 součas-n-á
spadla 	 s-pad-l-a 	 spad-l-a
spadne 	 s-pad-ne 	 spad-ne
spaly 	 sp-a-l-y 	 spal-y
specialisté 	 speci-al-ist-é 	 special-ist-é
specializované 	 speci-al-iz-ova-n-é 	 speci-aliz-ova-n-é
specifickým 	 speci-fic-k-ý-m 	 specif-ick-ým
speciál 	 speci-ál 	 speciál
spekulací 	 spekul-ac-í 	 spek-ul-ac-í
spekulantem 	 spek-ul-ant-e-m 	 spek-ul-ant-em
spekulativní 	 spekul-at-iv-n-í 	 spek-ul-ativn-í
spis 	 s-pis 	 spis
splatit 	 s-plat-i-t 	 splat-i-t
splašené 	 s-plaš-en-é 	 splaš-en-é
spojkami 	 s-poj-k-a-m-i 	 spoj-k-ami
spokojena 	 s-po-koj-en-a 	 s-pokoj-ena
spokojíte 	 s-pokoj-í-te 	 s-pok-oj-í-te
spolehliví 	 s-po-leh-liv-í 	 s-pol-eh-liv-í
spolupodepsat 	 spol-u-pode-ps-a-t 	 spolupodepsat
spolupůsobit 	 spol-u-působ-i-t 	 spol-upůsob-i-t
spolutvořit 	 spol-u-tvoř-i-t 	 spolutvoř-i-t
spoléhej 	 s-po-léh-ej 	 spol-éh-ej
sponzorsky 	 sponzor-sk-y 	 sponzorsk-y
sportovní 	 sport-ov-n-í 	 sportovní
spotřebitel 	 s-po-třeb-i-tel 	 s-potřeb-i-tel
spotřebitele 	 s-po-třeb-i-tel-e 	 s-potřeb-i-tel-e
spoután 	 s-pout-á-n 	 spoután
spočítal 	 s-po-čít-a-l 	 s-počít-a-l
spočítá 	 s-po-čít-á 	 s-poč-ít-á
spoří 	 s-poř-í 	 spoř-í
spravedlivost 	 s-prav-ed-l-iv-ost 	 spravedliv-ost
sprchnout 	 s-prch-nou-t 	 sprch-nou-t
správních 	 s-práv-n-ích 	 správ-n-ích
spáchat 	 s-pách-a-t 	 spách-a-t
spřahovat 	 s-přah-ova-t 	 spřah-ova-t
srdečně 	 srd-eč-n-ě 	 srdečn-ě
srna 	 srn-a 	 srna
srovnatelná 	 s-rov-n-a-teln-á 	 s-rovn-a-tel-n-á
stabilní 	 stabil-n-í 	 stab-il-n-í
stadionu 	 stadion-u 	 stad-ionu
stanoven 	 stanov-en 	 stan-ov-en
stanovil 	 stanov-i-l 	 stan-ovil
starobní 	 star-ob-n-í 	 starob-n-í
starožitných 	 star-o-ži-t-n-ých 	 star-ož-itn-ých
start 	 start 	 star-t
starých 	 star-ý-ch 	 star-ých
stavení 	 sta-v-en-í 	 stav-en-í
stačilo 	 stač-i-l-o 	 stač-il-o
stejkaně 	 s-tejk-a-n-ě 	 stejkan-ě
stejném 	 stej-n-é-m 	 stejn-ém
stipendium 	 stipendi-um 	 stipendium
stlačit 	 s-tlač-i-t 	 stlač-i-t
stlouci 	 s-tlouc-i 	 stlouc-i
stokorunovou 	 st-o-korun-ov-ou 	 stokorun-ov-ou
století 	 st-o-let-í 	 stol-et-í
stones 	 stone-s 	 stones
stoupněte 	 stoup-ně-te 	 stoupn-ěte
stovkou 	 st-ovk-ou 	 stov-k-ou
stovku 	 st-ovk-u 	 stov-k-u
strahov 	 strahov 	 strah-ov
strahova 	 strahov-a 	 strah-ova
strahově 	 strahov-ě 	 strah-ově
strava 	 s-trav-a 	 strav-a
strašnicích 	 strašnic-í-ch 	 straš-nic-ích
strnutí 	 s-trn-u-t-í 	 strnut-í
stroje 	 stroj-e 	 stroje
strojírenské 	 stroj-íren-sk-é 	 strojíren-sk-é
studiích 	 stud-i-í-ch 	 stud-i-ích
studovaný 	 stud-ova-n-ý 	 stud-ovaný
stulit 	 s-tul-i-t 	 stul-i-t
stál 	 stá-l 	 stál
stála 	 stá-l-a 	 stál-a
stát 	 stá-t 	 stát
stínit 	 stín-i-t 	 s-tín-i-t
stěžovatel 	 stěž-ova-tel 	 s-těž-ova-tel
střechách 	 střech-á-ch 	 střech-ách
střepávat 	 s-třep-á-v-a-t 	 střep-á-va-t
stříbrolesklého 	 stříbr-o-lesk-l-é-ho 	 stříbr-olesk-l-ého
střízlivět 	 stříz-l-iv-ě-t 	 střízl-ivě-t
sundavat 	 s-und-a-v-a-t 	 sundav-a-t
superdobrý 	 super-dobr-ý 	 superdobr-ý
supernova 	 super-nova 	 supern-ova
supraphon 	 supra-phon 	 supraphon
svedena 	 s-ved-en-a 	 sved-en-a
svlékat 	 s-vlék-a-t 	 svlék-a-t
svlékla 	 s-vlék-l-a 	 svlékl-a
svraštil 	 s-vrašt-i-l 	 svrašt-i-l
svrtět 	 s-vrt-ě-t 	 svrt-ě-t
svát 	 s-vá-t 	 svát
svídnici 	 svídnic-i 	 svíd-nici
svítily 	 svít-i-l-y 	 svít-il-y
svědkové 	 s-věd-k-ové 	 svěd-kové
svědomím 	 s-věd-om-í-m 	 svěd-om-ím
světelné 	 svět-el-n-é 	 světelné
světelných 	 svět-el-n-ých 	 světel-n-ých
synchronizovat 	 syn-chron-iz-ova-t 	 synchron-izovat
sypou 	 syp-ou 	 sypou
systematický 	 system-at-ic-k-ý 	 systematick-ý
systémem 	 systém-e-m 	 systém-em
sáňkovávací 	 sáň-k-ová-v-a-c-í 	 sáňk-ováva-c-í
síci 	 síc-i 	 síci
sít 	 sí-t 	 sít
sýra 	 sýr-a 	 sýra
sčítávat 	 s-čít-á-v-a-t 	 s-čít-áv-a-t
sžívat 	 s-ží-v-a-t 	 sžív-a-t
tahal 	 tah-a-l 	 taha-l
tajemství 	 taj-em-stv-í 	 tajemství
tajná 	 taj-n-á 	 tajn-á
takzvaném 	 tak-zv-a-n-é-m 	 takzvan-ém
také 	 také 	 tak-é
takřečená 	 tak-řeč-en-á 	 takřeč-en-á
tati 	 tat-i 	 tati
taxík 	 tax-ík 	 taxík
technickým 	 techn-ic-k-ým 	 techn-ick-ým
technika 	 techn-ik-a 	 technik-a
technologického 	 techn-o-log-ick-ého 	 techno-log-ického
telat 	 tel-at 	 tel-a-t
telefonního 	 tele-fon-n-í-ho 	 tele-fon-n-ího
temporalizovatelný 	 tempor-al-izova-teln-ý 	 temporal-izovatelný
tendenci 	 tend-enc-i 	 tendenc-i
tenhle 	 t-en-hle 	 tenhle
tenounkým 	 ten-oun-k-ý-m 	 tenounk-ým
terminologii 	 termino-log-i-i 	 terminologii
tesklivých 	 tesk-l-iv-ý-ch 	 teskliv-ých
tetička 	 tet-ič-k-a 	 tetičk-a
textil 	 textil 	 text-i-l
thajska 	 thaj-sk-a 	 thajsk-a
theodicée 	 theodicée 	 theod-icée
tikem 	 tik-e-m 	 tikem
tipovali 	 tip-ova-l-i 	 tipoval-i
tipy 	 tip-y 	 tipy
tiskárnu 	 tisk-árn-u 	 tisk-ár-n-u
tisovitý 	 tis-ovit-ý 	 tisovit-ý
tj 	 t-j 	 tj
tkalcovnictví 	 tka-lc-ovnic-tv-í 	 tkalc-ovnictví
tlapkách 	 tlap-k-á-ch 	 tlap-k-ách
topilo 	 top-i-l-o 	 topil-o
tou 	 t-ou 	 tou
transplantační 	 trans-plant-ač-n-í 	 transplant-ační
treperendo 	 treper-end-o 	 treperendo
trestat 	 trest-a-t 	 tresta-t
trojí 	 tr-oj-í 	 troj-í
troufat 	 trouf-a-t 	 troufa-t
trpělivě 	 trp-ě-l-iv-ě 	 trpěl-iv-ě
truhlářský 	 truhl-ář-sk-ý 	 truhlář-sk-ý
trutnovský 	 trutnov-sk-ý 	 trut-novsk-ý
tržba 	 trž-b-a 	 tržb-a
tržním 	 trž-n-ím 	 tržn-ím
turbodmychadlo 	 turbo-dmych-adl-o 	 turbod-mychadlo
turbovrtulových 	 turbo-vrt-ul-ov-ých 	 turb-ovrtulových
turecký 	 turec-k-ý 	 tureck-ý
turistiky 	 tur-ist-ik-y 	 turistik-y
turné 	 turné 	 tur-n-é
tušící 	 tuš-íc-í 	 tušíc-í
tužba 	 tuž-b-a 	 tužb-a
tužeb 	 tuž-eb 	 tužeb
tvrzeními 	 tvrz-en-í-m-i 	 tvrz-en-ími
tyfem 	 tyf-em 	 tyfem
tzv 	 t-z-v 	 tzv
táhlo 	 táh-l-o 	 táhl-o
téhož 	 t-é-ho-ž 	 téhož
tématu 	 tém-at-u 	 témat-u
tímhle 	 t-í-m-hle 	 tímhle
tímto 	 t-í-m-t-o 	 tímt-o
tít 	 t-í-t 	 tít
týdeníku 	 týden-ík-u 	 týdeníku
těhotenství 	 těhoten-ství 	 těhotenstv-í
těmi 	 t-ě-m-i 	 těmi
třemi 	 tř-e-m-i 	 třemi
třepetat 	 třep-et-a-t 	 třepet-a-t
třesoucí 	 třes-ou-c-í 	 třes-ouc-í
třetím 	 tř-e-t-í-m 	 třet-í-m
třiceti 	 tř-i-cet-i 	 třiceti
udýchanej 	 u-dých-a-n-ej 	 u-dýchanej
uhledat 	 u-hled-a-t 	 u-hleda-t
uhražen 	 u-hraž-en 	 uhraž-en
ujelo 	 u-je-l-o 	 u-jel-o
ujistit 	 u-jist-i-t 	 u-jisti-t
ukazuju 	 u-kaz-u-j-u 	 u-kaz-uj-u
ukrutným 	 u-krut-n-ý-m 	 u-krut-n-ým
ukuckat 	 u-kuc-k-a-t 	 u-kuck-a-t
ulici 	 ul-ic-i 	 ulic-i
uloženými 	 u-lož-en-ý-m-i 	 u-lož-en-ými
umožnilo 	 u-možn-i-l-o 	 u-mož-n-i-l-o
umožnily 	 u-možn-i-l-y 	 u-mož-n-i-l-y
umrtvení 	 u-mr-tv-en-í 	 u-mrtv-en-í
uměle 	 u-m-ě-l-e 	 uměl-e
umělkovat 	 um-ě-l-k-ova-t 	 u-měl-k-ova-t
umělostech 	 u-m-ě-l-ost-e-ch 	 u-měl-ost-ech
unavujou 	 u-nav-uj-ou 	 unav-uj-ou
unese 	 u-nes-e 	 unes-e
unikát 	 unik-át 	 unik-á-t
univerzitního 	 uni-verz-it-n-ího 	 univerzit-n-ího
uplatnil 	 u-plat-n-i-l 	 u-platn-i-l
uplatněný 	 u-plat-n-ěn-ý 	 u-platn-ěn-ý
upozornit 	 u-po-zor-n-i-t 	 u-pozor-n-i-t
upozorňujeme 	 u-po-zor-ň-uje-me 	 u-pozor-ň-uje-me
urgenci 	 urg-enc-i 	 urgenc-i
urousat 	 u-rous-a-t 	 u-rousa-t
urychlila 	 u-rychl-i-l-a 	 urychl-il-a
určeno 	 u-rč-en-o 	 určeno
určenou 	 u-rč-en-ou 	 určen-ou
určitě 	 urč-it-ě 	 určit-ě
určovaly 	 u-rč-ova-l-y 	 urč-ova-l-y
usa 	 u-s-a 	 u-sa
uschovávat 	 u-s-chov-á-v-a-t 	 u-sch-ov-á-va-t
usd 	 u-s-d 	 usd
usedavě 	 u-sed-a-v-ě 	 u-sed-av-ě
uskladňovat 	 u-s-klad-ň-ova-t 	 u-sklad-ň-ova-t
uskutečnila 	 u-skuteč-n-i-l-a 	 u-skutečni-l-a
uskutečnily 	 u-s-kut-eč-n-i-l-y 	 u-skutečni-l-y
uspokojen 	 u-s-po-koj-en 	 u-spo-kojen
uspořádat 	 u-s-po-řád-a-t 	 u-spořád-a-t
ustanoveními 	 u-stanov-en-ími 	 u-stanoven-ími
ustavičně 	 u-stav-ič-n-ě 	 u-stavič-n-ě
ustrnule 	 u-s-trn-u-l-e 	 u-str-nule
utrmácet 	 u-trmác-e-t 	 u-trm-ác-e-t
utřel 	 u-tř-e-l 	 u-tře-l
uvolnit 	 u-vol-n-i-t 	 u-vol-ni-t
uváděním 	 u-vád-ě-n-ím 	 u-vád-ěn-ím
uzavírá 	 u-za-vír-á 	 u-zav-ír-á
uzavřeli 	 u-za-vř-e-l-i 	 u-za-vře-l-i
uzdraví 	 u-zdrav-í 	 u-zdr-av-í
uznávání 	 u-zn-á-v-á-n-í 	 u-zn-á-vá-n-í
uzpůsobit 	 u-z-působ-i-t 	 uzpůsob-i-t
učitel 	 uč-i-tel 	 uči-tel
učitelů 	 uč-i-tel-ů 	 učitel-ů
uštelovavší 	 u-štel-ova-vš-í 	 u-štelovavší
uším 	 uš-ím 	 uším
užitečné 	 u-žit-eč-n-é 	 užiteč-n-é
užívat 	 u-ží-v-a-t 	 u-ží-v-at
užívá 	 u-ží-v-á 	 u-žív-á
vadí 	 vad-í 	 vadí
vajnar 	 vajnar 	 vajn-ar
vakuářskost 	 vaku-ář-sk-ost 	 vakuář-sk-ost
vanka 	 van-k-a 	 vank-a
vaně 	 van-ě 	 vaně
vašnosti 	 vaš-n-ost-i 	 vaš-n-osti
vcházet 	 v-cház-e-t 	 vcház-e-t
vdechnout 	 v-dech-nou-t 	 vdech-nou-t
vejci 	 vej-c-i 	 vejc-i
velikost 	 vel-ik-ost 	 velik-ost
velikou 	 vel-ik-ou 	 velik-ou
velká 	 vel-k-á 	 velk-á
velkého 	 vel-k-é-ho 	 vel-k-ého
velvyslanectví 	 vel-vy-sl-a-n-ec-tv-í 	 velvyslanectví
vemluvit 	 ve-mluv-i-t 	 vemluv-i-t
venkovan 	 ven-k-ov-an 	 venk-ovan
ventures 	 venture-s 	 ventures
vepsat 	 ve-ps-a-t 	 veps-a-t
vesnici 	 ves-nic-i 	 vesn-ic-i
vespolek 	 ve-s-pol-ek 	 vespol-ek
vetkat 	 ve-tk-a-t 	 vetk-a-t
vetkávat 	 ve-tk-á-v-a-t 	 vetk-á-v-a-t
vezmeš 	 vez-m-e-š 	 vezmeš
vezmou 	 vez-m-ou 	 vezm-ou
veřejně 	 veř-ej-n-ě 	 veřejn-ě
veškeré 	 veš-k-er-é 	 vešk-er-é
veškerým 	 veš-k-er-ý-m 	 vešk-er-ým
vhodným 	 v-hod-n-ým 	 vhod-n-ým
viděls 	 vid-ě-l-s 	 viděls
vily 	 vil-y 	 vily
vinohradského 	 vinohrad-sk-é-ho 	 vinohradsk-ého
virile 	 virile 	 viril-e
vizum 	 viz-um 	 vizum
vkluzovávaně 	 v-kluz-ová-v-a-n-ě 	 vkluzovávan-ě
vkládáme 	 v-klád-á-me 	 vklád-á-me
vlastnostech 	 vlast-n-ost-ech 	 vlastn-ost-ech
vlastního 	 vlast-n-í-ho 	 vlast-n-ího
vlaštovčí 	 vlašt-ov-č-í 	 vlaštovč-í
vložit 	 v-lož-i-t 	 vlož-i-t
vložkovací 	 v-lož-k-ova-c-í 	 vložk-ovac-í
vloží 	 v-lož-í 	 vlož-í
vládávatelnost 	 vlád-á-v-a-teln-ost 	 v-lád-áv-a-teln-ost
vnitrný 	 v-nitr-n-ý 	 vnitrn-ý
vnitřnostech 	 v-nitř-n-ost-e-ch 	 vnitřn-ost-ech
vnímat 	 v-ním-a-t 	 vním-a-t
vobléknutelný 	 v-ob-lék-nu-teln-ý 	 vob-lék-nutelný
vodolově 	 vodolov-ě 	 vodol-ov-ě
vodotiskem 	 vod-o-tisk-em 	 vodotiskem
vojenskou 	 voj-en-sk-ou 	 vojensk-ou
vojsko 	 voj-sk-o 	 vojsk-o
vozidly 	 voz-i-dl-y 	 vozidl-y
vplížit 	 v-plíž-i-t 	 vplíž-i-t
vpít 	 v-pí-t 	 vpít
vraštět 	 vraš-t-ě-t 	 vraště-t
vrcholu 	 vrch-ol-u 	 vrchol-u
vrtulníky 	 vrt-ul-ník-y 	 vrtuln-ík-y
vrátnice 	 vrát-nic-e 	 vrát-nice
vstoupnutelný 	 v-stoup-nu-teln-ý 	 v-stoup-nu-telný
vstup 	 v-stup 	 vstup
vstupenek 	 vs-tup-en-ek 	 vstupenek
vstupenka 	 v-stup-enk-a 	 vstupenka
vstupenku 	 v-stup-enk-u 	 vstupenku
vstupenky 	 vstup-enk-y 	 vstupenky
vstupné 	 v-stup-n-é 	 vstupn-é
vstupného 	 v-stup-n-ého 	 vstupn-ého
vstupném 	 v-stup-n-ém 	 vstupn-ém
vstupu 	 v-stup-u 	 vstup-u
vtiskávat 	 v-tisk-á-v-a-t 	 v-tisk-á-va-t
vyabstrahovat 	 vy-abs-trah-ova-t 	 vyabstrah-ovat
vybafčit 	 vy-baf-č-i-t 	 vy-bafč-i-t
vychovat 	 vy-chov-a-t 	 vychova-t
vydráždit 	 vy-drážd-i-t 	 vy-dráž-d-i-t
vydávaje 	 vy-d-á-v-aj-e 	 vy-dáv-aje
vyhledávat 	 vy-hled-á-v-a-t 	 vy-hled-á-va-t
vyhodnocovat 	 vy-hod-n-oc-ova-t 	 vy-hod-n-ocova-t
vyhrkla 	 vy-hrk-l-a 	 vy-hrkl-a
vyjasněný 	 vy-jas-n-ěn-ý 	 vy-jasn-ěn-ý
vyjel 	 vy-je-l 	 vyje-l
vyklopýtat 	 vy-klopýt-a-t 	 vy-klop-ýta-t
vykonávali 	 vy-kon-á-v-a-l-i 	 vy-koná-val-i
vykramařit 	 vy-kram-ař-i-t 	 vy-kram-aři-t
vylehčit 	 vy-leh-č-i-t 	 vy-lehč-i-t
vymyšlené 	 vy-myšl-e-n-é 	 vy-myšl-en-é
vyměřovacímu 	 vy-měř-ova-c-ímu 	 vy-měř-ovac-ímu
vynaložením 	 vy-na-lož-en-í-m 	 vy-na-lož-en-ím
vynaloží 	 vy-na-lož-í 	 vy-nal-ož-í
vynalézání 	 vy-na-léz-á-n-í 	 vy-na-léz-án-í
vypancéřovat 	 vy-pancéř-ova-t 	 vy-panc-éř-ova-t
vypeckovat 	 vy-pec-k-ova-t 	 vy-peck-ova-t
vypejkání 	 vy-pejk-á-n-í 	 vy-pejk-án-í
vyplaněný 	 vy-plan-ě-n-ý 	 vy-plan-ěn-ý
vyplísnit 	 vy-plísn-i-t 	 vy-plís-n-i-t
vyportrétovat 	 vy-portrét-ova-t 	 vy-portrét-ovat
vypočísti 	 vy-po-číst-i 	 vy-po-čís-ti
vypočítávat 	 vy-po-čít-á-v-a-t 	 vy-po-čít-áv-a-t
vypravili 	 vy-prav-i-l-i 	 vy-prav-il-i
vyprovokovat 	 vy-pro-vok-ova-t 	 vy-provokova-t
vyprávěli 	 vy-práv-ě-l-i 	 vy-práv-ěl-i
vypárovací 	 vy-pár-ova-c-í 	 vy-pár-ovac-í
vysedával 	 vy-sed-á-v-a-l 	 vy-sed-ával
vyslovený 	 vy-slov-en-ý 	 vyslov-ený
vyslyšeti 	 vy-slyš-e-ti 	 vyslyš-e-ti
vysokoškolské 	 vys-ok-o-škol-sk-é 	 vy-soko-školské
vysokoškolský 	 vys-ok-o-škol-sk-ý 	 vy-sokoškolský
vysoká 	 vys-ok-á 	 vysok-á
vysokém 	 vys-ok-ém 	 vysok-ém
vyspinkat 	 vy-sp-ink-a-t 	 vy-spink-a-t
vyspravit 	 vy-s-prav-i-t 	 vysprav-i-t
vystavila 	 vy-stav-i-l-a 	 vy-stav-il-a
vystoupení 	 vy-stoup-en-í 	 vy-stoupen-í
vystoupením 	 vy-stoup-en-ím 	 vy-stoupen-ím
vystřídalo 	 vy-stříd-a-l-o 	 vy-střída-l-o
vystříkat 	 vy-střík-a-t 	 vystřík-a-t
vysvětlení 	 vy-svět-l-en-í 	 vy-svět-len-í
vysílací 	 vy-síl-a-c-í 	 vy-síl-ac-í
vytvořeno 	 vy-tvoř-en-o 	 vytvoř-eno
vytít 	 vy-t-í-t 	 vy-tí-t
vyvracela 	 vy-vrac-e-l-a 	 vy-vrac-el-a
vyvrkávat 	 vy-vrk-á-v-a-t 	 vy-vrk-á-va-t
vyvážecí 	 vy-váž-e-c-í 	 vy-váž-ec-í
vyznají 	 vy-zn-aj-í 	 vy-znaj-í
vyzpytovat 	 vy-z-pyt-ova-t 	 vy-zpyt-ova-t
vyzvracet 	 vy-z-vrac-e-t 	 vy-zvrac-et
vyčpět 	 vy-čp-ě-t 	 vy-čpě-t
vyčísti 	 vy-číst-i 	 vy-čís-ti
vyřinout 	 vy-řin-ou-t 	 vyři-nou-t
vyžadonit 	 vy-žad-on-i-t 	 vy-žadon-i-t
vyžle 	 vyžle 	 vy-žl-e
vzdorovat 	 vz-dor-ova-t 	 vzdor-ova-t
vzdálený 	 vz-dál-en-ý 	 vzdál-en-ý
vzdělání 	 vz-děl-án-í 	 vz-děl-á-n-í
vzhlížet 	 vz-hlíž-e-t 	 vzhlíž-e-t
vznikají 	 vz-nik-aj-í 	 vznik-aj-í
vztekle 	 vz-tek-l-e 	 vz-tekl-e
vzájemná 	 v-zá-jem-n-á 	 vzájem-n-á
vzít 	 vz-í-t 	 vzí-t
vás 	 v-á-s 	 vás
víte 	 v-í-te 	 víte
vítkovice 	 vít-k-ov-ic-e 	 vítk-ovice
vítkovického 	 vítk-ovic-k-ého 	 vítk-ovick-ého
vítkovickém 	 vítk-ovic-k-ém 	 vítkov-ick-ém
vítězství 	 vítěz-ství 	 vítězství
výcviku 	 vý-cvik-u 	 výcvik-u
výdělek 	 vý-děl-ek 	 vý-dělek
výdělečných 	 vý-děl-eč-n-ých 	 vý-děleč-n-ých
výherci 	 vý-her-c-i 	 vý-herc-i
výpotek 	 vý-pot-ek 	 vý-potek
výpočetní 	 vý-po-čet-n-í 	 vý-počet-n-í
výsostným 	 výs-ost-n-ý-m 	 výsost-n-ým
výuce 	 vý-uc-e 	 výuc-e
výukových 	 vý-uk-ov-ých 	 výuk-ov-ých
výčitek 	 vý-čit-e-k 	 vý-čitek
vědec 	 věd-ec 	 vědec
větrovka 	 větr-ovk-a 	 větrovk-a
věznit 	 věz-n-i-t 	 vězn-i-t
všeho 	 vš-eho 	 všeho
všeobecně 	 vš-e-obec-n-ě 	 všeobec-n-ě
vševědova 	 vševěd-ov-a 	 vševěd-ova
vštípit 	 v-štíp-i-t 	 vštípi-t
vštěpuji 	 v-štěp-uj-i 	 vštěp-uji
vůnička 	 vůn-ič-k-a 	 vůničk-a
vůní 	 vůn-í 	 vůní
vůně 	 vůn-ě 	 vůně
westermannem 	 westermann-e-m 	 westerman-n-em
whitney 	 whitney 	 whitne-y
yse 	 y-s-e 	 yse
zabijeme 	 za-bi-je-me 	 za-bije-me
zachmuřen 	 za-chmuř-en 	 za-chmuřen
zachovávat 	 za-chov-á-v-a-t 	 za-chov-á-va-t
zadek 	 zad-ek 	 zadek
zadrhl 	 za-drh-l 	 zadrh-l
zafilosofovat 	 za-filo-sof-ova-t 	 za-filosof-ovat
zahanbit 	 za-han-b-i-t 	 za-hanb-i-t
zahozených 	 za-hoz-en-ý-ch 	 za-hoz-en-ých
zahradník 	 za-hrad-n-ík 	 za-hrad-ník
zahrnutí 	 za-hr-nu-t-í 	 za-hrnu-t-í
zahynul 	 za-hyn-u-l 	 za-hynu-l
zainteresované 	 za-interes-ova-n-é 	 zainteres-ova-n-é
zajatec 	 za-j-at-ec 	 za-jat-ec
zakonzervování 	 za-konzerv-ová-n-í 	 za-konz-erv-ová-n-í
zakopaný 	 za-kop-a-n-ý 	 za-kopa-n-ý
zakopán 	 za-kop-á-n 	 za-kopán
zakrvavět 	 za-krv-av-ě-t 	 za-krv-avě-t
zakusitelno 	 za-kus-i-tel-n-o 	 za-kus-i-telno
zakázkách 	 za-káz-k-ách 	 za-kázk-ách
zakývat 	 za-kýv-a-t 	 za-ký-v-a-t
zalidnit 	 za-lid-n-i-t 	 za-lidn-i-t
zalil 	 za-li-l 	 zali-l
zameškávat 	 za-mešk-á-v-a-t 	 za-mešk-á-va-t
zamkl 	 za-mk-l 	 zamk-l
zamotávat 	 za-mot-á-v-a-t 	 za-motá-v-a-t
zamyšlená 	 za-myšl-e-n-á 	 za-myšl-en-á
zamyšlený 	 za-myšl-e-n-ý 	 za-myšl-en-ý
zamyšleně 	 za-myšl-e-n-ě 	 za-myšl-en-ě
zaměstnancům 	 za-měst-n-an-c-ům 	 za-měst-nanc-ům
zaměstnání 	 za-měst-n-á-n-í 	 za-měst-nán-í
zanadávat 	 za-na-d-á-v-a-t 	 za-nad-á-v-a-t
zanedbávat 	 za-ne-db-á-v-a-t 	 za-nedb-á-va-t
zapomnění 	 za-po-mn-ě-n-í 	 za-pomn-ěn-í
zapomínat 	 za-pomín-a-t 	 za-po-mín-a-t
započísti 	 za-po-číst-i 	 za-po-čísti
zapošít 	 za-po-ší-t 	 za-poš-í-t
zaprodávat 	 za-pro-d-á-v-a-t 	 za-prod-á-v-a-t
zapříčiněné 	 za-pří-čin-ěn-é 	 za-příč-in-ěn-é
zardousil 	 za-rdous-i-l 	 zard-ousi-l
zareagovat 	 za-re-ag-ova-t 	 za-reag-ova-t
zaregistrovat 	 za-registr-ova-t 	 za-registr-ovat
zarámovány 	 za-rám-ová-n-y 	 za-rám-ován-y
zasahují 	 za-sah-u-j-í 	 za-sah-uj-í
zasklívaně 	 za-skl-í-v-a-n-ě 	 za-sklívan-ě
zaslíbeni 	 za-s-líb-en-i 	 za-slíb-eni
zastřelili 	 za-střel-i-l-i 	 za-střelil-i
zatelegrafovat 	 za-tele-graf-ova-t 	 zatele-grafovat
zatkneme 	 za-tk-ne-me 	 zatkneme
zatrubňovávatelnost 	 za-trub-ň-ová-v-a-teln-ost 	 za-trub-ň-ová-v-a-telnost
zatvrzují 	 za-tvrz-u-j-í 	 za-tvrz-uj-í
zatčený 	 za-tč-en-ý 	 zatč-en-ý
zaujatý 	 z-au-j-a-t-ý 	 zauj-at-ý
zaujmouti 	 zau-jm-ou-ti 	 zaujmouti
zavolám 	 za-vol-á-m 	 za-vol-ám
zavtipkovat 	 za-vtip-k-ova-t 	 zavtipk-ova-t
zavzdychnout 	 za-vz-dych-nou-t 	 zavz-dych-nou-t
zavírali 	 za-vír-a-l-i 	 za-vír-al-i
zavřeny 	 za-vř-e-n-y 	 za-vř-en-y
zazátkovat 	 za-zá-tk-ova-t 	 za-zátk-ova-t
začne 	 za-č-ne 	 začn-e
začpít 	 za-čp-í-t 	 za-čpí-t
zaťal 	 za-ť-a-l 	 zaťa-l
zbaštit 	 z-bašt-i-t 	 z-bašti-t
zblízka 	 z-blíz-k-a 	 zblízk-a
zbožni 	 z-bož-n-i 	 zbož-n-i
zbytečné 	 z-by-t-eč-n-é 	 z-byt-eč-n-é
zchlapčilý 	 z-chlap-č-i-l-ý 	 z-chlap-čil-ý
zcuchat 	 z-cuch-a-t 	 zcuch-a-t
zdanitelná 	 z-dan-i-teln-á 	 z-dan-iteln-á
zdechat 	 z-dech-a-t 	 zdech-a-t
zdeformovat 	 z-de-form-ova-t 	 zde-form-ova-t
zdegenerovat 	 z-de-gener-ova-t 	 z-degenerova-t
zdeněk 	 zdeněk 	 zden-ěk
zdi 	 zd-i 	 zdi
zdobit 	 z-dob-i-t 	 zdob-i-t
zdokonalit 	 z-do-kon-a-l-i-t 	 z-do-kon-al-i-t
zdražovat 	 z-draž-ova-t 	 zdraž-ova-t
zdrchat 	 z-drch-a-t 	 zdrch-a-t
zdrsnět 	 z-drs-n-ě-t 	 z-drsn-ě-t
zdít 	 zd-í-t 	 zdí-t
zdřevnatět 	 z-dřev-n-at-ě-t 	 z-dřevn-at-ě-t
zemím 	 zem-ím 	 zemí-m
zemědělské 	 zem-ě-děl-sk-é 	 zemědělsk-é
zemědělských 	 zem-ě-děl-sk-ých 	 zemědělsk-ých
zemřeli 	 ze-mř-e-l-i 	 zemř-e-l-i
zeptá 	 ze-pt-á 	 zept-á
zesilovat 	 ze-sil-ova-t 	 zesil-ova-t
zespolečenšťovat 	 ze-spol-eč-en-šť-ova-t 	 ze-spol-eč-enšťovat
zesvětštět 	 ze-svět-št-ě-t 	 zesvět-št-ě-t
zesílit 	 ze-síl-i-t 	 zesíl-i-t
zešedivět 	 ze-šed-iv-ě-t 	 zešed-iv-ět
zešpatnět 	 ze-špat-n-ě-t 	 zešpat-n-ě-t
zfalšování 	 z-falš-ová-n-í 	 z-falšová-n-í
zheroizovavší 	 z-hero-izova-vš-í 	 z-hero-izovavš-í
zhospodárnit 	 z-hospod-ár-n-i-t 	 z-hospodár-n-i-t
zhypnotizovat 	 z-hypn-ot-iz-ova-t 	 z-hypnotiz-ova-t
zimě 	 zim-ě 	 zimě
zinventovat 	 z-invent-ova-t 	 zinvent-ova-t
zjednat 	 z-jedn-a-t 	 z-jedna-t
zjednodušení 	 z-jedn-o-duš-en-í 	 z-jedno-duš-en-í
zjednodušilo 	 z-jedn-o-duš-i-l-o 	 z-jedno-duš-i-l-o
zjízlivět 	 z-jíz-l-iv-ě-t 	 z-jízl-ivě-t
zkamenět 	 z-kamen-ě-t 	 z-kam-en-ě-t
zkazilo 	 z-kaz-i-l-o 	 z-kaz-il-o
zkrásnět 	 z-krás-n-ě-t 	 z-krásn-ě-t
zkusila 	 z-kus-i-l-a 	 z-kus-il-a
zkypřet 	 z-kypř-e-t 	 z-kypře-t
zlatnout 	 zlat-nou-t 	 z-lat-nou-t
zlatovlasé 	 zlat-o-vlas-é 	 zlat-ovlas-é
zloděj 	 zl-o-děj 	 zlod-ěj
zlodějsku 	 zl-o-děj-sk-u 	 zlod-ějsku
zločinem 	 zl-o-čin-e-m 	 zloč-in-em
zlí 	 zl-í 	 zlí
zmeškat 	 z-mešk-a-t 	 z-meška-t
zmizely 	 z-miz-e-l-y 	 z-miz-el-y
zmodrat 	 z-modr-a-t 	 z-modra-t
zmoralizování 	 z-moral-iz-ová-n-í 	 z-mor-al-izová-n-í
zmramorovatěnost 	 z-mramor-ovat-ě-n-ost 	 z-mramor-ova-t-ěnost
zmultiplicírovaný 	 z-multi-plic-ír-ova-n-ý 	 z-multi-plic-írovaný
zmýdelnět 	 z-mýdel-n-ě-t 	 z-mýdeln-ět
změněném 	 z-měn-ěn-é-m 	 z-měn-ěn-ém
znalec 	 zn-a-l-ec 	 znal-ec
znali 	 zn-a-l-i 	 znal-i
znalých 	 zn-a-l-ých 	 znal-ých
znamenaly 	 znam-en-a-l-y 	 z-namen-a-l-y
znemravnit 	 z-ne-mrav-n-i-t 	 zne-mravni-t
znesnadňovat 	 z-ne-snad-ň-ova-t 	 znesnad-ňova-t
znesvětit 	 z-ne-svět-i-t 	 z-nesvět-i-t
zneužití 	 z-ne-u-ži-t-í 	 z-neužit-í
znešvařena 	 z-ne-švař-en-a 	 znešvařen-a
znešvařovat 	 z-ne-švař-ova-t 	 znešvař-ova-t
znovu 	 z-nov-u 	 znov-u
znovuoživenost 	 z-nov-u-o-živ-en-ost 	 z-nov-uo-živ-en-ost
znásilňovat 	 z-ná-sil-ň-ova-t 	 z-násil-ň-ova-t
znáte 	 zn-á-te 	 zná-te
zněkolikanásobit 	 z-ně-kolik-a-násob-i-t 	 zněkol-ika-n-ásobit
znět 	 zn-ě-t 	 zně-t
zobecnět 	 z-obec-n-ě-t 	 z-obecn-ě-t
zorat 	 z-or-a-t 	 zora-t
zorganizovaný 	 z-organ-iz-ova-n-ý 	 z-org-an-izovan-ý
zosobnit 	 z-osob-n-i-t 	 z-osobn-i-t
zostoudit 	 z-o-stoud-i-t 	 zostoud-i-t
zouvat 	 zou-v-a-t 	 zouv-a-t
zpatlat 	 z-patl-a-t 	 z-patla-t
zpevnět 	 z-pevn-ě-t 	 z-pevně-t
zplnomocňovat 	 z-pln-o-moc-ň-ova-t 	 z-pln-omocň-ova-t
zpohlavkovat 	 z-po-hlav-k-ova-t 	 z-pohlav-k-ova-t
zprostředkovatelské 	 z-pro-střed-k-ova-tel-sk-é 	 z-pro-střed-kova-telské
zprostředkuje 	 z-pro-střed-k-uje 	 z-prostřed-k-uje
zprůmyslnělost 	 z-prů-mysl-n-ě-l-ost 	 z-prů-myslněl-ost
zpuchlý 	 z-puch-l-ý 	 zpuchl-ý
zpustošit 	 z-pust-oš-i-t 	 z-pustoš-i-t
zpívá 	 z-pí-v-á 	 z-pív-á
zpět 	 zpět 	 zpě-t
zpěvačka 	 z-pě-v-a-č-k-a 	 z-pěv-ač-k-a
zpěčovat 	 zpěč-ova-t 	 z-pěč-ova-t
zrakový 	 zrak-ov-ý 	 z-rak-ov-ý
zrcadle 	 zrc-a-dl-e 	 zrcadl-e
zregenerovat 	 z-re-gener-ova-t 	 z-reg-enerova-t
zrentgenovat 	 z-rentgen-ova-t 	 z-rentgenova-t
zrušil 	 z-ruš-i-l 	 zruš-i-l
ztenčovat 	 z-ten-č-ova-t 	 z-tenč-ova-t
ztotožnit 	 z-to-tož-n-i-t 	 z-totož-n-i-t
ztotožňovat 	 z-to-tož-ň-ova-t 	 z-totož-ň-ova-t
ztropí 	 z-trop-í 	 ztrop-í
ztroskotat 	 z-trosk-ot-a-t 	 z-trosk-ota-t
ztrátou 	 z-trát-ou 	 ztrát-ou
zuhelnět 	 z-uhel-n-ě-t 	 z-uheln-ě-t
zutrhat 	 z-u-trh-a-t 	 zutrh-a-t
zvadaně 	 z-vad-a-n-ě 	 z-vad-an-ě
zveřejněné 	 z-veřej-n-ě-n-é 	 z-veř-ejněn-é
zveřejnění 	 z-veřej-n-ě-n-í 	 zveř-ej-něn-í
zviklat 	 z-vikl-a-t 	 zvikla-t
zvládnou 	 z-vlád-n-ou 	 zvlád-n-ou
zvláčet 	 z-vláč-e-t 	 zvláč-e-t
zvláště 	 zvláště 	 zvlášt-ě
zvlášť 	 zvlášť 	 zvláš-ť
zvolnit 	 z-vol-n-i-t 	 z-vol-ni-t
zvroucnit 	 z-vr-ou-c-n-i-t 	 z-vrouc-n-i-t
zvrátit 	 z-vrát-i-t 	 zvrát-i-t
zvídavější 	 z-víd-a-v-ějš-í 	 zvíd-av-ějš-í
zvýhodnění 	 z-vý-hod-n-ěn-í 	 z-výhod-něn-í
zvýhodňovat 	 z-vý-hod-ň-ova-t 	 z-výhod-ň-ova-t
zvýšil 	 z-výš-i-l 	 zvýš-i-l
zvěčnit 	 z-věč-n-i-t 	 zvěč-n-i-t
zádech 	 zád-e-ch 	 zádech
zády 	 zád-y 	 zády
zájemci 	 zá-jem-c-i 	 zá-jemc-i
základem 	 zá-klad-e-m 	 zá-klad-em
zákoníku 	 zá-kon-ík-u 	 zá-koník-u
zásobováním 	 zá-sob-ová-n-ím 	 zá-sob-ován-ím
zástupce 	 zá-stup-c-e 	 zá-stupce
zástěrce 	 zá-stěr-c-e 	 zá-stěrc-e
zátočiny 	 zá-toč-in-y 	 zá-toč-iny
závazným 	 zá-vaz-n-ým 	 zá-vazn-ým
závojnatkách 	 zá-voj-n-at-k-á-ch 	 zá-vojn-atk-ách
zúžit 	 z-úž-i-t 	 zúži-t
zčásti 	 z-část-i 	 z-čás-ti
zřetelně 	 zř-e-teln-ě 	 zře-teln-ě
zůstal 	 z-ů-sta-l 	 zůst-a-l
zůstalo 	 zů-sta-l-o 	 zůstal-o
zůstanou 	 z-ů-sta-n-ou 	 zůstan-ou
úchvatná 	 ú-chvat-n-á 	 úchvat-n-á
úcta 	 ú-ct-a 	 úcta
újezdě 	 ú-jezd-ě 	 újezd-ě
újmě 	 ú-jm-ě 	 újm-ě
úmysly 	 ú-mysl-y 	 úmys-l-y
úprava 	 ú-prav-a 	 úprav-a
úpravě 	 ú-prav-ě 	 úprav-ě
úrodnou 	 ú-rod-n-ou 	 ú-rod-nou
úspěchy 	 ú-spěch-y 	 úspěch-y
úspěšnou 	 ú-spěš-n-ou 	 ú-spěšn-ou
úspěšnější 	 ú-spěš-n-ějš-í 	 ú-spěšn-ějš-í
ústit 	 úst-i-t 	 ú-sti-t
útrpně 	 ú-trp-n-ě 	 útrp-n-ě
útulný 	 ú-tul-n-ý 	 útul-n-ý
úzká 	 úz-k-á 	 úzk-á
účasten 	 ú-čast-en 	 ú-časten
účastně 	 ú-čast-n-ě 	 ú-čas-tn-ě
účinky 	 ú-čin-k-y 	 účin-k-y
účinnosti 	 ú-čin-n-ost-i 	 účin-n-osti
účinností 	 ú-čin-n-ost-í 	 účin-n-ost-í
účtu 	 ú-čt-u 	 účt-u
účty 	 ú-čt-y 	 účt-y
úžasem 	 ú-žas-e-m 	 ú-žas-em
časy 	 čas-y 	 časy
čekají 	 ček-aj-í 	 čekaj-í
čekal 	 ček-a-l 	 čeka-l
čekalo 	 ček-a-l-o 	 čekal-o
čepice 	 čep-ic-e 	 čepic-e
čepici 	 čep-ic-i 	 čepic-i
černosrstý 	 čern-o-srst-ý 	 čern-osrst-ý
černým 	 čern-ý-m 	 čern-ým
černýšovice 	 čern-ýš-ov-ic-e 	 černýš-ovice
českomalínský 	 česk-o-malín-sk-ý 	 česk-omalínský
českou 	 čes-k-ou 	 česk-ou
českého 	 čes-k-é-ho 	 česk-ého
českém 	 čes-k-ém 	 česk-ém
českým 	 čes-k-ým 	 česk-ým
češtiny 	 češ-t-in-y 	 češtin-y
čilý 	 čil-ý 	 čilý
činila 	 čin-i-l-a 	 čini-l-a
činorodé 	 čin-o-rod-é 	 činorod-é
čintamani 	 čintaman-i 	 čintamani
čistokrevnou 	 čist-o-krev-n-ou 	 čistokrev-nou
čiřit 	 čiř-i-t 	 čiři-t
článkem 	 člán-k-e-m 	 člán-k-em
čsfr 	 č-s-f-r 	 čsfr
čsn 	 č-s-n 	 čsn
čssr 	 č-s-s-r 	 čssr
čtveračit 	 čtver-ač-i-t 	 čtver-ačit
čtvrt 	 čtvrt 	 čtvr-t
čtvrtletního 	 čtvrt-let-n-ího 	 čtvrtlet-n-ího
čtvrtletně 	 čtvrt-let-n-ě 	 čtvrtlet-n-ě
čtvrtletí 	 čtvrt-let-í 	 čtvrtl-et-í
čtěte 	 čt-ě-te 	 čtěte
čubička 	 čub-ič-k-a 	 čub-ičk-a
čubičku 	 čub-ič-k-u 	 čubičk-u
čzpi 	 č-z-p-i 	 čzpi
částice 	 část-ic-e 	 část-ice
částka 	 část-k-a 	 částk-a
částku 	 část-k-u 	 částk-u
čáča 	 čáč-a 	 čáča
číhal 	 číh-a-l 	 číha-l
čímkoliv 	 č-í-m-koliv 	 čímkoliv
ňákou 	 ňák-ou 	 ňákou
řadou 	 řad-ou 	 řadou
řepkového 	 řep-k-ov-ého 	 řepk-ov-ého
řezání 	 řez-á-n-í 	 řez-án-í
říjet 	 říj-e-t 	 říje-t
říkají 	 řík-aj-í 	 říkaj-í
řízen 	 říz-en 	 řízen
šedivý 	 šed-iv-ý 	 šediv-ý
šel 	 še-l 	 šel
šem 	 š-em 	 šem
šeptne 	 šept-ne 	 šeptne
šero 	 šer-o 	 šero
šestigólový 	 šest-i-gól-ov-ý 	 šestigólový
šibal 	 šib-a-l 	 šiba-l
šifrovaných 	 šifr-ova-n-ý-ch 	 šifr-ovan-ých
šikovně 	 šik-ov-n-ě 	 šikovn-ě
šimůnek 	 šimůn-ek 	 šimůnek
školák 	 škol-ák 	 školák
škudlit 	 škud-l-i-t 	 škudl-i-t
škvrně 	 škvr-n-ě 	 škvrn-ě
šmejkal 	 šmejkal 	 šmejka-l
šohajky 	 šohaj-k-y 	 šohajk-y
špekovávat 	 špek-ová-v-a-t 	 špek-ov-áva-t
špionáže 	 špion-áž-e 	 špionáže
špičatit 	 špič-at-i-t 	 špičat-i-t
šplouná 	 šplou-n-á 	 šploun-á
šumperka 	 šumperk-a 	 šumper-k-a
šíblová 	 šíbl-ová 	 šíbl-ov-á
šťastná 	 šťast-n-á 	 šťastn-á
žehravost 	 žehr-a-v-ost 	 žehrav-ost
železná 	 želez-n-á 	 železn-á
železárnách 	 želez-árn-ách 	 železárnách
ženatý 	 žen-at-ý 	 ženat-ý
žernově 	 žernov-ě 	 žern-ov-ě
žhavět 	 žh-av-ě-t 	 žhav-ě-t
živ 	 ži-v 	 živ
živelná 	 ži-v-el-n-á 	 živeln-á
živnostenského 	 ži-v-n-ost-ensk-ého 	 živ-nosten-sk-ého
životními 	 ži-v-ot-n-í-m-i 	 život-n-ími
životě 	 ži-v-ot-ě 	 život-ě
žižkovák 	 žižkov-ák 	 žižkovák
žlábkovávající 	 žláb-k-ová-v-aj-íc-í 	 žlábk-ová-v-aj-ící
župka 	 žup-k-a 	 župk-a
žáby 	 žáb-y 	 žáby
žádali 	 žád-a-l-i 	 žáda-l-i
žádné 	 žád-n-é 	 žádn-é
žádostmi 	 žád-ost-mi 	 žádostmi
žádoucí 	 žád-ou-c-í 	 žádouc-í
