abbé 	 abb-é 	 ab-b-é
absolventi 	 ab-solv-ent-i 	 absolvent-i
abychom 	 a-by-chom 	 abychom
achronisticky 	 a-chron-ist-ic-k-y 	 a-chro-n-ist-ic-k-y
adresátů 	 adres-át-ů 	 adre-sát-ů
advokát 	 advok-át 	 adv-ok-á-t
agnoston 	 agnoston 	 a-gnost-on
agovávat 	 agov-á-v-a-t 	 ag-ová-v-a-t
akcií 	 akci-í 	 akc-i-í
aktuálního 	 akt-uál-n-ího 	 akt-u-ál-n-ího
alfou 	 alf-ou 	 alfou
amerikanismem 	 amerik-an-ism-e-m 	 amerik-an-ism-em
američanům 	 američ-an-ům 	 amer-ič-an-ům
anglosaskou 	 angl-o-sas-k-ou 	 angl-o-sa-sk-ou
aniž 	 aniž 	 an-iž
antala 	 antal-a 	 ant-a-l-a
anthony 	 anthony 	 anthon-y
anticipovat 	 anti-cip-ova-t 	 ant-icip-ova-t
antidatujeme 	 anti-dat-uje-me 	 ant-id-at-uje-me
architektury 	 archi-tekt-ur-y 	 arch-i-t-ekt-ur-y
arcilotras 	 arci-lotr-as 	 arc-il-o-tras
argentiny 	 argentin-y 	 argent-in-y
aristokratismu 	 aristo-krat-ism-u 	 arist-o-krat-ism-u
asekurovat 	 a-sekur-ova-t 	 asekur-ova-t
atamanem 	 ataman-e-m 	 ataman-em
atlet 	 atlet 	 atl-e-t
automobilka 	 automobil-k-a 	 aut-o-mob-il-k-a
avšak 	 a-však 	 avšak
badenu 	 baden-u 	 bad-en-u
bakalářském 	 bakalář-sk-ém 	 bakal-ář-sk-ém
balených 	 bal-en-ých 	 balen-ých
bania 	 bani-a 	 ban-i-a
bankovním 	 bank-ovn-ím 	 bank-ov-n-ím
barikádovat 	 barik-ád-ova-t 	 barikád-ova-t
barona 	 baron-a 	 bar-on-a
bartoch 	 bartoch 	 bart-och
batňovic 	 batňovic 	 bat-ň-ov-ic
bekem 	 bekem 	 bek-em
benediktýnů 	 benedikt-ýn-ů 	 bene-diktýn-ů
berehovsky 	 bereh-ov-sk-y 	 berehov-sk-y
betlémské 	 betlém-sk-é 	 bet-l-ém-sk-é
bezesných 	 beze-sn-ých 	 beze-s-n-ých
blahopřejeme 	 blah-o-pře-je-me 	 blah-o-př-e-je-me
bludišti 	 blud-išt-i 	 blud-iš-t-i
bolení 	 bol-e-n-í 	 bol-en-í
božínku 	 bož-ín-k-u 	 božín-k-u
brečeli 	 breč-e-l-i 	 bre-č-e-l-i
brožura 	 brožur-a 	 brož-ur-a
brummellův 	 brummell-ův 	 brum-mell-ův
budoucnosti 	 bud-ou-c-n-ost-i 	 bud-ouc-n-ost-i
budoucím 	 bud-ouc-ím 	 bud-ouc-í-m
budova 	 bud-ova 	 bud-ov-a
bulletinu 	 bulletin-u 	 bullet-in-u
bych 	 by-ch 	 bych
bytu 	 by-t-u 	 byt-u
byznys 	 byznys 	 by-z-n-ys
bázlivá 	 bá-z-l-iv-á 	 báz-l-iv-á
běláskové 	 běl-ás-k-ové 	 bělás-k-ov-é
běžně 	 běž-ně 	 běž-n-ě
castrogiovanni 	 castrogiovanni 	 castrogi-ovan-n-i
celoživotní 	 cel-o-ži-v-ot-n-í 	 celož-i-v-ot-n-í
cenovky 	 cen-ovk-y 	 cen-ov-k-y
cephalocereus 	 cephalocereus 	 ceph-alocere-us
cestující 	 cest-uj-í-c-í 	 cest-uj-íc-í
chcete 	 chc-e-te 	 chce-te
chcíplá 	 chcíp-l-á 	 chcí-p-l-á
chovají 	 chov-aj-í 	 chovaj-í
chráněných 	 chrán-ěn-ých 	 chrá-n-ěn-ých
chvalořečit 	 chval-o-řeč-i-t 	 chval-oř-eč-i-t
chvilce 	 chvil-c-e 	 chv-il-c-e
chvástat 	 chvást-a-t 	 chvá-st-a-t
chvílích 	 chvíl-í-ch 	 chvíl-ích
cigarety 	 cigar-et-y 	 cigaret-y
cimrmanovština 	 cimrman-ov-št-in-a 	 cimrman-ovšt-in-a
colubrina 	 colubrin-a 	 colubr-in-a
cos 	 c-o-s 	 c-os
courama 	 cour-ama 	 cour-am-a
ctihodnými 	 ct-i-hod-n-ý-m-i 	 ct-i-hod-n-ými
cácorka 	 các-or-k-a 	 cácor-k-a
cílem 	 cíl-e-m 	 cíl-em
daklar 	 daklar 	 da-klar
daktyloskopie 	 daktylo-skopi-e 	 dakt-y-l-o-skop-i-e
dali 	 d-a-l-i 	 da-l-i
daly 	 d-a-l-y 	 da-l-y
dana 	 dan-a 	 da-n-a
danost 	 d-a-n-ost 	 da-n-ost
dané 	 d-a-n-é 	 da-n-é
delikátnostem 	 delikát-n-ost-e-m 	 delik-át-n-ost-em
dem 	 dem 	 d-em
demokratizovat 	 demo-krat-iz-ova-t 	 de-mo-krat-iz-ova-t
demoralizovat 	 de-moral-iz-ova-t 	 de-mor-al-iz-ova-t
desíti 	 desít-i 	 de-sí-t-i
devizové 	 deviz-ov-é 	 de-v-iz-ov-é
devět 	 devět 	 dev-ě-t
dezinfikovat 	 dez-infik-ova-t 	 dezin-fik-ova-t
dezinteresovat 	 dez-interes-ova-t 	 dezinteres-ova-t
dezorganizovat 	 dez-organ-iz-ova-t 	 de-zorgan-iz-ova-t
dešifrovat 	 de-šifr-ova-t 	 deši-fr-ova-t
diavolo 	 diavolo 	 diav-ol-o
diferovat 	 difer-ova-t 	 di-fer-ova-t
diplomové 	 diplom-ov-é 	 di-plom-ov-é
disciplíny 	 disciplín-y 	 dis-ci-p-lín-y
diskařský 	 disk-ař-sk-ý 	 dis-kař-sk-ý
distanční 	 dis-tanč-n-í 	 distanč-n-í
dkp 	 d-k-p 	 dk-p
dlouhodobého 	 dlouh-o-dob-ého 	 dlouhod-o-b-ého
dnešek 	 dneš-ek 	 dne-š-ek
dobra 	 dobr-a 	 do-br-a
dobrodiní 	 dobr-o-di-n-í 	 do-brod-in-í
dobrozdání 	 dobr-o-zd-á-n-í 	 do-broz-d-á-n-í
dobráka 	 dobr-ák-a 	 do-brák-a
dobytek 	 do-byt-ek 	 do-by-t-ek
dobytí 	 do-by-tí 	 do-by-t-í
docentů 	 docent-ů 	 do-cent-ů
dohromady 	 do-hromad-y 	 do-hro-mad-y
dokonaleji 	 do-kon-a-l-eji 	 do-kon-a-l-ej-i
dokonalého 	 do-kon-a-l-é-ho 	 do-kon-a-l-ého
dokončovat 	 do-konč-ova-t 	 do-kon-č-ova-t
doletovat 	 do-let-ova-t 	 dolet-ova-t
dolnolužický 	 doln-o-luž-ick-ý 	 dol-n-oluž-ic-k-ý
dopít 	 do-pí-t 	 do-p-í-t
dostaviti 	 do-stav-i-ti 	 do-stav-i-t-i
dotazníky 	 do-taz-ník-y 	 do-taz-n-ík-y
dovinout 	 do-vi-nou-t 	 dovi-nou-t
dovnitř 	 do-v-nitř 	 dov-n-itř
dozvíte 	 do-z-v-í-te 	 do-zv-í-te
dožebrat 	 do-žebr-a-t 	 do-že-br-a-t
drbaný 	 drb-a-n-ý 	 drba-n-ý
drožkář 	 drožk-ář 	 drož-k-ář
druhém 	 druh-é-m 	 druh-ém
dubnové 	 dubn-ov-é 	 dub-n-ov-é
durajková 	 durajk-ov-á 	 duraj-k-ov-á
dušiček 	 duš-iček 	 duš-ič-ek
dveřích 	 dveř-í-ch 	 dveř-ích
dvojnásobek 	 dv-oj-ná-sob-ek 	 dvoj-ná-sob-ek
dvouměsíční 	 dv-ou-měsíč-n-í 	 dv-ou-měs-íč-n-í
dynamická 	 dynam-ic-k-á 	 dy-nam-ic-k-á
dynamika 	 dynam-ik-a 	 dy-na-mik-a
dívají 	 dív-aj-í 	 dí-v-aj-í
dívám 	 dív-á-m 	 dí-v-á-m
díváš 	 dív-á-š 	 dí-v-á-š
dědečkův 	 děd-eč-k-ův 	 děd-e-č-k-ův
dělostřelec 	 děl-o-střel-ec 	 děl-o-stř-el-ec
děti 	 dět-i 	 dě-t-i
dětské 	 dět-sk-é 	 dě-t-sk-é
dřeně 	 dřen-ě 	 dř-e-n-ě
dřevěný 	 dřev-ě-n-ý 	 dře-v-ěn-ý
dřívějších 	 dřív-ějš-ích 	 dří-v-ěj-š-ích
důkladněji 	 dů-klad-n-ěji 	 dů-klad-n-ěj-i
efektů 	 efekt-ů 	 e-fekt-ů
ekologické 	 eko-log-ick-é 	 eko-log-ic-k-é
ekologického 	 eko-log-ick-ého 	 eko-log-ic-k-ého
ekonomech 	 eko-nom-ech 	 eko-n-om-ech
ekonomickou 	 eko-nom-ick-ou 	 eko-n-om-ic-k-ou
ekonomové 	 eko-nom-ov-é 	 eko-n-om-ov-é
empirických 	 empir-ic-k-ý-ch 	 empir-ic-k-ých
energie 	 energ-i-e 	 energ-ie
epocha 	 epoch-a 	 epo-ch-a
et 	 et 	 e-t
expansion 	 expansion 	 ex-pan-sion
experiment 	 experi-ment 	 experiment
experimentaci 	 experi-ment-ac-i 	 experiment-ac-i
faktorů 	 fakt-or-ů 	 faktor-ů
fanoušků 	 fan-oušk-ů 	 fa-noušk-ů
farmaceutické 	 farmac-eut-ick-é 	 farmaceut-ic-k-é
fastfood 	 fast-food 	 fast-f-ood
filiace 	 fili-ac-e 	 filiac-e
filozofické 	 filo-zof-ic-k-é 	 fil-o-zof-ic-k-é
finesami 	 fines-ami 	 fin-e-sami
finálním 	 fin-ál-n-ím 	 fin-ál-n-í-m
fondem 	 fondem 	 fond-em
formosu 	 formos-u 	 form-os-u
formát 	 form-át 	 form-á-t
fosforeskovat 	 fosfor-esk-ova-t 	 fos-fore-sk-ova-t
fošen 	 fošen 	 foš-en
franciska 	 francisk-a 	 fran-c-is-k-a
francisku 	 francisk-u 	 fran-c-isk-u
frotýrovat 	 frot-ýr-ova-t 	 frotýr-ova-t
fólie 	 fóli-e 	 fól-i-e
garance 	 garanc-e 	 garan-c-e
gastronomie 	 gastr-o-nom-i-e 	 gastro-n-om-i-e
generál 	 gener-ál 	 gener-á-l
gestikulovat 	 gestik-ul-ova-t 	 gest-ikul-ova-t
graessnerii 	 graessnerii 	 graess-ner-i-i
graessneriji 	 graessneriji 	 graess-nerij-i
haly 	 hal-y 	 ha-l-y
haló 	 haló 	 hal-ó
havarovat 	 havar-ova-t 	 ha-var-ova-t
hegelianism 	 hegelian-ism 	 hegelia-n-ism
hejkavec 	 hejkavec 	 hej-k-av-ec
hematologického 	 hemat-o-log-ick-ého 	 hemat-o-log-ic-k-ého
hergot 	 hergot 	 herg-ot
hmotného 	 hmot-n-é-ho 	 hmot-n-ého
hnedle 	 hned-le 	 hne-d-l-e
hnutí 	 h-nu-t-í 	 hnu-t-í
hnízdech 	 hnízd-e-ch 	 hnízd-ech
hochschule 	 hoch-schule 	 hochschul-e
hodinek 	 hodin-ek 	 hod-in-ek
hodinou 	 hodin-ou 	 hod-i-n-ou
hodnotíte 	 hodn-ot-í-te 	 hod-n-ot-í-te
holiči 	 hol-i-č-i 	 hol-ič-i
honkat 	 honk-a-t 	 hon-k-a-t
horolezci 	 hor-o-lez-c-i 	 horolez-c-i
horoucně 	 hor-ou-c-n-ě 	 horouc-n-ě
horálek 	 horálek 	 hor-ál-ek
hotovostí 	 hotov-ost-í 	 hot-o-v-ost-í
houževnatá 	 houžev-n-at-á 	 houže-v-n-a-t-á
hra 	 hr-a 	 hra
hroznou 	 hrozn-ou 	 hroz-n-ou
hudebníci 	 hud-eb-níc-i 	 hud-eb-n-íc-i
husími 	 hus-í-m-i 	 hus-í-mi
hřbitov 	 hřbitov 	 hřb-it-ov
hřebec 	 hřeb-ec 	 hře-b-ec
ian 	 ian 	 ia-n
idejí 	 idej-í 	 id-ej-í
imigraci 	 i-migr-ac-i 	 imi-grac-i
improvizovat 	 im-prov-iz-ova-t 	 im-pro-v-iz-ova-t
imunoenzymatický 	 imun-o-enzym-at-ick-ý 	 imun-oenzym-at-ic-k-ý
indikátorem 	 in-dik-át-or-em 	 in-dik-átor-em
inovace 	 inov-ace 	 in-ova-c-e
instalaci 	 in-stal-ac-i 	 in-st-a-lac-i
instrumentovat 	 instrument-ova-t 	 in-strument-ova-t
instrumentů 	 instru-ment-ů 	 in-strument-ů
intuice 	 intuic-e 	 int-u-ic-e
inzerátech 	 inzer-át-e-ch 	 inzerát-ech
irena 	 iren-a 	 ir-en-a
irkutsku 	 irkutsk-u 	 irkut-sk-u
ivančic 	 ivan-č-ic 	 i-van-č-ic
jablíčko 	 jablíč-k-o 	 jabl-íč-k-o
jakoby 	 jak-o-by 	 jak-ob-y
jakoupak 	 jak-ou-pak 	 jakoup-ak
jakého 	 jak-é-ho 	 jak-ého
jakéhokoliv 	 jak-é-ho-koliv 	 jak-ého-koliv
jakže 	 jak-že 	 jak-ž-e
jamese 	 james-e 	 ja-mes-e
janků 	 jan-k-ů 	 jank-ů
javelin 	 javelin 	 javel-in
jazejček 	 jazejč-ek 	 jaze-jč-ek
jediný 	 jedin-ý 	 jed-in-ý
jednak 	 jednak 	 jedn-a-k
jednatelem 	 jedn-a-tel-e-m 	 jedn-a-tel-em
jednom 	 jedn-o-m 	 jedn-om
jednomotorových 	 jedn-o-motor-ov-ých 	 jedn-o-m-otor-ov-ých
jednomu 	 jedn-o-mu 	 jedn-om-u
jednoosý 	 jedn-o-os-ý 	 jedn-o-osý
jedním 	 jedn-í-m 	 jedn-ím
jejích 	 je-j-í-ch 	 jej-ích
jenjen 	 jen-jen 	 jenjen
jenže 	 jen-že 	 jenž-e
jeseníkách 	 jesen-ík-ách 	 jese-n-ík-ách
jeskyni 	 jeskyn-i 	 jesk-y-n-i
jethro 	 jethro 	 jethr-o
ježibabo 	 ježibab-o 	 ježi-bab-o
jiker 	 jiker 	 jik-er
jimž 	 j-i-m-ž 	 jim-ž
jindy 	 jin-d-y 	 jind-y
jinonice 	 jinonic-e 	 jin-on-ic-e
jmenují 	 jmen-u-j-í 	 jmen-uj-í
joint 	 joint 	 join-t
jubilovat 	 jubil-ova-t 	 jub-il-ova-t
jupiterovy 	 jupiter-ov-y 	 jup-i-ter-ov-y
juránkův 	 jur-ánk-ův 	 jurán-k-ův
jídlo 	 jí-dl-o 	 jí-d-l-o
kalkulovat 	 kalk-ul-ova-t 	 kalkul-ova-t
kamera 	 kamera 	 kamer-a
kanada 	 kanad-a 	 kana-d-a
kapacity 	 kapacit-y 	 kapac-it-y
kapely 	 kapel-y 	 kap-el-y
kapesníček 	 kapes-níč-ek 	 kapes-n-íč-ek
kapitální 	 kapitál-n-í 	 kap-it-ál-n-í
kapitána 	 kapitán-a 	 kap-it-á-n-a
kapli 	 kapl-i 	 kap-l-i
kardašovy 	 kardašov-y 	 kardaš-ov-y
katalozích 	 kata-loz-ích 	 katal-oz-ích
kavalírem 	 kaval-ír-e-m 	 kaval-ír-em
kavkám 	 kav-k-ám 	 kav-k-á-m
každému 	 každ-é-mu 	 každ-ému
kdovíkdo 	 kd-o-v-í-kd-o 	 kd-ovíkd-o
kefurt 	 kefurt 	 kefur-t
kg 	 k-g 	 kg
klesne 	 kles-ne 	 kles-n-e
kliniky 	 klinik-y 	 klin-ik-y
kličku 	 klič-k-u 	 kl-ič-k-u
kličky 	 klič-k-y 	 kl-ič-k-y
klášterem 	 klášter-e-m 	 kláš-ter-em
knížete 	 kníž-et-e 	 kníž-e-te
kocouří 	 koc-ouř-í 	 kocouř-í
koho 	 k-o-ho 	 koho
kompetence 	 kompetenc-e 	 kompeten-c-e
kompetenci 	 kompet-enc-i 	 kompeten-c-i
komu 	 k-o-mu 	 komu
konceptem 	 koncept-em 	 kon-cept-em
koncert 	 koncert 	 kon-cert
koncertem 	 koncert-em 	 kon-cert-em
koncertní 	 koncert-n-í 	 kon-cert-n-í
koncertu 	 koncert-u 	 kon-cert-u
koncertě 	 koncert-ě 	 kon-cert-ě
koncertů 	 koncert-ů 	 kon-cert-ů
kondenzátor 	 kondenz-átor 	 konde-nzá-tor
konečná 	 koneč-n-á 	 kone-č-n-á
konferovat 	 konfer-ova-t 	 kon-fer-ova-t
koninou 	 kon-in-ou 	 kon-i-n-ou
konkrétního 	 konkrét-n-ího 	 kon-krét-n-ího
konkrétnímu 	 kon-krét-n-í-mu 	 kon-krét-n-ímu
kontaminovat 	 kon-tamin-ova-t 	 kont-amin-ova-t
kontilití 	 konti-li-t-í 	 kont-il-it-í
kontraindikace 	 kontra-in-dik-ac-e 	 kontrain-dik-ac-e
kontrolorů 	 kontrol-or-ů 	 kontrolor-ů
kontroloři 	 kontrol-oř-i 	 kontroloř-i
konvenovat 	 konven-ova-t 	 kon-ven-ova-t
konviktem 	 kon-vikt-e-m 	 kon-vikt-em
kopřivnická 	 kopřiv-n-ic-k-á 	 kopři-v-n-ic-k-á
korespondenčními 	 ko-re-spond-enč-n-ími 	 kore-spondenč-n-ími
korovatět 	 kor-ov-at-ě-t 	 kor-ovat-ě-t
kosmického 	 kosm-ic-k-é-ho 	 kosm-ic-k-ého
kostely 	 kostel-y 	 kost-el-y
kostýmy 	 kostým-y 	 kost-ým-y
koňských 	 koň-sk-ý-ch 	 koň-sk-ých
kožiše 	 kož-iš-e 	 kožiš-e
krakově 	 krakov-ě 	 krak-ov-ě
kristapána 	 krist-a-pán-a 	 kristap-á-n-a
krumlesco 	 krumlesco 	 krumles-c-o
krumlova 	 krumlov-a 	 kruml-ov-a
krytý 	 kry-t-ý 	 kryt-ý
krásným 	 krás-n-ý-m 	 krás-n-ým
krátkodobé 	 krát-k-o-dob-é 	 krát-k-od-ob-é
kráva 	 kráv-a 	 krá-v-a
kterého 	 kter-é-ho 	 kter-ého
kunovice 	 kun-ovic-e 	 kun-ov-ic-e
kupírovat 	 kupír-ova-t 	 kup-ír-ova-t
kyčel 	 kyčel 	 kyč-e-l
křestním 	 křest-n-í-m 	 křest-n-ím
křivkami 	 křiv-k-a-m-i 	 křiv-k-ami
křídlem 	 kří-dl-e-m 	 kří-dl-em
kůzlátek 	 kůzl-át-ek 	 kůzl-á-t-ek
lecčems 	 lec-č-e-m-s 	 lec-č-ems
lehkým 	 leh-k-ý-m 	 leh-k-ým
lesním 	 les-n-ím 	 les-n-í-m
letadel 	 let-a-del 	 letad-el
letouny 	 let-oun-y 	 letoun-y
lhostejnět 	 lhostej-n-ě-t 	 lhostejn-ě-t
lidem 	 lid-e-m 	 lid-em
ligni 	 ligni 	 lig-n-i
limit 	 limit 	 lim-i-t
londýně 	 londýn-ě 	 londý-n-ě
loupežníkem 	 loup-ež-n-ík-e-m 	 loup-ež-n-ík-em
ložnicový 	 lož-nic-ov-ý 	 lož-n-ic-ov-ý
ltd 	 l-t-d 	 ltd
luděk 	 luděk 	 lud-ěk
lukách 	 luk-á-ch 	 luk-ách
lumpačit 	 lump-ač-i-t 	 lumpač-i-t
lázní 	 lázn-í 	 láz-n-í
lékařem 	 lék-ař-e-m 	 lék-ař-em
lékem 	 lék-e-m 	 lék-em
lékárnám 	 lék-ár-n-ám 	 lékár-n-á-m
lístek 	 líst-ek 	 lís-t-ek
lístečcích 	 líst-ečc-ích 	 líst-eč-c-ích
lístku 	 líst-k-u 	 lís-t-k-u
lístky 	 líst-k-y 	 lís-t-k-y
lístků 	 líst-k-ů 	 lís-tk-ů
majíce 	 m-aj-íc-e 	 maj-íc-e
makrokonvertor 	 makro-kon-ver-t-or 	 makrokon-vert-or
malkovského 	 malkovsk-ého 	 malk-ov-sk-ého
mamlasovi 	 maml-as-ovi 	 mamlas-ovi
manager 	 manag-er 	 manager
manšestrovém 	 manšestr-ov-ém 	 manše-str-ov-ém
manšestrový 	 manšestr-ov-ý 	 manše-str-ov-ý
mariánských 	 mari-án-sk-ých 	 marián-sk-ých
marrackův 	 marrack-ův 	 marr-ac-k-ův
martina 	 martin-a 	 mart-in-a
materialisty 	 mater-i-al-ist-y 	 materi-al-ist-y
materiálové 	 materi-ál-ov-é 	 mater-i-ál-ov-é
mazání 	 maz-á-n-í 	 mazá-n-í
mašlí 	 mašl-í 	 maš-l-í
meduňka 	 meduňk-a 	 meduň-k-a
memnónovy 	 memnón-ov-y 	 memn-ón-ov-y
metafyzických 	 meta-fyz-ic-k-ý-ch 	 meta-fyz-ic-k-ých
metodologicky 	 metodo-log-ic-k-y 	 metod-o-log-ic-k-y
mezitím 	 mezi-t-ím 	 mezit-í-m
meziříčí 	 mezi-říč-í 	 meziř-íč-í
mezku 	 mezk-u 	 mez-k-u
mečení 	 meč-e-n-í 	 meč-en-í
mikroorganismy 	 mikro-organ-ism-y 	 mikro-organ-is-m-y
mil 	 mil 	 mi-l
miliarda 	 miliard-a 	 mil-iard-a
milionů 	 mili-on-ů 	 milion-ů
milostpane 	 mil-ost-pan-e 	 mil-ost-p-an-e
mimoškolními 	 mimo-škol-n-ími 	 mim-oškol-n-ími
minimem 	 minim-em 	 min-im-em
minimum 	 minim-um 	 min-im-um
ministerstva 	 minister-stv-a 	 min-is-ter-stv-a
ministři 	 ministř-i 	 min-istř-i
minulý 	 min-ul-ý 	 minu-l-ý
mjasisčev 	 mjasisčev 	 m-jas-is-č-ev
mladého 	 mlad-é-ho 	 mlad-ého
mlýna 	 ml-ýn-a 	 mlý-n-a
model 	 model 	 mode-l
moderního 	 modern-í-ho 	 moder-n-ího
mohutnět 	 moh-ut-n-ě-t 	 mohut-n-ě-t
mokro 	 mok-r-o 	 mo-kr-o
monopol 	 mono-pol 	 mono-p-ol
monopolu 	 mon-o-pol-u 	 mono-pol-u
more 	 more 	 mor-e
motivací 	 motiv-ac-í 	 mot-iv-a-c-í
motorlet 	 motor-let 	 motorl-e-t
motorletu 	 motor-let-u 	 motorlet-u
možnostech 	 možn-ost-ech 	 mož-n-ost-ech
mučírna 	 muč-írn-a 	 muč-ír-n-a
mužského 	 muž-sk-é-ho 	 muž-sk-ého
média 	 médi-a 	 méd-i-a
médií 	 médi-í 	 méd-i-í
mésti 	 mést-i 	 més-t-i
míli 	 míl-i 	 mí-l-i
míním 	 mín-í-m 	 mín-ím
mých 	 m-ý-ch 	 mých
měřítka 	 měř-í-tk-a 	 měř-í-t-k-a
měřítku 	 měř-í-tk-u 	 měř-í-t-k-u
mřížovec 	 mříž-ov-ec 	 mř-íž-ovec
nabitý 	 na-bi-t-ý 	 na-bit-ý
nabídla 	 na-bíd-l-a 	 na-bí-d-l-a
nacizovávatelnost 	 na-ciz-ová-v-a-teln-ost 	 na-c-iz-ová-v-a-teln-ost
nadcházející 	 nad-cház-ej-íc-í 	 nad-cház-e-j-íc-í
nadindividuálního 	 nad-in-divid-u-ál-n-í-ho 	 na-din-divid-u-ál-n-ího
nadklánět 	 nad-klán-ě-t 	 na-d-klán-ě-t
nadčlověctví 	 nad-člověc-tv-í 	 na-d-čl-ově-c-tv-í
nadějemi 	 na-děj-e-m-i 	 na-dě-j-emi
nadřaděného 	 nad-řad-ěn-é-ho 	 na-dřad-ě-n-ého
nadšení 	 na-dš-en-í 	 nadš-en-í
nadšením 	 na-dš-en-í-m 	 nadš-en-ím
najatí 	 na-j-a-t-í 	 na-j-at-í
nalopotit 	 na-lopot-i-t 	 na-lop-ot-i-t
namésti 	 na-mést-i 	 na-més-t-i
naprosto 	 na-prost-o 	 na-pro-st-o
naskicovat 	 na-skic-ova-t 	 na-sk-ic-ova-t
naspořit 	 na-spoř-i-t 	 na-s-poř-i-t
navnadit 	 na-vnad-i-t 	 na-v-nad-i-t
nařezávat 	 na-řez-á-v-a-t 	 na-ře-z-á-v-a-t
naříci 	 na-říc-i 	 na-ř-íc-i
neb 	 neb 	 ne-b
nebaleného 	 ne-bal-en-ého 	 ne-balen-ého
nebrání 	 ne-brán-í 	 ne-br-á-n-í
nechává 	 nech-á-v-á 	 ne-ch-á-v-á
nedaleko 	 ne-dal-ek-o 	 ne-d-alek-o
nedávna 	 ne-dávn-a 	 ne-d-á-v-n-a
negativními 	 negat-iv-n-ími 	 ne-gat-iv-n-ími
nehodlám 	 ne-hodl-á-m 	 ne-hod-l-á-m
nehty 	 neht-y 	 ne-ht-y
nejaktivnější 	 nej-akt-iv-n-ějš-í 	 ne-jakt-iv-n-ějš-í
nejcitlivějším 	 nej-cit-liv-ějš-ím 	 nej-cit-l-iv-ěj-š-í-m
nejdivočejší 	 nej-div-oč-ej-š-í 	 ne-j-d-iv-oč-ejš-í
nejdříve 	 nej-dřív-e 	 ne-jdř-í-v-e
nejkrásnějších 	 nej-krás-n-ěj-š-í-ch 	 ne-j-krás-n-ějš-ích
nejlahodnější 	 nej-lahod-n-ěj-š-í 	 ne-j-lahod-n-ějš-í
nejlíp 	 nej-líp 	 ne-j-líp
nejmenší 	 nej-men-š-í 	 ne-j-men-š-í
nejméně 	 nej-mén-ě 	 ne-j-mén-ě
nejpalčivější 	 nej-pal-č-iv-ěj-š-í 	 ne-j-pal-č-iv-ěj-š-í
nejpovolanějšímu 	 nej-po-vol-a-n-ějš-ímu 	 nej-po-vol-a-n-ěj-š-ímu
nejprve 	 nej-prv-e 	 ne-j-prv-e
nejsladšího 	 nej-slad-š-í-ho 	 ne-j-slad-š-ího
nejsladším 	 nej-slad-š-í-m 	 ne-j-slad-š-í-m
nejvzdálenější 	 nej-vz-dál-e-n-ěj-š-í 	 ne-j-vz-d-ál-e-n-ějš-í
nejvzácnější 	 nej-vzácn-ějš-í 	 nej-vzá-c-n-ějš-í
nejzřetelněji 	 nej-zř-e-tel-n-ěji 	 ne-j-zř-e-teln-ěj-i
nejčastějších 	 nej-čast-ěj-š-í-ch 	 ne-j-čast-ějš-ích
nejžha 	 nej-žh-a 	 ne-jžh-a
nekompetentní 	 ne-kompet-ent-n-í 	 ne-kompetent-n-í
nekrytý 	 ne-kry-t-ý 	 ne-kryt-ý
nekvete 	 ne-kvet-e 	 ne-kve-te
nemocenského 	 ne-moc-en-sk-ého 	 ne-mocen-sk-ého
nemálo 	 ne-mál-o 	 ne-má-l-o
nenech 	 ne-nech 	 ne-n-ech
neohrabané 	 ne-o-hrab-a-n-é 	 ne-o-hrab-an-é
nepodaří 	 ne-po-dař-í 	 ne-po-d-ař-í
nepolemizujme 	 ne-polem-iz-uj-me 	 ne-pol-em-iz-uj-me
nepotřebujete 	 ne-po-třeb-u-j-e-te 	 ne-po-třeb-uj-e-te
neprodělá 	 ne-pro-děl-á 	 ne-pro-dě-l-á
nepředepisují 	 ne-přede-pis-uj-í 	 ne-pře-de-pis-uj-í
nepřesných 	 ne-přesn-ých 	 ne-pře-sn-ých
neroztříštěná 	 ne-roz-tříšt-ěn-á 	 ne-roz-tříšt-ě-n-á
nervóznět 	 nerv-óz-n-ě-t 	 ne-rvóz-n-ě-t
nesena 	 nes-en-a 	 ne-se-n-a
neskromně 	 ne-s-krom-n-ě 	 ne-skrom-n-ě
nesnesitelna 	 ne-s-nes-i-teln-a 	 ne-s-ne-s-i-teln-a
netušícího 	 ne-tuš-íc-ího 	 ne-tuš-í-c-ího
neudělal 	 ne-u-děl-a-l 	 ne-ud-ě-l-a-l
neupije 	 ne-u-pi-je 	 ne-upi-j-e
nevrley 	 nevrley 	 ne-vrl-e-y
nezaměstnanosti 	 ne-za-měst-n-an-ost-i 	 ne-za-měst-n-a-n-ost-i
nezaoblená 	 ne-za-obl-en-á 	 ne-za-oblen-á
nezlob 	 ne-zlob 	 ne-zl-ob
neznámého 	 ne-zn-á-m-é-ho 	 ne-zn-á-m-ého
neztratitelnost 	 ne-z-trat-i-tel-n-ost 	 ne-z-trat-i-teln-ost
nezískáme 	 ne-získ-á-me 	 ne-zís-k-á-me
neštěstí 	 ne-štěst-í 	 ne-štěs-t-í
nijetzscheovi 	 nijetzsche-ovi 	 nij-etzsche-ovi
nimiž 	 n-imi-ž 	 nim-iž
nitěných 	 nit-ěn-ý-ch 	 nit-ěn-ých
norbert 	 norbert 	 norber-t
norem 	 norem 	 nor-em
normám 	 norm-ám 	 norm-á-m
nosatá 	 nos-at-á 	 nosat-á
nosem 	 nos-e-m 	 nos-em
novočerkasku 	 novočerkask-u 	 novo-čerkask-u
nula 	 nul-a 	 nu-l-a
nuly 	 nul-y 	 nu-l-y
nykláku 	 nyklák-u 	 ny-klák-u
nymburka 	 nymburk-a 	 nymbur-k-a
nábytek 	 ná-by-tek 	 ná-by-t-ek
náramného 	 ná-ram-n-é-ho 	 ná-ram-n-ého
nás 	 n-á-s 	 ná-s
návštěva 	 návštěv-a 	 ná-vště-v-a
návštěvnost 	 návštěv-n-ost 	 ná-vštěv-n-ost
návštěvnosti 	 návštěv-n-ost-i 	 ná-vštěv-n-ost-i
návštěvou 	 návštěv-ou 	 ná-vště-v-ou
nějakém 	 ně-jak-é-m 	 ně-jak-ém
něm 	 n-ě-m 	 n-ěm
oba 	 ob-a 	 o-b-a
obal 	 o-bal 	 o-ba-l
obchodníkův 	 ob-chod-ník-ův 	 ob-chod-n-ík-ův
obci 	 obc-i 	 ob-c-i
obcích 	 obc-ích 	 ob-c-ích
obemknout 	 obe-mk-nou-t 	 ob-e-mk-nou-t
obepnout 	 obe-pn-ou-t 	 obep-nou-t
obetkat 	 obe-tk-a-t 	 obe-t-k-a-t
obeznámit 	 obe-znám-i-t 	 obe-zn-ám-i-t
objektem 	 ob-jekt-e-m 	 ob-jekt-em
oblastech 	 oblast-ech 	 o-blast-ech
oblizovat 	 ob-liz-ova-t 	 obl-iz-ova-t
obnitkovat 	 ob-nit-k-ova-t 	 ob-n-i-t-k-ova-t
oborat 	 ob-or-a-t 	 o-bor-a-t
obouvatelný 	 ob-ouv-a-teln-ý 	 o-b-ouv-a-teln-ý
obrátek 	 ob-rát-ek 	 ob-rá-t-ek
obzvlášť 	 ob-zvlášť 	 ob-z-vlášť
občanského 	 obč-an-sk-ého 	 ob-čan-sk-ého
oběda 	 oběd-a 	 o-běd-a
oběsil 	 oběs-i-l 	 o-běs-i-l
obživit 	 ob-živ-i-t 	 ob-ži-v-i-t
oceli 	 ocel-i 	 o-cel-i
ochotna 	 ochot-n-a 	 o-chot-n-a
ochraně 	 o-chran-ě 	 o-chra-n-ě
octovat 	 oct-ova-t 	 o-ct-ova-t
odbytové 	 od-by-t-ov-é 	 od-byt-ov-é
oddanosti 	 od-d-a-n-ost-i 	 od-da-n-ost-i
oddati 	 od-d-a-ti 	 od-d-a-t-i
odevšad 	 ode-vš-ad 	 ode-všad
odečte 	 ode-čt-e 	 od-eč-te
odečtení 	 ode-čt-en-í 	 od-e-čt-en-í
odkývat 	 od-kýv-a-t 	 od-ký-v-a-t
odloupat 	 od-loup-a-t 	 o-d-loup-a-t
odloupávat 	 od-loup-á-v-a-t 	 o-d-loup-á-v-a-t
odloženou 	 od-lož-en-ou 	 od-lož-e-n-ou
odložení 	 od-lož-en-í 	 od-lož-e-n-í
odlévání 	 od-lév-á-n-í 	 od-lé-v-á-n-í
odmalička 	 od-mal-ičk-a 	 od-mal-ič-k-a
odmésti 	 od-mést-i 	 od-més-t-i
odpluje 	 od-plu-je 	 od-pluje
odrazuje 	 od-raz-uje 	 odraz-uje
odsouvací 	 od-souv-a-c-í 	 od-sou-v-a-c-í
odtrojmocnit 	 od-troj-moc-n-i-t 	 od-tro-j-moc-n-i-t
odříkat 	 od-řík-a-t 	 odřík-a-t
odřít 	 o-dř-í-t 	 odř-í-t
odžít 	 od-ží-t 	 od-ž-í-t
ohořelému 	 o-hoř-e-l-é-mu 	 o-hoř-e-l-ému
ohřebelcovat 	 o-hřeb-el-c-ova-t 	 o-hře-belc-ova-t
okamžitě 	 ok-a-mžit-ě 	 o-kamž-i-t-ě
okounět 	 okoun-ě-t 	 o-koun-ě-t
okozlit 	 o-koz-l-i-t 	 o-kozl-i-t
okresní 	 okres-n-í 	 o-kres-n-í
oktrojovat 	 oktroj-ova-t 	 o-ktroj-ova-t
olšanech 	 olšan-e-ch 	 olšan-ech
omegou 	 omeg-ou 	 o-megou
onen 	 on-en 	 onen
opancéřovat 	 o-pancéř-ova-t 	 o-pan-céř-ova-t
opačném 	 o-pač-n-é-m 	 o-pač-n-ém
opelichat 	 o-pelich-a-t 	 o-pel-ich-a-t
operacích 	 oper-ac-ích 	 o-per-ac-ích
oplésti 	 o-plést-i 	 o-plés-t-i
opouští 	 o-pouš-t-í 	 o-poušt-í
opovažuješ 	 o-po-važ-u-j-e-š 	 o-p-o-važ-uje-š
oranžista 	 oranž-ist-a 	 oranžist-a
orazítkovat 	 o-raz-í-tk-ova-t 	 o-raz-í-t-k-ova-t
orchestrem 	 orchestr-e-m 	 orchestr-em
organismus 	 organismus 	 organ-ism-us
organizují 	 organ-iz-u-j-í 	 organ-iz-uj-í
orlí 	 orl-í 	 or-l-í
oskar 	 oskar 	 o-skar
osmitisícový 	 osm-i-tisíc-ov-ý 	 o-sm-i-t-is-íc-ov-ý
osmnácté 	 osm-náct-é 	 o-sm-náct-é
osmou 	 osm-ou 	 o-sm-ou
ospalost 	 o-sp-a-l-ost 	 o-spa-l-ost
ostatních 	 o-stat-n-í-ch 	 o-stat-n-ích
ostravské 	 ostrav-sk-é 	 o-strav-sk-é
ostravy 	 ostrav-y 	 o-strav-y
ostřit 	 ostř-i-t 	 o-stř-i-t
osudem 	 o-sud-e-m 	 o-sud-em
osudně 	 osud-n-ě 	 o-sud-n-ě
osvobození 	 o-svoboz-en-í 	 o-svob-oz-e-n-í
osvědčovat 	 o-svědč-ova-t 	 o-s-věd-č-ova-t
osvědčují 	 o-s-věd-č-u-j-í 	 o-s-věd-č-uj-í
otevřena 	 ote-vř-en-a 	 ote-vř-e-n-a
otvírá 	 ot-vír-á 	 o-t-vír-á
oxfordského 	 oxford-sk-é-ho 	 oxford-sk-ého
oznobovat 	 o-znob-ova-t 	 o-zn-ob-ova-t
ozvalo 	 o-zv-a-l-o 	 o-z-va-l-o
ozřejmit 	 o-zřejm-i-t 	 o-zř-e-jm-i-t
očenichat 	 o-čenich-a-t 	 o-čen-ich-a-t
očima 	 oč-ima 	 o-č-i-m-a
očí 	 oč-í 	 o-č-í
očíslit 	 o-čísl-i-t 	 o-čís-l-i-t
ošukat 	 ošuk-a-t 	 o-šuk-a-t
ošvindlovat 	 o-švindl-ova-t 	 o-švin-dl-ova-t
paběrkovat 	 pa-běr-k-ova-t 	 paběr-k-ova-t
pacientovi 	 pac-i-ent-ovi 	 pacient-ovi
padesát 	 pa-desát 	 padesá-t
padesátku 	 pade-sát-k-u 	 padesát-k-u
palermě 	 palerm-ě 	 paler-m-ě
panáček 	 pan-áč-ek 	 pan-á-č-ek
parasoudně 	 para-soud-n-ě 	 parasoud-n-ě
pasírovat 	 pasír-ova-t 	 pas-ír-ova-t
patroni 	 patr-on-i 	 patron-i
pavel 	 pavel 	 pav-el
pavlačí 	 pavlač-í 	 pa-vlač-í
pavouček 	 pavouč-ek 	 pav-ouč-ek
paříž 	 paříž 	 pař-íž
pekárenských 	 pek-ár-en-sk-ých 	 pekár-en-sk-ých
peníz 	 peníz 	 pen-íz
perly 	 perl-y 	 per-l-y
perutková 	 perut-k-ov-á 	 perutk-ov-á
petrolejově 	 petrolej-ov-ě 	 petr-olej-ov-ě
petynce 	 pety-n-c-e 	 petyn-c-e
pečiva 	 peč-iv-a 	 peč-i-v-a
pfeffermann 	 pfeffer-mann 	 pfefferman-n
pil 	 pi-l 	 p-i-l
pilují 	 pil-u-j-í 	 pil-uj-í
pisklavě 	 pisk-l-av-ě 	 pis-klav-ě
pitomej 	 pitom-ej 	 pit-o-mej
planul 	 plan-u-l 	 pla-nu-l
plat 	 plat 	 pla-t
pleteného 	 plet-en-é-ho 	 plet-en-ého
plnění 	 pln-ěn-í 	 pln-ě-n-í
plodem 	 plod-e-m 	 plod-em
plují 	 plu-j-í 	 pluj-í
plánu 	 plán-u 	 plá-n-u
pobočkové 	 po-boč-k-ov-é 	 po-b-oč-k-ov-é
pobožnější 	 po-bož-n-ěj-š-í 	 po-bož-n-ějš-í
pochválena 	 po-chvál-en-a 	 po-chvál-e-n-a
podaří 	 po-dař-í 	 po-d-ař-í
podhrnout 	 pod-hrn-ou-t 	 pod-hr-nou-t
podivuhodné 	 po-div-u-hod-n-é 	 po-div-uhod-n-é
podlec 	 podl-ec 	 po-dlec
podlitina 	 pod-li-t-in-a 	 pod-lit-in-a
podléhat 	 pod-léh-a-t 	 po-d-léh-a-t
podnětu 	 pod-nět-u 	 pod-n-ět-u
podobného 	 po-dob-n-é-ho 	 po-dob-n-ého
podobě 	 po-dob-ě 	 po-d-ob-ě
podotkl 	 po-do-tk-l 	 pod-o-tk-l
podráždění 	 po-drážd-ěn-í 	 po-drážd-ě-n-í
podvésti 	 pod-vést-i 	 pod-vés-t-i
podívala 	 po-dív-a-l-a 	 po-dí-v-a-l-a
podívali 	 po-dív-a-l-i 	 po-d-í-v-a-l-i
podřazovat 	 pod-řaz-ova-t 	 po-dřaz-ova-t
podřeknout 	 pod-řek-nou-t 	 po-dřek-nou-t
pohaněné 	 po-han-ě-n-é 	 po-han-ěn-é
pohnutlivé 	 po-h-nu-t-l-i-v-é 	 po-hnut-l-iv-é
pohotovějším 	 po-hotov-ějš-ím 	 po-hot-ov-ěj-š-í-m
pojímá 	 po-jím-á 	 po-j-ím-á
pojímání 	 po-jím-á-n-í 	 po-j-ím-á-n-í
pojísti 	 po-jíst-i 	 po-jís-t-i
pokročilejším 	 po-kroč-i-l-ejš-ím 	 po-kroč-il-ejš-í-m
pokývat 	 po-kýv-a-t 	 po-ký-v-a-t
politických 	 polit-ic-k-ý-ch 	 polit-ic-k-ých
polyvalence 	 poly-valenc-e 	 po-ly-v-alen-c-e
poměrem 	 po-měr-e-m 	 po-měr-em
poobědvat 	 po-oběd-v-a-t 	 po-o-běd-v-a-t
popelnic 	 po-pel-nic 	 po-pel-n-ic
popkultura 	 pop-kult-ur-a 	 po-p-kult-ur-a
poplatník 	 po-plat-ník 	 po-plat-n-ík
poplatníka 	 po-plat-ník-a 	 po-plat-n-ík-a
poplatníky 	 po-plat-ník-y 	 po-plat-n-ík-y
poproduktivní 	 po-pro-duk-t-iv-n-í 	 po-pro-dukt-iv-n-í
poptávky 	 po-pt-á-v-k-y 	 po-ptá-v-k-y
porculánu 	 porculán-u 	 po-r-culá-n-u
porovnání 	 po-rovn-ání 	 po-rov-n-á-n-í
porůsti 	 po-růst-i 	 po-růs-t-i
posily 	 po-sil-y 	 po-si-l-y
posluchače 	 po-sluch-a-č-e 	 po-sluch-ač-e
posluchačů 	 po-sluch-a-č-ů 	 po-sluch-ač-ů
postih 	 po-stih 	 po-st-ih
potká 	 po-tk-á 	 po-t-k-á
potkáme 	 po-tk-á-me 	 po-t-k-á-me
potrefený 	 po-tref-en-ý 	 po-tre-fen-ý
potud 	 po-t-ud 	 po-tud
pouhém 	 pouh-é-m 	 pouh-ém
poupátko 	 poup-át-k-o 	 poupát-k-o
poučit 	 po-uč-i-t 	 pouč-i-t
použije 	 po-u-ži-je 	 po-uži-j-e
použito 	 po-u-ži-t-o 	 po-už-i-t-o
povečeřet 	 po-večeř-e-t 	 po-ve-čeř-e-t
povolaný 	 po-vol-an-ý 	 po-vol-a-n-ý
povyrůsti 	 po-vy-růst-i 	 po-vy-růs-t-i
povzbudivé 	 po-vz-bud-i-v-é 	 po-vz-bud-iv-é
povzbuzení 	 po-vz-buz-en-í 	 po-vz-buz-e-n-í
povznáší 	 po-vz-náš-í 	 po-vz-ná-š-í
povšimli 	 po-všim-l-i 	 po-vš-im-l-i
pozdní 	 pozd-n-í 	 po-zdn-í
pozitivně 	 pozit-iv-n-ě 	 po-zit-iv-n-ě
početí 	 po-č-e-t-í 	 po-čet-í
počkal 	 po-čk-a-l 	 po-č-k-a-l
počkám 	 po-čk-á-m 	 po-č-k-á-m
pošlete 	 po-šl-e-te 	 po-šle-te
poštu 	 pošt-u 	 po-št-u
pracovníka 	 prac-ov-ník-a 	 prac-ov-n-ík-a
pragokoncertu 	 prag-o-koncert-u 	 pragokon-cert-u
prajzler 	 prajzler 	 pra-j-zler
praktickým 	 prakt-ic-k-ý-m 	 prakt-ic-k-ým
praktikantům 	 prakt-ik-ant-ům 	 prakt-ikant-ům
pravidel 	 prav-i-del 	 prav-id-e-l
prchavý 	 prch-a-v-ý 	 prch-av-ý
prejudikovat 	 pre-ju-dik-ova-t 	 pre-judik-ova-t
premií 	 prem-i-í 	 pre-mi-í
press 	 press 	 pre-ss
previtský 	 previt-sk-ý 	 pre-vit-sk-ý
prezidentů 	 prezid-ent-ů 	 pre-zident-ů
princezna 	 princ-ez-n-a 	 princez-n-a
princmetálovou 	 princ-metál-ov-ou 	 prin-cmet-ál-ov-ou
princátky 	 princ-át-k-y 	 princát-k-y
prodejce 	 pro-d-ej-c-e 	 pro-dej-c-e
prodejna 	 pro-d-ej-n-a 	 pro-dej-n-a
prodejně 	 pro-d-ej-n-ě 	 pro-dej-n-ě
producent 	 pro-duc-ent 	 pro-ducent
profesora 	 pro-fes-or-a 	 pro-fesor-a
profesory 	 pro-fes-or-y 	 pro-fesor-y
projednáním 	 pro-jed-n-án-ím 	 pro-jedn-á-n-ím
projet 	 pro-je-t 	 pro-j-e-t
proklábosit 	 pro-klábos-i-t 	 pro-kláb-os-i-t
proklásti 	 pro-klást-i 	 pro-klás-t-i
prokormidlovavší 	 pro-kormidl-ova-vš-í 	 pro-korm-idl-ova-vš-í
prokrindapána 	 pro-krind-a-pán-a 	 pro-krindapá-n-a
promnout 	 pro-mn-ou-t 	 pro-m-nou-t
propagace 	 propag-ac-e 	 pro-pag-ac-e
prosciutto 	 prosciutt-o 	 pro-sciutt-o
prosimás 	 prosimás 	 pro-si-m-ás
prostou 	 prost-ou 	 pro-st-ou
prostějovsko 	 prostějov-sk-o 	 pro-stěj-ov-sk-o
prostějově 	 prostějov-ě 	 pro-stěj-ov-ě
protagorovi 	 protagor-ovi 	 pro-tagor-ovi
proteplit 	 pro-tep-l-i-t 	 pro-tepl-i-t
protiabcházský 	 proti-abcház-sk-ý 	 pro-tiabcház-sk-ý
protisluneční 	 proti-slun-eč-n-í 	 pro-ti-sluneč-n-í
protivit 	 protiv-i-t 	 pro-tiv-i-t
protokol 	 protokol 	 pro-t-okol
proužek 	 prouž-ek 	 pro-už-ek
provincií 	 provinc-i-í 	 pro-vin-c-i-í
pročež 	 pro-č-e-ž 	 pro-čež
pročpak 	 proč-pak 	 pro-č-pak
prošel 	 pro-še-l 	 pro-š-e-l
právem 	 práv-e-m 	 práv-em
prázdné 	 prázdn-é 	 prázd-n-é
psaním 	 ps-a-n-í-m 	 ps-a-n-ím
psychologistickou 	 psycho-log-ist-ic-k-ou 	 psych-o-log-ist-ic-k-ou
psům 	 ps-ů-m 	 ps-ům
ptejme 	 pt-ej-me 	 pte-j-me
purple 	 purple 	 pur-pl-e
pučálka 	 pučálk-a 	 pučál-k-a
pzt 	 p-z-t 	 pz-t
pán 	 pán 	 pá-n
pánové 	 pán-ové 	 pán-ov-é
pápěrka 	 pá-pěr-k-a 	 pápěr-k-a
pásci 	 pásc-i 	 pás-c-i
píti 	 pít-i 	 pí-t-i
pódiem 	 pódi-em 	 pód-i-em
pódiu 	 pódi-u 	 pód-i-u
pódium 	 pódi-um 	 pód-i-um
pěkné 	 pěkn-é 	 pěk-n-é
pěkném 	 pěkn-é-m 	 pěk-n-ém
pěst 	 pěst 	 pěs-t
pěstit 	 pěst-i-t 	 pěs-t-i-t
pětikorunovou 	 pět-i-korun-ov-ou 	 pět-ikorun-ov-ou
pětistovkou 	 pět-i-st-ovk-ou 	 pět-ist-ov-k-ou
pětník 	 pět-ník 	 pět-n-ík
předepsanou 	 přede-ps-a-n-ou 	 pře-de-ps-a-n-ou
předepíše 	 přede-píš-e 	 pře-de-píš-e
předložit 	 před-lož-i-t 	 pře-dlož-i-t
předlétnout 	 před-lét-nou-t 	 pře-dlét-nou-t
předměty 	 před-mět-y 	 pře-d-mět-y
předmětů 	 před-mět-ů 	 pře-d-mět-ů
předobjednávání 	 před-ob-jedn-á-v-á-n-í 	 pře-dob-jedn-á-v-á-n-í
předprodeje 	 před-pro-d-ej-e 	 pře-d-pro-de-j-e
předsedům 	 před-sed-ů-m 	 pře-d-sed-ům
představ 	 před-stav 	 pře-d-stav
představiteli 	 před-stav-i-tel-i 	 pře-d-stav-i-tel-i
představy 	 před-stav-y 	 pře-d-stav-y
předstihujícím 	 před-stih-uj-í-c-í-m 	 pře-d-stih-uj-íc-í-m
předvýrobní 	 před-vý-rob-n-í 	 pře-d-vý-rob-n-í
předvědecky 	 před-věd-ec-k-y 	 pře-d-věd-ec-k-y
předzpívat 	 před-zpí-v-a-t 	 pře-d-zp-í-v-a-t
předělati 	 pře-děl-a-ti 	 pře-děl-a-t-i
přejímce 	 pře-j-í-m-c-e 	 pře-jím-c-e
přemnohý 	 pře-mnoh-ý 	 pře-mn-oh-ý
přemýšlivější 	 pře-mýšl-iv-ějš-í 	 pře-mýš-l-iv-ěj-š-í
přepnout 	 pře-pn-ou-t 	 pře-p-nou-t
přeslabikovat 	 pře-slabik-ova-t 	 pře-slab-ik-ova-t
přesnost 	 přesn-ost 	 pře-sn-ost
přesností 	 přesn-ost-í 	 pře-sn-ost-í
přesný 	 přesn-ý 	 pře-sn-ý
přesnější 	 přesn-ěj-š-í 	 pře-sn-ějš-í
přesáhla 	 pře-sáh-l-a 	 pře-sá-h-l-a
přečin 	 pře-čin 	 pře-č-in
přečíslovat 	 pře-čísl-ova-t 	 pře-čí-sl-ova-t
přežití 	 pře-ži-t-í 	 pře-ž-i-t-í
přijmout 	 při-j-mou-t 	 při-jmou-t
přilepšit 	 při-lep-š-i-t 	 př-i-lep-š-i-t
přiláká 	 při-lák-á 	 př-i-lák-á
připadne 	 při-pad-ne 	 při-pad-n-e
připluje 	 při-plu-je 	 při-pluje
připomenout 	 při-po-men-ou-t 	 při-po-me-nou-t
přisvědčit 	 při-svědč-i-t 	 při-s-věd-č-i-t
přitiskne 	 při-tisk-ne 	 př-i-tisk-n-e
přitiskovat 	 při-tisk-ova-t 	 př-i-t-isk-ova-t
přiznej 	 při-zn-e-j 	 při-z-n-ej
přičinění 	 při-čin-ěn-í 	 při-čin-ě-n-í
přišinout 	 při-šin-ou-t 	 při-š-i-nou-t
přímé 	 přím-é 	 pří-m-é
přímém 	 přím-é-m 	 pří-m-ém
přísné 	 přísn-é 	 pří-sn-é
přísní 	 přísn-í 	 pří-s-n-í
přítomny 	 pří-t-o-m-n-y 	 pří-t-om-n-y
přítomném 	 pří-t-o-m-n-é-m 	 pří-t-om-n-ém
přítomnými 	 pří-t-o-m-n-ý-m-i 	 pří-t-om-n-ými
přízemí 	 pří-zem-í 	 pří-z-em-í
příštipkovat 	 pří-štip-k-ova-t 	 pří-š-t-ip-k-ova-t
příštího 	 příšt-í-ho 	 pří-š-t-ího
příštím 	 příšt-ím 	 pří-š-t-í-m
příště 	 příšt-ě 	 pří-št-ě
pšeničné 	 pšen-ič-n-é 	 pš-e-n-ič-n-é
pšenka 	 pšen-k-a 	 pš-e-n-k-a
půjčte 	 půjč-te 	 půj-č-te
půlsnímkovost 	 půl-s-ním-k-ov-ost 	 půl-s-n-ím-k-ov-ost
québec 	 québec 	 québ-ec
rachotit 	 rach-ot-i-t 	 rachot-i-t
racionalism 	 racion-al-ism 	 racio-n-a-l-ism
radomír 	 radomír 	 rad-omír
raději 	 rad-ěji 	 rad-ěj-i
rakousku 	 rakous-k-u 	 rakousk-u
rallye 	 rallye 	 rally-e
rameni 	 ram-en-i 	 ramen-i
raneček 	 raneč-ek 	 rane-č-ek
ravaissona 	 ravaisson-a 	 rav-aisson-a
razítky 	 raz-í-tk-y 	 raz-í-t-k-y
realizovat 	 real-iz-ova-t 	 re-al-iz-ova-t
redakční 	 redakč-n-í 	 re-dakč-n-í
referát 	 re-fer-át 	 re-fer-á-t
regentíkův 	 regent-ík-ův 	 re-gent-ík-ův
regulovat 	 regul-ova-t 	 re-gul-ova-t
regály 	 regál-y 	 re-gál-y
rejda 	 rejd-a 	 re-jd-a
rejstříku 	 rejstřík-u 	 re-j-střík-u
reklamace 	 reklam-ac-e 	 re-klam-ac-e
reklamu 	 reklam-u 	 re-klam-u
rekord 	 rekord 	 re-kord
relativita 	 rel-at-iv-it-a 	 relat-iv-it-a
relativizování 	 relat-iv-izová-n-í 	 relat-iv-iz-ová-n-í
repeal 	 repeal 	 re-pea-l
reportáž 	 re-port-áž 	 re-po-rt-áž
republikou 	 republik-ou 	 repu-bl-ik-ou
resp 	 resp 	 re-sp
revolucí 	 revol-uc-í 	 re-voluc-í
reálné 	 reál-n-é 	 re-ál-n-é
rider 	 rid-er 	 rider
rivalové 	 rival-ové 	 rival-ov-é
rolling 	 roll-ing 	 rollin-g
roxby 	 roxby 	 rox-b-y
rozchraptit 	 roz-chrap-t-i-t 	 roz-chrapt-i-t
rozdíly 	 roz-díl-y 	 roz-d-íl-y
rozhrnula 	 roz-hrn-u-l-a 	 roz-hr-n-u-l-a
rozkošným 	 roz-koš-n-ý-m 	 roz-koš-n-ým
rozkývat 	 roz-kýv-a-t 	 roz-ký-v-a-t
rozpočísti 	 roz-po-číst-i 	 roz-po-čís-t-i
roztávat 	 roz-tá-v-a-t 	 roz-t-á-v-a-t
rozumových 	 roz-um-ov-ý-ch 	 roz-um-ov-ých
rozutíkat 	 roz-utík-a-t 	 rozu-tík-a-t
rozuzlovat 	 roz-uzl-ova-t 	 roz-u-zl-ova-t
rozvinovat 	 roz-vi-n-ova-t 	 roz-vin-ova-t
rozvětvené 	 roz-větv-en-é 	 roz-vět-ven-é
rozčechrávat 	 roz-čechr-á-v-a-t 	 roz-čechrá-v-a-t
rozšít 	 roz-ší-t 	 roz-š-í-t
rozšíření 	 roz-šíř-en-í 	 roz-šíř-e-n-í
rozžhavil 	 roz-žh-av-i-l 	 roz-žhav-i-l
rupií 	 rupi-í 	 rup-i-í
ruské 	 rus-k-é 	 rusk-é
rusové 	 rus-ové 	 rus-ov-é
russel 	 russel 	 russe-l
rána 	 rán-a 	 rá-n-a
ráno 	 rán-o 	 rá-n-o
rázem 	 ráz-e-m 	 ráz-em
různými 	 různ-ý-m-i 	 různ-ými
samcoložník 	 samc-o-lož-n-ík 	 samc-olož-n-ík
samostatnější 	 sam-o-stat-n-ějš-í 	 sam-ostat-n-ěj-š-í
samozřejmá 	 sam-o-zř-ejm-á 	 sam-o-zř-e-jm-á
samsung 	 samsung 	 samsun-g
sazeb 	 saz-eb 	 saz-e-b
sbubnovat 	 s-bubn-ova-t 	 s-bub-n-ova-t
schodech 	 s-chod-e-ch 	 s-chod-ech
schovat 	 s-chov-a-t 	 s-ch-ova-t
scienza 	 scienza 	 s-cien-z-a
scorpions 	 scorpion-s 	 s-corp-ion-s
scéna 	 scén-a 	 s-cé-n-a
sebelepší 	 seb-e-lep-š-í 	 se-belep-š-í
sebeničením 	 s-eb-e-ni-č-en-í-m 	 se-b-en-ič-en-ím
sebevíce 	 seb-e-víc-e 	 se-b-e-v-íc-e
sedla 	 sed-l-a 	 se-d-l-a
sedláková 	 sedl-ák-ov-á 	 se-dl-ák-ov-á
sedmihradsku 	 sedmihradsk-u 	 sedmi-hrad-sk-u
sedmé 	 sedm-é 	 se-d-m-é
seger 	 seger 	 se-ger
seminární 	 semin-ár-n-í 	 se-min-ár-n-í
separátní 	 se-par-át-n-í 	 se-parát-n-í
sepnout 	 se-pn-ou-t 	 se-p-nou-t
sestává 	 se-stá-v-á 	 se-st-á-v-á
setkal 	 se-tk-a-l 	 se-t-k-a-l
seznámit 	 se-znám-i-t 	 se-zn-ám-i-t
seřizovat 	 se-řiz-ova-t 	 se-ř-iz-ova-t
silence 	 silence 	 silen-c-e
skončil 	 s-konč-i-l 	 s-kon-č-i-l
skončila 	 s-konč-i-l-a 	 s-kon-č-i-l-a
skončí 	 s-konč-í 	 s-kon-č-í
skrývala 	 s-krýv-a-l-a 	 s-krý-v-a-l-a
skutečnosti 	 s-kut-eč-n-ost-i 	 skuteč-n-ost-i
skutečném 	 s-kut-eč-n-é-m 	 skuteč-n-ém
slavnějším 	 slav-n-ěj-š-í-m 	 slav-n-ějš-í-m
slejvat 	 s-lej-v-a-t 	 slej-v-a-t
slev 	 s-lev 	 slev
slevu 	 s-lev-u 	 slev-u
slez 	 s-lez 	 slez
slovným 	 slov-n-ý-m 	 slov-n-ým
smaragdy 	 smaragd-y 	 s-maragd-y
smetanový 	 smetan-ov-ý 	 s-metan-ov-ý
smrtelném 	 s-mr-tel-n-é-m 	 s-mr-t-eln-ém
smrtelnému 	 s-mr-tel-n-é-mu 	 s-mr-t-eln-ému
smyslových 	 s-mysl-ov-ý-ch 	 s-mysl-ov-ých
smésti 	 s-mést-i 	 s-més-t-i
směl 	 smě-l 	 s-m-ě-l
směrem 	 s-měr-e-m 	 s-měr-em
směšný 	 směš-n-ý 	 s-měš-n-ý
snah 	 snah 	 s-nah
snahami 	 snah-a-m-i 	 sna-hami
sníh 	 sníh 	 s-n-íh
snů 	 sn-ů 	 s-n-ů
sobotu 	 sobot-u 	 sob-ot-u
sobě 	 s-ob-ě 	 sob-ě
socializovat 	 soci-al-iz-ova-t 	 so-ci-al-iz-ova-t
solarmax 	 solar-max 	 s-olarmax
solidních 	 solid-n-í-ch 	 solid-n-ích
sotva 	 sotva 	 so-tv-a
souboj 	 sou-boj 	 soub-oj
soukromník 	 sou-krom-ník 	 sou-krom-n-ík
sousedního 	 sou-sed-n-í-ho 	 sou-sed-n-ího
soustava 	 sou-stav-a 	 sou-sta-v-a
soutěž 	 sou-těž 	 sou-tě-ž
spadne 	 s-pad-ne 	 s-pad-n-e
spaly 	 sp-a-l-y 	 spa-l-y
species 	 species 	 spec-ie-s
specifickým 	 speci-fic-k-ý-m 	 speci-f-ic-k-ým
speciál 	 speci-ál 	 spec-i-á-l
spekulantem 	 spek-ul-ant-e-m 	 spekulant-em
spojkami 	 s-poj-k-a-m-i 	 s-poj-k-ami
spokojíte 	 s-pokoj-í-te 	 s-po-koj-í-te
společných 	 spol-eč-n-ých 	 s-pol-eč-n-ých
spolupodepsat 	 spol-u-pode-ps-a-t 	 spolu-p-ode-ps-a-t
spolupůsobit 	 spol-u-působ-i-t 	 spolupů-sob-i-t
spolutvořit 	 spol-u-tvoř-i-t 	 spolu-tvoř-i-t
sponzorsky 	 sponzor-sk-y 	 s-pon-z-or-sk-y
sportovní 	 sport-ov-n-í 	 s-port-ov-n-í
spotřebitel 	 s-po-třeb-i-tel 	 s-po-třeb-i-t-el
spravedlivost 	 s-prav-ed-l-iv-ost 	 s-praved-l-iv-ost
srna 	 srn-a 	 sr-n-a
srozumitelně 	 s-roz-um-i-teln-ě 	 s-roz-um-i-t-eln-ě
stabilní 	 stabil-n-í 	 stab-il-n-í
stadionu 	 stadion-u 	 stadio-n-u
stanoven 	 stanov-en 	 stan-ov-en
starobní 	 star-ob-n-í 	 starob-n-í
starožitných 	 star-o-ži-t-n-ých 	 starož-it-n-ých
starých 	 star-ý-ch 	 star-ých
stavení 	 sta-v-en-í 	 stav-en-í
stejkaně 	 s-tejk-a-n-ě 	 stej-k-a-n-ě
stejném 	 stej-n-é-m 	 stejn-ém
stipendium 	 stipendi-um 	 stip-endi-um
stojaté 	 stoj-at-é 	 stoj-a-t-é
stokorunovou 	 st-o-korun-ov-ou 	 sto-korun-ov-ou
století 	 st-o-let-í 	 stol-et-í
stones 	 stone-s 	 sto-ne-s
stornovat 	 storn-ova-t 	 stor-n-ova-t
stoupněte 	 stoup-ně-te 	 stoup-n-ě-te
stovkou 	 st-ovk-ou 	 st-ov-k-ou
stovku 	 st-ovk-u 	 st-ov-k-u
strahov 	 strahov 	 strah-ov
strahova 	 strahov-a 	 strah-ov-a
strahově 	 strahov-ě 	 strah-ov-ě
strava 	 s-trav-a 	 strav-a
strašnicích 	 strašnic-í-ch 	 straš-n-ic-ích
strnutí 	 s-trn-u-t-í 	 str-nu-t-í
strojírenské 	 stroj-íren-sk-é 	 stroj-ír-en-sk-é
studijní 	 stud-ij-n-í 	 studij-n-í
studijních 	 stud-ij-n-ích 	 studij-n-ích
studiích 	 stud-i-í-ch 	 stud-i-ích
stulit 	 s-tul-i-t 	 stul-i-t
stálý 	 stál-ý 	 stá-l-ý
stýkati 	 s-týk-a-ti 	 stýk-a-ti
stěžovatel 	 stěž-ova-tel 	 s-těž-ova-tel
střechách 	 střech-á-ch 	 střech-ách
střepávat 	 s-třep-á-v-a-t 	 střep-á-v-a-t
stříbrolesklého 	 stříbr-o-lesk-l-é-ho 	 stří-br-olesk-l-ého
střílí 	 stříl-í 	 stř-í-l-í
stůl 	 stůl 	 stů-l
sundavat 	 s-und-a-v-a-t 	 sund-a-v-a-t
superdobrý 	 super-dobr-ý 	 superd-obr-ý
supernova 	 super-nova 	 supern-ov-a
supraphon 	 supra-phon 	 su-praphon
svalnatý 	 sval-nat-ý 	 s-val-n-at-ý
svalovou 	 sval-ov-ou 	 s-val-ov-ou
svát 	 s-vá-t 	 svá-t
svídnici 	 svídnic-i 	 s-víd-n-ic-i
svědkové 	 s-věd-k-ové 	 s-věd-k-ov-é
světelné 	 svět-el-n-é 	 svě-t-eln-é
světelných 	 svět-el-n-ých 	 svě-t-eln-ých
systematický 	 system-at-ic-k-ý 	 syst-em-at-ic-k-ý
systémem 	 systém-e-m 	 syst-é-m-em
tajemství 	 taj-em-stv-í 	 tajemstv-í
takzvaném 	 tak-zv-a-n-é-m 	 tak-zv-a-n-ém
také 	 také 	 tak-é
takřečená 	 tak-řeč-en-á 	 takřeč-en-á
tati 	 tat-i 	 ta-t-i
technologického 	 techn-o-log-ick-ého 	 tech-n-o-log-ic-k-ého
telat 	 tel-at 	 tel-a-t
telefonního 	 tele-fon-n-í-ho 	 tele-fon-n-ího
televize 	 televize 	 telev-iz-e
temporalizovatelný 	 tempor-al-izova-teln-ý 	 tempor-al-iz-ova-teln-ý
tendenci 	 tend-enc-i 	 tend-en-c-i
tenhle 	 t-en-hle 	 tenhle
tenounkým 	 ten-oun-k-ý-m 	 tenoun-k-ým
tepichy 	 tepich-y 	 tep-ich-y
terminologii 	 termino-log-i-i 	 termin-o-log-i-i
tesklivých 	 tesk-l-iv-ý-ch 	 tesk-liv-ých
textil 	 textil 	 text-i-l
thajska 	 thaj-sk-a 	 thajsk-a
theodicée 	 theodicée 	 theod-ic-é-e
tikem 	 tik-e-m 	 tik-em
tips 	 tips 	 tip-s
tiskárnu 	 tisk-árn-u 	 tis-k-ár-n-u
tisovitý 	 tis-ovit-ý 	 tis-ov-it-ý
tkalcovnictví 	 tka-lc-ovnic-tv-í 	 t-kalc-ov-n-ic-tv-í
tlapkách 	 tlap-k-á-ch 	 tlap-k-ách
tomáš 	 tomáš 	 to-má-š
tops 	 tops 	 top-s
totožný 	 totožn-ý 	 to-tož-n-ý
tou 	 t-ou 	 tou
traktorů 	 traktor-ů 	 trakt-or-ů
treperendo 	 treper-end-o 	 treperend-o
trní 	 trn-í 	 tr-n-í
trojí 	 tr-oj-í 	 troj-í
tropickém 	 trop-ick-ém 	 trop-ic-k-ém
trutnovský 	 trutnov-sk-ý 	 trut-n-ov-sk-ý
turbodmychadlo 	 turbo-dmych-adl-o 	 turbod-mychadl-o
turbovrtulových 	 turbo-vrt-ul-ov-ých 	 turb-ovrtul-ov-ých
turci 	 turc-i 	 tur-c-i
turecký 	 turec-k-ý 	 tur-e-c-k-ý
turek 	 turek 	 tur-ek
turné 	 turné 	 tur-n-é
tušící 	 tuš-íc-í 	 tuš-í-c-í
tvrzeními 	 tvrz-en-í-m-i 	 tvrz-e-n-ími
tzv 	 t-z-v 	 tzv
téhož 	 t-é-ho-ž 	 t-éhož
tématu 	 tém-at-u 	 témat-u
tímhle 	 t-í-m-hle 	 t-ímhle
týdeníku 	 týden-ík-u 	 týd-e-n-ík-u
těhotenství 	 těhoten-ství 	 těhoten-stv-í
tělo 	 těl-o 	 t-ě-l-o
těmi 	 t-ě-m-i 	 t-ěmi
třemi 	 tř-e-m-i 	 tř-emi
třesoucí 	 třes-ou-c-í 	 třesou-c-í
třiceti 	 tř-i-cet-i 	 tř-icet-i
třineckých 	 třinec-k-ých 	 tř-in-ec-k-ých
třísla 	 třís-l-a 	 tří-s-l-a
udýchanej 	 u-dých-a-n-ej 	 u-dýcha-n-ej
uhlí 	 uhl-í 	 u-hl-í
ukazuju 	 u-kaz-u-j-u 	 u-kaz-uj-u
ukrutným 	 u-krut-n-ý-m 	 u-krut-n-ým
ulici 	 ul-ic-i 	 u-lic-i
uloženými 	 u-lož-en-ý-m-i 	 u-lož-en-ými
umožnilo 	 u-možn-i-l-o 	 u-mož-n-i-l-o
umožnily 	 u-možn-i-l-y 	 u-mož-n-i-l-y
umělkovat 	 um-ě-l-k-ova-t 	 u-mě-l-k-ova-t
umělostech 	 u-m-ě-l-ost-e-ch 	 u-mě-l-ost-ech
unese 	 u-nes-e 	 u-ne-s-e
unikát 	 unik-át 	 u-nik-á-t
univerzitního 	 uni-verz-it-n-ího 	 u-niverz-it-n-ího
upozorňujeme 	 u-po-zor-ň-uje-me 	 u-po-zorň-uje-me
upíchat 	 u-pích-a-t 	 u-p-ích-a-t
urgenci 	 urg-enc-i 	 u-rgenc-i
urgencích 	 urgenc-ích 	 u-rgenc-ích
urgovat 	 urg-ova-t 	 u-rg-ova-t
uriah 	 uriah 	 u-riah
urozená 	 u-roz-en-á 	 u-roz-e-n-á
určenou 	 u-rč-en-ou 	 u-rč-e-n-ou
určitě 	 urč-it-ě 	 u-rč-it-ě
uschovávat 	 u-s-chov-á-v-a-t 	 u-s-ch-ov-á-v-a-t
usd 	 u-s-d 	 u-sd
usedavě 	 u-sed-a-v-ě 	 u-sed-av-ě
usilovně 	 u-sil-ov-n-ě 	 u-s-il-ov-n-ě
uskutečnily 	 u-s-kut-eč-n-i-l-y 	 u-skuteč-n-i-l-y
ustanoveními 	 u-stanov-en-ími 	 u-stan-ov-e-n-ími
ustrnule 	 u-s-trn-u-l-e 	 u-str-nu-l-e
usvědčit 	 u-svědč-i-t 	 u-s-věd-č-i-t
uvedenou 	 u-ved-en-ou 	 u-ved-e-n-ou
uzpůsobit 	 u-z-působ-i-t 	 u-z-pů-sob-i-t
učitel 	 uč-i-tel 	 u-č-i-t-el
učitelů 	 uč-i-tel-ů 	 u-č-i-tel-ů
uším 	 uš-ím 	 u-š-í-m
užitečné 	 u-žit-eč-n-é 	 u-ži-t-eč-n-é
uživit 	 u-živ-i-t 	 u-ži-v-i-t
vajnar 	 vajnar 	 vaj-nar
vakuářskost 	 vaku-ář-sk-ost 	 vakuář-sk-ost
vaně 	 van-ě 	 va-n-ě
vatikánský 	 vatikán-sk-ý 	 vat-ik-án-sk-ý
vdechnout 	 v-dech-nou-t 	 vdech-nou-t
velkého 	 vel-k-é-ho 	 vel-k-ého
velvyslanectví 	 vel-vy-sl-a-n-ec-tv-í 	 velvy-sla-ne-c-tv-í
venkovan 	 ven-k-ov-an 	 ven-k-ova-n
ventures 	 venture-s 	 vent-ures
venčit 	 ven-č-i-t 	 venč-i-t
veslař 	 vesl-ař 	 ve-sl-ař
vesnici 	 ves-nic-i 	 ves-n-ic-i
vespolek 	 ve-s-pol-ek 	 ve-spol-ek
vetkat 	 ve-tk-a-t 	 ve-t-k-a-t
vetkávat 	 ve-tk-á-v-a-t 	 vet-k-á-v-a-t
vezmeš 	 vez-m-e-š 	 vez-meš
veřejně 	 veř-ej-n-ě 	 veřej-n-ě
veškerým 	 veš-k-er-ý-m 	 veš-k-er-ým
vidimovat 	 vidim-ova-t 	 vid-im-ova-t
vinohradského 	 vinohrad-sk-é-ho 	 vin-o-hrad-sk-ého
virile 	 virile 	 vir-il-e
vlastního 	 vlast-n-í-ho 	 vlast-n-ího
vlepovat 	 v-lep-ova-t 	 vlep-ova-t
vložit 	 v-lož-i-t 	 vlož-i-t
vložkovací 	 v-lož-k-ova-c-í 	 vlož-k-ova-c-í
vloží 	 v-lož-í 	 vlož-í
vlézt 	 v-léz-t 	 vléz-t
vlítat 	 v-lít-a-t 	 vlít-a-t
vnitřnostech 	 v-nitř-n-ost-e-ch 	 v-nitř-n-ost-ech
vnímat 	 v-ním-a-t 	 v-n-ím-a-t
vobléknutelný 	 v-ob-lék-nu-teln-ý 	 vob-lék-nu-teln-ý
vodolově 	 vodolov-ě 	 vod-ol-ov-ě
vodotiskem 	 vod-o-tisk-em 	 vod-o-t-isk-em
vozidly 	 voz-i-dl-y 	 voz-i-d-l-y
vpít 	 v-pí-t 	 v-p-í-t
vraštět 	 vraš-t-ě-t 	 vrašt-ě-t
vrcholu 	 vrch-ol-u 	 vrchol-u
vrtulníky 	 vrt-ul-ník-y 	 vrt-ul-n-ík-y
vrátnice 	 vrát-nic-e 	 vrát-n-ic-e
vstupenek 	 vs-tup-en-ek 	 v-stup-en-ek
vstupenka 	 v-stup-enk-a 	 v-stup-en-k-a
vstupenku 	 v-stup-enk-u 	 v-stup-en-k-u
vstupenky 	 vstup-enk-y 	 v-stup-en-k-y
vstupného 	 v-stup-n-ého 	 v-stup-n-é-ho
vychovat 	 vy-chov-a-t 	 vy-ch-ova-t
vycházejí 	 vy-cház-ej-í 	 vy-cház-e-j-í
vydávit 	 vy-dáv-i-t 	 vy-d-áv-i-t
vykramařit 	 vy-kram-ař-i-t 	 vy-kramař-i-t
vymáčkl 	 vy-máčk-l 	 vy-máč-k-l
vymáčknout 	 vy-máčk-nou-t 	 vy-máč-k-nou-t
vynaložením 	 vy-na-lož-en-í-m 	 vy-na-lož-e-n-ím
vynesla 	 vy-nes-l-a 	 vy-ne-s-l-a
vypancéřovat 	 vy-pancéř-ova-t 	 vy-pan-céř-ova-t
vypejkání 	 vy-pejk-á-n-í 	 vy-pej-k-á-n-í
vyplaněný 	 vy-plan-ě-n-ý 	 vy-plan-ěn-ý
vypočísti 	 vy-po-číst-i 	 vy-po-čís-t-i
vyprávěli 	 vy-práv-ě-l-i 	 vy-prá-v-ě-l-i
vysidlovat 	 vy-sidl-ova-t 	 vy-si-dl-ova-t
vyslyšeti 	 vy-slyš-e-ti 	 vy-slyš-e-t-i
vysmrádnout 	 vy-smrád-nou-t 	 vy-s-mrád-nou-t
vysokoškolské 	 vys-ok-o-škol-sk-é 	 vy-s-o-k-oškol-sk-é
vysokoškolský 	 vys-ok-o-škol-sk-ý 	 vy-s-o-k-oškol-sk-ý
vysoká 	 vys-ok-á 	 vy-s-ok-á
vysokém 	 vys-ok-ém 	 vy-s-ok-ém
vyspinkat 	 vy-sp-ink-a-t 	 vy-sp-in-k-a-t
vyspělým 	 vy-spě-l-ým 	 vy-sp-ě-l-ým
vysílací 	 vy-síl-a-c-í 	 vy-síl-ac-í
vytištěny 	 vy-tišt-ěn-y 	 vy-t-išt-ěn-y
vytvořeno 	 vy-tvoř-en-o 	 vy-tvoř-e-n-o
vyzpytovat 	 vy-z-pyt-ova-t 	 vy-zpyt-ova-t
vyčísti 	 vy-číst-i 	 vy-čís-t-i
vyřinout 	 vy-řin-ou-t 	 vy-ř-i-nou-t
vyžadonit 	 vy-žad-on-i-t 	 vy-žadon-i-t
vyžle 	 vyžle 	 vy-žl-e
vzdělání 	 vz-děl-án-í 	 vz-děl-á-n-í
vzlínat 	 vz-lín-a-t 	 vzlín-a-t
vzlítnout 	 vz-lít-nou-t 	 vzlít-nou-t
vznikají 	 vz-nik-aj-í 	 vz-n-ik-aj-í
vzniku 	 vz-nik-u 	 vz-n-ik-u
vzniká 	 vz-nik-á 	 vz-n-ik-á
vzájemná 	 v-zá-jem-n-á 	 vzá-jem-n-á
válka 	 válk-a 	 vál-k-a
vás 	 v-á-s 	 vás
víte 	 v-í-te 	 ví-te
vítkovického 	 vítk-ovic-k-ého 	 vít-k-ov-ic-k-ého
vítkovickém 	 vítk-ovic-k-ém 	 vít-k-ov-ic-k-ém
vítězství 	 vítěz-ství 	 vít-ěz-stv-í
vítězům 	 vítěz-ům 	 vít-ěz-ům
výluka 	 vý-luk-a 	 výluk-a
výpotek 	 vý-pot-ek 	 vý-po-t-ek
výsostným 	 výs-ost-n-ý-m 	 vý-sost-n-ým
výčitek 	 vý-čit-e-k 	 vý-č-i-t-ek
větrovka 	 větr-ovk-a 	 větr-ov-k-a
všeobecně 	 vš-e-obec-n-ě 	 vš-e-ob-ec-n-ě
vševědova 	 vševěd-ov-a 	 vše-věd-ov-a
všoupnout 	 v-šoup-nou-t 	 všoup-nou-t
vštípit 	 v-štíp-i-t 	 vštíp-i-t
vštěpuji 	 v-štěp-uj-i 	 vštěp-uj-i
vůní 	 vůn-í 	 vů-n-í
westermannem 	 westermann-e-m 	 westerman-n-em
whitney 	 whitney 	 whit-ne-y
yse 	 y-s-e 	 ys-e
zabijeme 	 za-bi-je-me 	 za-bij-e-me
zachovávat 	 za-chov-á-v-a-t 	 za-ch-ov-á-v-a-t
zachrániti 	 za-chrán-i-ti 	 za-chrán-i-t-i
zacinkat 	 za-cink-a-t 	 za-cin-k-a-t
zadek 	 zad-ek 	 za-dek
zafilosofovat 	 za-filo-sof-ova-t 	 za-fil-osof-ova-t
zahanbit 	 za-han-b-i-t 	 za-hanb-i-t
zahozených 	 za-hoz-en-ý-ch 	 za-hoz-e-n-ých
zahrnutí 	 za-hr-nu-t-í 	 za-hrnu-t-í
zahynul 	 za-hyn-u-l 	 za-hy-nu-l
zainteresované 	 za-interes-ova-n-é 	 za-in-teres-ova-n-é
zajatec 	 za-j-at-ec 	 za-j-a-t-ec
zakončovat 	 za-konč-ova-t 	 za-kon-č-ova-t
zakusitelno 	 za-kus-i-tel-n-o 	 za-kus-i-t-eln-o
zakývala 	 za-kýv-a-l-a 	 za-ký-v-a-l-a
zakývat 	 za-kýv-a-t 	 za-ký-v-a-t
zalil 	 za-li-l 	 za-l-i-l
zaměstnancům 	 za-měst-n-an-c-ům 	 za-měst-n-anc-ům
zapomínat 	 za-pomín-a-t 	 za-po-mín-a-t
započísti 	 za-po-číst-i 	 za-po-čís-t-i
zapříčiněné 	 za-pří-čin-ěn-é 	 za-př-í-č-in-ěn-é
zareagovat 	 za-re-ag-ova-t 	 za-reag-ova-t
zasahují 	 za-sah-u-j-í 	 za-sah-uj-í
zaslíbeni 	 za-s-líb-en-i 	 za-slíb-en-i
zasnoubil 	 za-snoub-i-l 	 za-s-noub-i-l
zastřelili 	 za-střel-i-l-i 	 za-stř-el-i-l-i
zatvrzují 	 za-tvrz-u-j-í 	 za-tvrz-uj-í
zaujatý 	 z-au-j-a-t-ý 	 za-uj-a-t-ý
zaujmouti 	 zau-jm-ou-ti 	 za-u-j-mout-i
zazátkovat 	 za-zá-tk-ova-t 	 za-zá-t-k-ova-t
začne 	 za-č-ne 	 za-č-n-e
začínají 	 za-čín-aj-í 	 za-č-ín-aj-í
zařizovatel 	 za-řiz-ova-tel 	 za-ř-iz-ova-tel
zařízením 	 za-říz-en-ím 	 za-říz-e-n-ím
zdaleka 	 z-dal-ek-a 	 z-dalek-a
zdeničky 	 zden-ič-k-y 	 z-den-ič-k-y
zdeněk 	 zdeněk 	 z-d-en-ěk
zdi 	 zd-i 	 z-d-i
zdokonalit 	 z-do-kon-a-l-i-t 	 z-do-kon-al-i-t
zemana 	 zeman-a 	 ze-ma-n-a
zemím 	 zem-ím 	 ze-m-í-m
zemědělské 	 zem-ě-děl-sk-é 	 ze-měd-ě-l-sk-é
zemědělských 	 zem-ě-děl-sk-ých 	 ze-měd-ě-l-sk-ých
zheroizovavší 	 z-hero-izova-vš-í 	 z-hero-iz-ova-vš-í
zhypnotizovat 	 z-hypn-ot-iz-ova-t 	 z-hyp-n-ot-iz-ova-t
zinventovat 	 z-invent-ova-t 	 z-in-vent-ova-t
zjednodušení 	 z-jedn-o-duš-en-í 	 z-jedn-o-duš-e-n-í
zkušeností 	 z-kuš-en-ost-í 	 z-kuš-e-n-ost-í
zkypřovat 	 z-kypř-ova-t 	 z-kypř-o-va-t
zloděj 	 zl-o-děj 	 zl-od-ěj
zlodějsku 	 zl-o-děj-sk-u 	 zl-od-ě-j-sk-u
zločinem 	 zl-o-čin-e-m 	 z-lo-č-in-em
zlákat 	 z-lák-a-t 	 zlák-a-t
zlí 	 zl-í 	 z-l-í
zmoralizování 	 z-moral-iz-ová-n-í 	 z-mor-al-iz-ová-n-í
zmultiplicírovaný 	 z-multi-plic-ír-ova-n-ý 	 z-mult-i-p-lic-ír-ova-n-ý
změněném 	 z-měn-ěn-é-m 	 z-měn-ěn-ém
znalec 	 zn-a-l-ec 	 z-n-a-l-ec
znali 	 zn-a-l-i 	 z-n-a-l-i
znalých 	 zn-a-l-ých 	 z-n-a-lých
znamenaly 	 znam-en-a-l-y 	 z-nam-en-a-l-y
zneužití 	 z-ne-u-ži-t-í 	 z-ne-u-ž-i-t-í
znešvařena 	 z-ne-švař-en-a 	 z-ne-š-vař-e-n-a
znešvařovat 	 z-ne-švař-ova-t 	 z-ne-š-vař-ova-t
znovuoživenost 	 z-nov-u-o-živ-en-ost 	 z-nov-uoži-v-en-ost
známku 	 znám-k-u 	 zná-m-k-u
znásilňovat 	 z-ná-sil-ň-ova-t 	 z-ná-s-il-ň-ova-t
znásobit 	 z-násob-i-t 	 z-ná-sob-i-t
znásobovaný 	 z-násob-ova-n-ý 	 z-ná-sob-ova-n-ý
znáte 	 zn-á-te 	 z-n-á-te
znět 	 zn-ě-t 	 z-n-ě-t
zosobnit 	 z-osob-n-i-t 	 z-o-sob-n-i-t
zouvat 	 zou-v-a-t 	 zouv-a-t
zpevnět 	 z-pevn-ě-t 	 z-pev-n-ě-t
zpocený 	 z-poc-en-ý 	 z-po-cen-ý
zpustošit 	 z-pust-oš-i-t 	 z-pustoš-i-t
zpět 	 zpět 	 zp-ě-t
zpěvačka 	 z-pě-v-a-č-k-a 	 z-pě-v-ač-k-a
zpěčovat 	 zpěč-ova-t 	 z-pěč-ova-t
zpřísnit 	 z-přísn-i-t 	 z-pří-sn-i-t
zpřísnět 	 z-přísn-ě-t 	 z-pří-sn-ě-t
zrakový 	 zrak-ov-ý 	 z-rak-ov-ý
zrcadle 	 zrc-a-dl-e 	 zrca-dl-e
zregulovat 	 z-regul-ova-t 	 z-re-gul-ova-t
zrentgenovat 	 z-rentgen-ova-t 	 z-re-ntgen-ova-t
zrušení 	 z-ruš-en-í 	 z-ruš-e-n-í
ztotožnit 	 z-to-tož-n-i-t 	 z-t-o-tož-n-i-t
ztotožňovat 	 z-to-tož-ň-ova-t 	 z-t-o-t-ož-ň-ova-t
ztratiti 	 z-trat-i-ti 	 z-trat-i-t-i
zutrhat 	 z-u-trh-a-t 	 zu-trh-a-t
zveřejněné 	 z-veřej-n-ě-n-é 	 z-veřejn-ěn-é
zveřejnění 	 z-veřej-n-ě-n-í 	 z-veřejn-ě-n-í
zviklat 	 z-vikl-a-t 	 z-vik-l-a-t
zvláště 	 zvláště 	 z-vlášt-ě
zvlášť 	 zvlášť 	 z-vlášť
zvroucnit 	 z-vr-ou-c-n-i-t 	 z-vrouc-n-i-t
zvážení 	 z-váž-en-í 	 z-váž-e-n-í
zvídavější 	 z-víd-a-v-ějš-í 	 z-víd-a-v-ěj-š-í
zvířata 	 zvíř-at-a 	 z-víř-at-a
zvýhodnění 	 z-vý-hod-n-ěn-í 	 z-vý-hod-n-ě-n-í
zádech 	 zád-e-ch 	 zá-d-ech
zády 	 zád-y 	 zá-d-y
zákazníka 	 zá-kaz-ník-a 	 zá-kaz-n-ík-a
základem 	 zá-klad-e-m 	 zá-klad-em
zármutku 	 zá-rmut-k-u 	 zá-rmutk-u
závojnatkách 	 zá-voj-n-at-k-á-ch 	 zá-voj-n-a-t-k-ách
zúžit 	 z-úž-i-t 	 zú-ž-i-t
zčásti 	 z-část-i 	 z-čás-t-i
zůstal 	 z-ů-sta-l 	 zů-st-a-l
zůstanou 	 z-ů-sta-n-ou 	 zů-sta-n-ou
úmysly 	 ú-mysl-y 	 ú-mys-l-y
ústit 	 úst-i-t 	 ú-st-i-t
útrobách 	 útrob-ách 	 ú-tr-ob-ách
úzká 	 úz-k-á 	 ú-z-k-á
účinky 	 ú-čin-k-y 	 ú-č-in-k-y
úžasem 	 ú-žas-e-m 	 ú-žas-em
černým 	 čern-ý-m 	 čer-n-ým
černýšovice 	 čern-ýš-ov-ic-e 	 čer-n-ýš-ov-ic-e
čerstvého 	 čerstv-ého 	 čerst-v-ého
českou 	 čes-k-ou 	 česk-ou
českého 	 čes-k-é-ho 	 česk-ého
českém 	 čes-k-ém 	 česk-ém
češtiny 	 češ-t-in-y 	 češt-in-y
čilý 	 čil-ý 	 či-l-ý
činorodé 	 čin-o-rod-é 	 čin-orod-é
článkem 	 člán-k-e-m 	 člán-k-em
čokoládou 	 čokolád-ou 	 čo-kolád-ou
čsfr 	 č-s-f-r 	 čsfr
čsn 	 č-s-n 	 čsn
čssr 	 č-s-s-r 	 čssr
čtvrt 	 čtvrt 	 čtvr-t
čzpi 	 č-z-p-i 	 čzp-i
řepkového 	 řep-k-ov-ého 	 řep-k-ového
řetězových 	 řetěz-ov-ých 	 ře-těz-ov-ých
řezání 	 řez-á-n-í 	 ře-zá-n-í
říjet 	 říj-e-t 	 ří-j-e-t
šeptne 	 šept-ne 	 šept-n-e
šifrovaných 	 šifr-ova-n-ý-ch 	 šifr-ova-n-ých
šitinův 	 šitin-ův 	 šit-in-ův
škudlit 	 škud-l-i-t 	 škudl-i-t
šmankote 	 šmankote 	 šmank-ote
šmejkal 	 šmejkal 	 šmejk-a-l
šminkovat 	 šmink-ova-t 	 šmin-k-ova-t
špaček 	 špaček 	 špač-ek
špionáže 	 špion-áž-e 	 špio-náž-e
šplouná 	 šplou-n-á 	 šploun-á
štít 	 štít 	 št-í-t
šumperka 	 šumperk-a 	 šumper-k-a
švýcarské 	 švýcar-sk-é 	 švý-car-sk-é
šíblová 	 šíbl-ová 	 šíbl-ov-á
žaludek 	 žaludek 	 žalud-ek
žehrat 	 žehr-a-t 	 že-hr-a-t
žehravost 	 žehr-a-v-ost 	 že-hrav-ost
žejbrovat 	 žejbr-ova-t 	 že-jbr-ova-t
železárnách 	 želez-árn-ách 	 železá-r-n-ách
žernově 	 žernov-ě 	 žern-ov-ě
živelná 	 ži-v-el-n-á 	 ži-vel-n-á
živnostenského 	 ži-v-n-ost-ensk-ého 	 ži-v-n-ost-en-sk-ého
životními 	 ži-v-ot-n-í-m-i 	 ži-v-ot-n-ími
žižkovák 	 žižkov-ák 	 žiž-k-ovák
