absolventi 	 ab-solv-ent-i 	 absolvent-i
achronisticky 	 a-chron-ist-ic-k-y 	 a-chronist-ic-k-y
adaptabilní 	 adapt-abil-n-í 	 adaptabil-n-í
adresátů 	 adres-át-ů 	 adresát-ů
amerikanismem 	 amerik-an-ism-e-m 	 amerik-an-ism-em
anglosaskou 	 angl-o-sas-k-ou 	 angl-o-sask-ou
architektury 	 archi-tekt-ur-y 	 architektur-y
arcilotras 	 arci-lotr-as 	 arci-lotras
argaláš 	 argaláš 	 argal-áš
argentiny 	 argentin-y 	 argent-in-y
atamanem 	 ataman-e-m 	 ataman-em
atlet 	 atlet 	 atle-t
automobilka 	 automobil-k-a 	 auto-mobil-k-a
avšak 	 a-však 	 avšak
babičku 	 bab-ič-k-u 	 bab-ičk-u
balený 	 bal-en-ý 	 balen-ý
balených 	 bal-en-ých 	 balen-ých
betlémské 	 betlém-sk-é 	 betl-ém-sk-é
bezesných 	 beze-sn-ých 	 bezes-n-ých
bionaftu 	 bio-naft-u 	 bionaft-u
bionafty 	 bio-naft-y 	 bionaft-y
blahopřejeme 	 blah-o-pře-je-me 	 blaho-přeje-me
bojíme 	 boj-í-me 	 bo-j-í-me
budoucnosti 	 bud-ou-c-n-ost-i 	 bud-ouc-n-ost-i
budoucím 	 bud-ouc-ím 	 bud-ouc-í-m
budova 	 bud-ova 	 bud-ov-a
bulletinu 	 bulletin-u 	 bullet-in-u
bych 	 by-ch 	 bych
bytu 	 by-t-u 	 byt-u
byznys 	 byznys 	 by-z-n-ys
běžně 	 běž-ně 	 běž-n-ě
celkovou 	 cel-k-ov-ou 	 celk-ov-ou
celková 	 cel-k-ov-á 	 celk-ov-á
celkové 	 cel-k-ov-é 	 celk-ové
celoživotní 	 cel-o-ži-v-ot-n-í 	 celo-živ-ot-n-í
cenovky 	 cen-ovk-y 	 cenov-k-y
cestující 	 cest-uj-í-c-í 	 cest-uj-íc-í
chcete 	 chc-e-te 	 chce-te
chvílích 	 chvíl-í-ch 	 chvíl-ích
cigarety 	 cigar-et-y 	 cigaret-y
cimrmanovština 	 cimrman-ov-št-in-a 	 cimrman-ov-št-ina
cizince 	 ciz-in-c-e 	 ciz-inc-e
ctihodnými 	 ct-i-hod-n-ý-m-i 	 ct-i-hod-n-ými
cácorka 	 các-or-k-a 	 cácor-k-a
cílem 	 cíl-e-m 	 cíl-em
daktyloskopie 	 daktylo-skopi-e 	 daktylo-skop-i-e
dali 	 d-a-l-i 	 da-l-i
dana 	 dan-a 	 d-a-n-a
dané 	 d-a-n-é 	 dan-é
deklarována 	 de-klar-ová-n-a 	 deklar-ová-n-a
deklarováno 	 de-klar-ová-n-o 	 deklar-ová-n-o
deklarují 	 de-klar-uj-í 	 deklar-uj-í
delikátnostem 	 delikát-n-ost-e-m 	 delikátn-ost-em
devizové 	 deviz-ov-é 	 deviz-ové
dezinteresovat 	 dez-interes-ova-t 	 dezinteres-ova-t
distanční 	 dis-tanč-n-í 	 dist-anč-n-í
dkp 	 d-k-p 	 dkp
dobrodiní 	 dobr-o-di-n-í 	 dobr-odin-í
dobytí 	 do-by-tí 	 do-by-t-í
docentů 	 docent-ů 	 do-cent-ů
dodacích 	 do-d-a-c-ích 	 do-dac-ích
dokonalého 	 do-kon-a-l-é-ho 	 do-kon-a-l-ého
domáknout 	 do-mák-nou-t 	 domák-nou-t
dosvědčíme 	 do-s-věd-č-í-me 	 do-s-vědč-í-me
dotazníky 	 do-taz-ník-y 	 do-taz-n-ík-y
dozvíte 	 do-z-v-í-te 	 do-zv-í-te
druhém 	 druh-é-m 	 druh-ém
dubnové 	 dubn-ov-é 	 dubn-ové
duchovně 	 duch-ov-n-ě 	 duch-ovn-ě
dveřích 	 dveř-í-ch 	 dveř-ích
dvojnásobek 	 dv-oj-ná-sob-ek 	 dvoj-násob-ek
dvouměsíční 	 dv-ou-měsíč-n-í 	 dvou-měsíč-n-í
dvoustraně 	 dv-ou-stran-ě 	 dvou-stran-ě
dynamická 	 dynam-ic-k-á 	 dynamic-k-á
dynamika 	 dynam-ik-a 	 dynamik-a
dálkové 	 dál-k-ov-é 	 dál-k-ové
dědečkův 	 děd-eč-k-ův 	 děd-ečk-ův
dělení 	 děl-en-í 	 děl-e-n-í
dřívějších 	 dřív-ějš-ích 	 dřív-ěj-š-ích
důchod 	 dů-chod 	 důchod
empirických 	 empir-ic-k-ý-ch 	 empir-ic-k-ých
energie 	 energ-i-e 	 energ-ie
epocha 	 epoch-a 	 e-poch-a
expansion 	 expansion 	 ex-pans-ion
experiment 	 experi-ment 	 experiment
experimentaci 	 experi-ment-ac-i 	 experiment-ac-i
faktorů 	 fakt-or-ů 	 faktor-ů
faktury 	 fakt-ur-y 	 faktur-y
fanoušků 	 fan-oušk-ů 	 fanoušk-ů
farmaceutické 	 farmac-eut-ick-é 	 farmaceut-ic-k-é
filozofické 	 filo-zof-ic-k-é 	 fil-o-zof-ic-k-é
finálním 	 fin-ál-n-ím 	 finál-n-í-m
fondem 	 fondem 	 fond-em
formosu 	 formos-u 	 form-os-u
fosforeskovat 	 fosfor-esk-ova-t 	 fosforesk-ova-t
francouzsky 	 franc-ouz-sk-y 	 franc-ouzsk-y
fyzický 	 fyz-ic-k-ý 	 fyzic-k-ý
fólie 	 fóli-e 	 fól-i-e
gastronomie 	 gastr-o-nom-i-e 	 gastr-onomi-e
gestikulovat 	 gestik-ul-ova-t 	 gestikul-ova-t
graessnerii 	 graessnerii 	 graessner-i-i
haly 	 hal-y 	 haly
haló 	 haló 	 hal-ó
hematologického 	 hemat-o-log-ick-ého 	 hematologic-k-ého
hladověli 	 hlad-ov-ě-l-i 	 hlad-ově-l-i
hmotného 	 hmot-n-é-ho 	 hmot-n-ého
hnedle 	 hned-le 	 hned-l-e
hnízdech 	 hnízd-e-ch 	 hnízd-ech
hochschule 	 hoch-schule 	 hochschul-e
hodnotím 	 hod-n-ot-í-m 	 hod-n-ot-ím
hodnotíte 	 hodn-ot-í-te 	 hod-n-ot-í-te
holandsku 	 holand-sk-u 	 holandsk-u
holiči 	 hol-i-č-i 	 hol-ič-i
holčičkou 	 hol-č-ič-k-ou 	 hol-č-ičk-ou
horolezci 	 hor-o-lez-c-i 	 horolez-c-i
houston 	 houston 	 houst-on
hra 	 hr-a 	 hra
hromková 	 hrom-k-ov-á 	 hromk-ov-á
hry 	 hr-y 	 hry
husími 	 hus-í-m-i 	 hus-ími
huti 	 hut-i 	 huti
hvězdičky 	 hvězd-ič-k-y 	 hvězd-ičk-y
identifikační 	 identi-fik-ač-n-í 	 identifik-ač-n-í
indikátorem 	 in-dik-át-or-em 	 indik-átor-em
inzerátech 	 inzer-át-e-ch 	 inzerát-ech
inženýrském 	 inženýr-sk-ém 	 inžen-ýr-sk-ém
ivančic 	 ivan-č-ic 	 ivanč-ic
jablíčko 	 jablíč-k-o 	 jabl-íčk-o
jakoby 	 jak-o-by 	 jak-ob-y
jakého 	 jak-é-ho 	 jak-ého
janků 	 jan-k-ů 	 jank-ů
jazejček 	 jazejč-ek 	 jazejček
jednatelem 	 jedn-a-tel-e-m 	 jedn-a-tel-em
jednomotorových 	 jedn-o-motor-ov-ých 	 jedno-motor-ov-ých
jednoosý 	 jedn-o-os-ý 	 jedn-oosý
jednorázové 	 jedn-o-ráz-ov-é 	 jednoráz-ov-é
jednotlivina 	 jedn-ot-liv-in-a 	 jedn-otliv-in-a
jednotlivými 	 jedn-ot-liv-ými 	 jedn-otliv-ými
jedním 	 jedn-í-m 	 jedn-ím
jejích 	 je-j-í-ch 	 jej-ích
jethro 	 jethro 	 jethr-o
jimž 	 j-i-m-ž 	 j-im-ž
jindy 	 jin-d-y 	 jind-y
jmenují 	 jmen-u-j-í 	 jmen-uj-í
kamera 	 kamera 	 kamer-a
kapesníček 	 kapes-níč-ek 	 kapes-níček
kapli 	 kapl-i 	 kap-l-i
kardašovy 	 kardašov-y 	 kardaš-ov-y
katalozích 	 kata-loz-ích 	 kataloz-ích
kavalírem 	 kaval-ír-e-m 	 kaval-ír-em
kavkám 	 kav-k-ám 	 kavk-á-m
každému 	 každ-é-mu 	 každ-ému
kdovíkdo 	 kd-o-v-í-kd-o 	 kd-ovíkd-o
kdož 	 kdo-ž 	 kd-o-ž
klasifikaci 	 klasi-fik-ac-i 	 klasifik-ac-i
klesly 	 kles-l-y 	 klesl-y
klesne 	 kles-ne 	 klesn-e
kliniky 	 klinik-y 	 klin-ik-y
klášterem 	 klášter-e-m 	 klášter-em
koho 	 k-o-ho 	 koho
kompetenci 	 kompet-enc-i 	 kompetenc-i
komu 	 k-o-mu 	 komu
konkrétního 	 konkrét-n-ího 	 kon-krét-n-ího
konkrétnímu 	 kon-krét-n-í-mu 	 kon-krét-n-ímu
kontilití 	 konti-li-t-í 	 kontilit-í
kontraindikace 	 kontra-in-dik-ac-e 	 kontraindik-ace
kontrolorů 	 kontrol-or-ů 	 kontrolor-ů
kontroloři 	 kontrol-oř-i 	 kontroloř-i
konviktem 	 kon-vikt-e-m 	 konvikt-em
konírny 	 kon-ír-n-y 	 kon-írn-y
kosmického 	 kosm-ic-k-é-ho 	 kosm-ick-ého
kostička 	 kost-ič-k-a 	 kost-ičk-a
koupací 	 koup-ac-í 	 koup-a-c-í
koňských 	 koň-sk-ý-ch 	 koň-sk-ých
kožené 	 kož-en-é 	 kožen-é
krakově 	 krakov-ě 	 krak-ov-ě
kristapána 	 krist-a-pán-a 	 krista-pán-a
krumlesco 	 krumlesco 	 krumlesc-o
krumlova 	 krumlov-a 	 kruml-ov-a
krádeže 	 krád-ež-e 	 krád-eže
krásným 	 krás-n-ý-m 	 krás-n-ým
kterého 	 kter-é-ho 	 kter-ého
kunovice 	 kun-ovic-e 	 kun-ov-ic-e
kuriozity 	 kurioz-it-y 	 kuriozit-y
křivkami 	 křiv-k-a-m-i 	 křiv-k-ami
křídlem 	 kří-dl-e-m 	 křídl-em
kůzlátek 	 kůzl-át-ek 	 kůzl-átek
lavírovat 	 lav-ír-ova-t 	 lavír-ova-t
lehkým 	 leh-k-ý-m 	 leh-k-ým
lesním 	 les-n-ím 	 les-n-í-m
letiště 	 let-išt-ě 	 let-iště
lhostejnět 	 lhostej-n-ě-t 	 l-hostejn-ě-t
lidem 	 lid-e-m 	 lid-em
limit 	 limit 	 lim-i-t
loupežníkem 	 loup-ež-n-ík-e-m 	 loup-ež-n-ík-em
ltd 	 l-t-d 	 ltd
luděk 	 luděk 	 lud-ěk
lukách 	 luk-á-ch 	 luk-ách
lumpačit 	 lump-ač-i-t 	 lumpač-i-t
lékařem 	 lék-ař-e-m 	 lék-ař-em
lékem 	 lék-e-m 	 lék-em
maiden 	 maid-en 	 maiden
majíce 	 m-aj-íc-e 	 m-ajíc-e
makrokonvertor 	 makro-kon-ver-t-or 	 makro-konver-t-or
maličkosti 	 mal-ič-k-ost-i 	 mal-ičk-ost-i
maličký 	 mal-ič-k-ý 	 mal-ičk-ý
malkovského 	 malkovsk-ého 	 malk-ov-sk-ého
mamlasovi 	 maml-as-ovi 	 mamlas-ovi
manager 	 manag-er 	 manager
manažerovi 	 manažer-ovi 	 manaž-er-ovi
manýrám 	 manýr-á-m 	 manýr-ám
mariánských 	 mari-án-sk-ých 	 marián-sk-ých
marketingový 	 market-ing-ov-ý 	 marketing-ov-ý
materialisty 	 mater-i-al-ist-y 	 materi-al-ist-y
materiálové 	 materi-ál-ov-é 	 materiál-ov-é
materiálu 	 mater-i-ál-u 	 materi-ál-u
mazání 	 maz-á-n-í 	 mazá-n-í
metafyzických 	 meta-fyz-ic-k-ý-ch 	 meta-fyz-ic-k-ých
metodologicky 	 metodo-log-ic-k-y 	 metodo-log-ick-y
mezitím 	 mezi-t-ím 	 mezit-ím
meziříčí 	 mezi-říč-í 	 meziříč-í
mečení 	 meč-e-n-í 	 meč-en-í
mhouřit 	 mhouř-i-t 	 m-houř-i-t
mikroorganismy 	 mikro-organ-ism-y 	 mikroorgan-ismy
miliarda 	 miliard-a 	 mili-ard-a
milostpane 	 mil-ost-pan-e 	 mil-ostpan-e
ministerstva 	 minister-stv-a 	 ministerstv-a
minulý 	 min-ul-ý 	 mi-nu-l-ý
mjasisčev 	 mjasisčev 	 mjasisč-ev
mladého 	 mlad-é-ho 	 mlad-ého
mluvící 	 mluv-íc-í 	 mluvíc-í
mlýna 	 ml-ýn-a 	 ml-ýna
moderního 	 modern-í-ho 	 modern-ího
moje 	 moj-e 	 moje
monopolu 	 mon-o-pol-u 	 mono-pol-u
motorlet 	 motor-let 	 motorl-e-t
motorletu 	 motor-let-u 	 motorlet-u
možnostech 	 možn-ost-ech 	 mož-n-ost-ech
mrtvé 	 mr-tv-é 	 mrtv-é
mužského 	 muž-sk-é-ho 	 muž-sk-ého
mésti 	 mést-i 	 més-ti
mých 	 m-ý-ch 	 m-ých
měli 	 mě-l-i 	 m-ě-l-i
měřítka 	 měř-í-tk-a 	 měř-ít-k-a
měřítku 	 měř-í-tk-u 	 měř-ít-k-u
mřížovec 	 mříž-ov-ec 	 mříž-ovec
nabitý 	 na-bi-t-ý 	 na-bit-ý
nadpočetné 	 nad-po-čet-n-é 	 nad-počet-n-é
nadějemi 	 na-děj-e-m-i 	 na-děj-emi
nadřaděného 	 nad-řad-ěn-é-ho 	 nad-řad-ěn-ého
nadšení 	 na-dš-en-í 	 nad-šen-í
nadšením 	 na-dš-en-í-m 	 nad-šen-ím
nahrávat 	 na-hrá-v-a-t 	 na-hráv-a-t
najatí 	 na-j-a-t-í 	 na-j-at-í
nakolkovat 	 na-kol-k-ova-t 	 na-kolk-ova-t
namésti 	 na-mést-i 	 na-més-ti
nebrání 	 ne-brán-í 	 ne-br-á-n-í
nechtěj 	 ne-cht-ě-j 	 ne-cht-ěj
nedefinovatelné 	 ne-de-fin-ova-teln-é 	 ne-definova-teln-é
nedávna 	 ne-dávn-a 	 ne-dáv-n-a
neinkasoval 	 ne-in-kas-ova-l 	 ne-inkas-ova-l
nejaktivnější 	 nej-akt-iv-n-ějš-í 	 ne-jakt-iv-n-ěj-š-í
nejcitlivějším 	 nej-cit-liv-ějš-ím 	 nej-cit-l-iv-ěj-š-í-m
nejdivočejší 	 nej-div-oč-ej-š-í 	 nej-div-oč-ejš-í
nejkrásnějších 	 nej-krás-n-ěj-š-í-ch 	 nej-krás-n-ěj-š-ích
nejlahodnější 	 nej-lahod-n-ěj-š-í 	 nejlahod-n-ěj-š-í
nejsladšího 	 nej-slad-š-í-ho 	 nej-slad-š-ího
nejvzdálenější 	 nej-vz-dál-e-n-ěj-š-í 	 nejvz-dálen-ějš-í
nejzřetelněji 	 nej-zř-e-tel-n-ěji 	 nej-zř-e-teln-ěji
nejčastějších 	 nej-čast-ěj-š-í-ch 	 nej-čast-ěj-š-ích
nekvete 	 ne-kvet-e 	 ne-kve-te
nelegální 	 ne-leg-ál-n-í 	 ne-legál-n-í
neměly 	 ne-m-ě-l-y 	 ne-m-ěl-y
neodpovídající 	 ne-od-po-víd-aj-íc-í 	 ne-od-povíd-aj-ící
nepohnutě 	 ne-po-h-nu-t-ě 	 ne-po-h-nutě
nepolemizujme 	 ne-polem-iz-uj-me 	 ne-polemizuj-me
nepotřebujete 	 ne-po-třeb-u-j-e-te 	 ne-po-třeb-uje-te
nepravdivých 	 ne-prav-d-iv-ých 	 ne-prav-div-ých
nepředepisují 	 ne-přede-pis-uj-í 	 ne-předepis-uj-í
nepředpokládám 	 ne-před-po-klád-á-m 	 ne-předpoklád-ám
nepřidává 	 ne-při-d-á-v-á 	 ne-při-dá-v-á
nepřišla 	 ne-při-š-l-a 	 ne-při-šl-a
nereálný 	 ne-reál-n-ý 	 ne-reáln-ý
nesnesitelna 	 ne-s-nes-i-teln-a 	 ne-snes-i-teln-a
nevyhnutelné 	 ne-vy-h-nu-teln-é 	 ne-vy-h-nuteln-é
nevyskytly 	 ne-vy-skyt-l-y 	 ne-vy-skytl-y
nezaměstnanosti 	 ne-za-měst-n-an-ost-i 	 ne-za-městn-an-osti
nezaoblená 	 ne-za-obl-en-á 	 ne-za-oblen-á
nezačínej 	 ne-za-č-ín-ej 	 ne-za-čín-ej
neznámého 	 ne-zn-á-m-é-ho 	 ne-zn-á-m-ého
neztratitelnost 	 ne-z-trat-i-tel-n-ost 	 ne-z-trat-i-teln-ost
neúplných 	 ne-ú-pln-ých 	 neú-pln-ých
nitěných 	 nit-ěn-ý-ch 	 nit-ěn-ých
norem 	 norem 	 nor-em
nosem 	 nos-e-m 	 nos-em
novinám 	 nov-in-á-m 	 nov-in-ám
nuly 	 nul-y 	 nuly
nymburka 	 nymburk-a 	 nymbur-k-a
nábytek 	 ná-by-tek 	 ná-byt-ek
náramného 	 ná-ram-n-é-ho 	 ná-ram-n-ého
nás 	 n-á-s 	 nás
následujících 	 ná-sled-uj-íc-ích 	 násled-uj-íc-ích
následujícího 	 ná-sled-uj-íc-ího 	 násled-uj-íc-ího
nějakém 	 ně-jak-é-m 	 ně-jak-ém
něm 	 n-ě-m 	 n-ěm
němá 	 něm-á 	 n-ěm-á
obcích 	 obc-ích 	 ob-c-ích
obepnout 	 obe-pn-ou-t 	 obe-p-nou-t
objektem 	 ob-jekt-e-m 	 ob-jekt-em
obor 	 o-bor 	 obor
obrali 	 o-br-a-l-i 	 o-bra-l-i
obrat 	 o-br-a-t 	 obr-a-t
obzvlášť 	 ob-zvlášť 	 ob-z-vlášť
občanského 	 obč-an-sk-ého 	 občan-sk-ého
oceli 	 ocel-i 	 o-cel-i
ochotna 	 ochot-n-a 	 o-chot-n-a
odbytové 	 od-by-t-ov-é 	 od-byt-ové
odehrávají 	 ode-hrá-v-aj-í 	 ode-hráv-aj-í
odervat 	 ode-rv-a-t 	 oderv-a-t
odečte 	 ode-čt-e 	 odeč-te
odečtou 	 ode-čt-ou 	 odečt-ou
odmésti 	 od-mést-i 	 od-més-ti
odměňujeme 	 od-měň-uje-me 	 od-měň-ujeme
odst 	 od-st 	 odst
ohořelému 	 o-hoř-e-l-é-mu 	 o-hoř-e-l-ému
ohřebelcovat 	 o-hřeb-el-c-ova-t 	 o-hřebelc-ova-t
okounět 	 okoun-ě-t 	 o-koun-ě-t
oktrojovat 	 oktroj-ova-t 	 o-ktroj-ova-t
olšanech 	 olšan-e-ch 	 olšan-ech
omegou 	 omeg-ou 	 o-meg-ou
opačném 	 o-pač-n-é-m 	 o-pač-n-ém
oplésti 	 o-plést-i 	 o-plés-ti
opovažuješ 	 o-po-važ-u-j-e-š 	 o-po-važ-uje-š
orchestrem 	 orchestr-e-m 	 orchestr-em
organismus 	 organismus 	 organ-ism-us
organizují 	 organ-iz-u-j-í 	 organ-iz-uj-í
orientální 	 orient-ál-n-í 	 orient-áln-í
orlik 	 orl-ik 	 orlik
osmou 	 osm-ou 	 o-sm-ou
osobu 	 o-sob-u 	 osob-u
ospalost 	 o-sp-a-l-ost 	 o-spal-ost
ostatních 	 o-stat-n-í-ch 	 o-stat-n-ích
ostravské 	 ostrav-sk-é 	 o-strav-sk-é
ostravy 	 ostrav-y 	 o-strav-y
osudem 	 o-sud-e-m 	 o-sud-em
osudně 	 osud-n-ě 	 o-sud-n-ě
osvědčují 	 o-s-věd-č-u-j-í 	 o-svědč-uj-í
oxfordského 	 oxford-sk-é-ho 	 oxford-sk-ého
ošukat 	 ošuk-a-t 	 o-šuk-a-t
pacientovi 	 pac-i-ent-ovi 	 pacient-ovi
padesátku 	 pade-sát-k-u 	 pa-desát-k-u
panenka 	 pan-en-k-a 	 panenk-a
paničko 	 pan-ič-k-o 	 pan-ičk-o
pekárenských 	 pek-ár-en-sk-ých 	 pekáren-sk-ých
perfektně 	 per-fekt-n-ě 	 perfekt-n-ě
petynce 	 pety-n-c-e 	 petyn-c-e
pil 	 pi-l 	 pil
pilují 	 pil-u-j-í 	 pil-uj-í
pisklavě 	 pisk-l-av-ě 	 pisk-l-avě
plakáty 	 plakát-y 	 plak-át-y
planul 	 plan-u-l 	 pla-nu-l
plat 	 plat 	 pl-a-t
plačící 	 plač-í-c-í 	 plač-íc-í
pleteného 	 plet-en-é-ho 	 plet-en-ého
plnohodnotné 	 pln-o-hod-n-ot-n-é 	 pln-o-hod-not-n-é
plodem 	 plod-e-m 	 plod-em
plukovník 	 pluk-ov-n-ík 	 pluk-ovn-ík
podhrnout 	 pod-hrn-ou-t 	 pod-hr-nou-t
podobného 	 po-dob-n-é-ho 	 po-dob-n-ého
podotkl 	 po-do-tk-l 	 po-dotk-l
podvésti 	 pod-vést-i 	 pod-vés-ti
pohaněné 	 po-han-ě-n-é 	 po-han-ěn-é
pohotovějším 	 po-hotov-ějš-ím 	 po-hotov-ějš-í-m
politických 	 polit-ic-k-ý-ch 	 polit-ic-k-ých
polska 	 pol-sk-a 	 polsk-a
poměrem 	 po-měr-e-m 	 po-měr-em
popelnic 	 po-pel-nic 	 popel-nic
popkultura 	 pop-kult-ur-a 	 popkult-ur-a
poplatník 	 po-plat-ník 	 po-plat-n-ík
poplatníka 	 po-plat-ník-a 	 po-plat-n-ík-a
poplatníky 	 po-plat-ník-y 	 po-plat-n-ík-y
poproduktivní 	 po-pro-duk-t-iv-n-í 	 popro-dukt-iv-n-í
porovnání 	 po-rovn-ání 	 po-rov-n-á-n-í
porůsti 	 po-růst-i 	 po-růs-ti
posluchače 	 po-sluch-a-č-e 	 po-sluch-ač-e
posluchačů 	 po-sluch-a-č-ů 	 po-sluch-ač-ů
postih 	 po-stih 	 postih
postávalo 	 po-stá-v-a-l-o 	 po-stáv-a-l-o
potrefený 	 po-tref-en-ý 	 po-trefen-ý
pouhém 	 pouh-é-m 	 pouh-ém
poučit 	 po-uč-i-t 	 pouč-i-t
použito 	 po-u-ži-t-o 	 použi-to
povyrůsti 	 po-vy-růst-i 	 po-vy-růs-ti
povzbudivé 	 po-vz-bud-i-v-é 	 po-vz-bud-iv-é
pošlete 	 po-šl-e-te 	 po-šle-te
pragokoncertu 	 prag-o-koncert-u 	 prago-koncert-u
praktickým 	 prakt-ic-k-ý-m 	 prakt-ic-k-ým
praktikantům 	 prakt-ik-ant-ům 	 praktikant-ům
pravd 	 prav-d 	 pravd
prezidentů 	 prezid-ent-ů 	 prezident-ů
prodejce 	 pro-d-ej-c-e 	 pro-d-ejc-e
prodejna 	 pro-d-ej-n-a 	 pro-d-ejn-a
produševňovat 	 pro-duš-ev-ň-ova-t 	 pro-dušev-ň-ova-t
prohrával 	 pro-hrá-v-a-l 	 pro-hráv-a-l
projede 	 pro-jed-e 	 pro-jede
projednáním 	 pro-jed-n-án-ím 	 pro-jedn-á-n-ím
prokládkovost 	 pro-klád-k-ov-ost 	 pro-klád-kov-ost
proklásti 	 pro-klást-i 	 pro-klás-ti
prolévat 	 pro-lé-v-a-t 	 pro-lév-a-t
promnout 	 pro-mn-ou-t 	 pro-m-nou-t
propagace 	 propag-ac-e 	 pro-pag-ac-e
prostějovsko 	 prostějov-sk-o 	 prostějovsk-o
prostějově 	 prostějov-ě 	 prostěj-ov-ě
protisluneční 	 proti-slun-eč-n-í 	 protislun-eč-n-í
provincií 	 provinc-i-í 	 pro-vinc-i-í
provádějí 	 pro-vád-ěj-í 	 pro-vád-ě-j-í
pročež 	 pro-č-e-ž 	 pro-č-ež
prošel 	 pro-še-l 	 prošel
prstíčky 	 prst-íč-k-y 	 prst-íčk-y
právem 	 práv-e-m 	 práv-em
psaním 	 ps-a-n-í-m 	 ps-a-n-ím
psychično 	 psych-ič-n-o 	 psychičn-o
psům 	 ps-ů-m 	 ps-ům
ptejme 	 pt-ej-me 	 ptej-me
publicita 	 public-it-a 	 publicit-a
purple 	 purple 	 purpl-e
pučálka 	 pučálk-a 	 pučál-k-a
pzt 	 p-z-t 	 pz-t
pánové 	 pán-ové 	 pán-ov-é
pápěrka 	 pá-pěr-k-a 	 pápěr-k-a
píti 	 pít-i 	 pí-ti
pódiem 	 pódi-em 	 pód-i-em
pěkném 	 pěkn-é-m 	 pěkn-ém
pěst 	 pěst 	 pěs-t
pětikorunovou 	 pět-i-korun-ov-ou 	 pět-ikorun-ov-ou
pětistovkou 	 pět-i-st-ovk-ou 	 pět-ist-ovk-ou
předcházejí 	 před-cház-e-j-í 	 před-cház-ej-í
předepsanou 	 přede-ps-a-n-ou 	 přede-psa-n-ou
předobjednávání 	 před-ob-jedn-á-v-á-n-í 	 předobjedná-v-á-n-í
předprodeje 	 před-pro-d-ej-e 	 před-prodeje
předsedům 	 před-sed-ů-m 	 před-sed-ům
představiteli 	 před-stav-i-tel-i 	 před-stavi-tel-i
předstihujícím 	 před-stih-uj-í-c-í-m 	 před-stih-uj-íc-ím
předvýrobní 	 před-vý-rob-n-í 	 před-výrob-n-í
přejímce 	 pře-j-í-m-c-e 	 pře-jímc-e
překontrolována 	 pře-kontrol-ová-n-a 	 pře-kontrol-ová-na
přepnout 	 pře-pn-ou-t 	 pře-p-nou-t
připadne 	 při-pad-ne 	 při-pad-n-e
připluje 	 při-plu-je 	 při-pluje
připomenout 	 při-po-men-ou-t 	 při-pome-nou-t
přivydělávat 	 při-vy-děl-á-v-a-t 	 při-vyděl-á-v-a-t
přizpůsobivosti 	 při-z-pů-sob-i-v-ost-i 	 při-z-pů-sob-i-v-osti
přišinout 	 při-šin-ou-t 	 při-ši-nou-t
přímém 	 přím-é-m 	 přím-ém
přítomném 	 pří-t-o-m-n-é-m 	 pří-t-om-n-ém
přítomnými 	 pří-t-o-m-n-ý-m-i 	 pří-t-o-m-n-ými
příštího 	 příšt-í-ho 	 příšt-ího
pšenka 	 pšen-k-a 	 pšenk-a
québec 	 québec 	 québ-ec
radomír 	 radomír 	 rad-omír
raději 	 rad-ěji 	 rad-ěj-i
rallye 	 rallye 	 rall-ye
regentíkův 	 regent-ík-ův 	 regentík-ův
rejda 	 rejd-a 	 rejda
rejha 	 rejh-a 	 rejha
rejstříku 	 rejstřík-u 	 rejstř-ík-u
rektorem 	 rekt-or-em 	 rektor-em
relativita 	 rel-at-iv-it-a 	 relat-iv-it-a
reportáž 	 re-port-áž 	 report-áž
reprodukční 	 re-pro-duk-č-n-í 	 re-pro-dukč-n-í
restriktivní 	 re-strikt-iv-n-í 	 restrikt-iv-n-í
revolucí 	 revol-uc-í 	 revoluc-í
rider 	 rid-er 	 rider
rohovatět 	 roh-ov-at-ě-t 	 roh-ovat-ě-t
rolling 	 roll-ing 	 rolling
rolničit 	 rol-n-ič-i-t 	 rol-nič-i-t
roxby 	 roxby 	 roxb-y
rozchraptit 	 roz-chrap-t-i-t 	 roz-chrapt-i-t
rozhrnula 	 roz-hrn-u-l-a 	 roz-hr-nu-l-a
rozkošným 	 roz-koš-n-ý-m 	 roz-koš-n-ým
rozleptávat 	 roz-lept-á-v-a-t 	 roz-lept-áv-a-t
rozplývat 	 roz-plý-v-a-t 	 roz-plýv-a-t
rozpočísti 	 roz-po-číst-i 	 roz-po-čís-ti
rozprodávat 	 roz-pro-d-á-v-a-t 	 roz-prod-á-v-a-t
rozumových 	 roz-um-ov-ý-ch 	 roz-um-ov-ých
rozutíkat 	 roz-utík-a-t 	 roz-u-tík-a-t
rupií 	 rupi-í 	 rup-i-í
rusové 	 rus-ové 	 rus-ov-é
rázem 	 ráz-e-m 	 ráz-em
různými 	 různ-ý-m-i 	 různ-ými
samostatnější 	 sam-o-stat-n-ějš-í 	 sam-o-stat-n-ěj-š-í
samozřejmá 	 sam-o-zř-ejm-á 	 sam-o-zřejm-á
schodech 	 s-chod-e-ch 	 s-chod-ech
scorpions 	 scorpion-s 	 scorp-ions
sebeničením 	 s-eb-e-ni-č-en-í-m 	 seb-e-nič-en-ím
sebevíce 	 seb-e-víc-e 	 seb-e-více
sedláková 	 sedl-ák-ov-á 	 sed-l-ák-ov-á
sedmihradsku 	 sedmihradsk-u 	 sedmi-hrad-sk-u
seminární 	 semin-ár-n-í 	 semin-árn-í
separátní 	 se-par-át-n-í 	 se-parát-n-í
sepnout 	 se-pn-ou-t 	 se-p-nou-t
signalizovali 	 signal-iz-ova-l-i 	 sign-al-iz-ova-l-i
silence 	 silence 	 silen-c-e
skutečnosti 	 s-kut-eč-n-ost-i 	 skuteč-n-ost-i
skutečném 	 s-kut-eč-n-é-m 	 skuteč-n-ém
slepou 	 slep-ou 	 s-lep-ou
sloupoví 	 sloup-ov-í 	 s-loup-ov-í
slovensko 	 sloven-sk-o 	 slov-en-sk-o
slovným 	 slov-n-ý-m 	 slov-n-ým
smetanový 	 smetan-ov-ý 	 smet-an-ov-ý
smrtelném 	 s-mr-tel-n-é-m 	 s-mr-teln-ém
smrtelnému 	 s-mr-tel-n-é-mu 	 s-mr-teln-ému
smyslových 	 s-mysl-ov-ý-ch 	 s-mysl-ov-ých
smésti 	 s-mést-i 	 s-més-ti
směl 	 smě-l 	 sm-ě-l
směrem 	 s-měr-e-m 	 s-měr-em
snahami 	 snah-a-m-i 	 snah-ami
solarmax 	 solar-max 	 solarmax
solidních 	 solid-n-í-ch 	 solid-n-ích
sotva 	 sotva 	 sotv-a
sousedního 	 sou-sed-n-í-ho 	 sou-sed-n-ího
soutěže 	 sou-těž-e 	 sou-těže
specifickým 	 speci-fic-k-ý-m 	 speci-fic-k-ým
spekulantem 	 spek-ul-ant-e-m 	 spek-ul-ant-em
spojkami 	 s-poj-k-a-m-i 	 s-poj-k-ami
spokojíte 	 s-pokoj-í-te 	 s-po-koj-í-te
spolupůsobit 	 spol-u-působ-i-t 	 spol-u-pů-sob-i-t
sponzorsky 	 sponzor-sk-y 	 spon-zorsk-y
spravedlivost 	 s-prav-ed-l-iv-ost 	 s-prav-ed-liv-ost
srdečně 	 srd-eč-n-ě 	 srdeč-n-ě
srozumitelně 	 s-roz-um-i-teln-ě 	 s-roz-umi-teln-ě
stadionu 	 stadion-u 	 stad-ion-u
stanovení 	 stan-ov-en-í 	 stanov-en-í
starožitných 	 star-o-ži-t-n-ých 	 star-ožit-n-ých
starých 	 star-ý-ch 	 star-ých
stavení 	 sta-v-en-í 	 stav-en-í
staška 	 staš-k-a 	 s-taš-k-a
stejném 	 stej-n-é-m 	 stejn-ém
stipendium 	 stipendi-um 	 stipendium
stojaté 	 stoj-at-é 	 stoj-a-t-é
stokorunovou 	 st-o-korun-ov-ou 	 stokorun-ov-ou
století 	 st-o-let-í 	 stol-et-í
stones 	 stone-s 	 stones
stovkou 	 st-ovk-ou 	 stovk-ou
stovku 	 st-ovk-u 	 stovk-u
strahov 	 strahov 	 strah-ov
strahova 	 strahov-a 	 strah-ov-a
strahově 	 strahov-ě 	 strah-ově
strašnicích 	 strašnic-í-ch 	 straš-nic-ích
strnutí 	 s-trn-u-t-í 	 s-tr-nu-t-í
studijní 	 stud-ij-n-í 	 studij-n-í
studiích 	 stud-i-í-ch 	 stud-i-ích
stál 	 stá-l 	 stál
stínit 	 stín-i-t 	 s-tín-i-t
stěžovatel 	 stěž-ova-tel 	 s-těž-ova-tel
střechách 	 střech-á-ch 	 střech-ách
stříbrolesklého 	 stříbr-o-lesk-l-é-ho 	 stříbr-o-lesk-l-ého
supraphon 	 supra-phon 	 supraphon
svalovou 	 sval-ov-ou 	 s-val-ov-ou
svrtět 	 s-vrt-ě-t 	 svrt-ě-t
svědomím 	 s-věd-om-í-m 	 s-věd-om-ím
světelné 	 svět-el-n-é 	 svět-eln-é
světelných 	 svět-el-n-ých 	 svět-eln-ých
světově 	 svět-ov-ě 	 svět-ově
synchronizovat 	 syn-chron-iz-ova-t 	 synchron-iz-ova-t
systematický 	 system-at-ic-k-ý 	 systemat-ic-k-ý
systémem 	 systém-e-m 	 systém-em
tajemství 	 taj-em-stv-í 	 tajem-stv-í
takzvaném 	 tak-zv-a-n-é-m 	 tak-zv-a-n-ém
tati 	 tat-i 	 t-a-ti
technologického 	 techn-o-log-ick-ého 	 technologic-k-ého
telat 	 tel-at 	 tel-a-t
telefonního 	 tele-fon-n-í-ho 	 tele-fon-n-ího
televize 	 televize 	 televiz-e
tendenci 	 tend-enc-i 	 tendenc-i
tenounkým 	 ten-oun-k-ý-m 	 ten-ounk-ým
tesklivých 	 tesk-l-iv-ý-ch 	 tesk-liv-ých
tetička 	 tet-ič-k-a 	 tet-ičk-a
textil 	 textil 	 text-i-l
thajska 	 thaj-sk-a 	 thajsk-a
tikem 	 tik-e-m 	 tik-em
tkalcovnictví 	 tka-lc-ovnic-tv-í 	 tk-a-l-c-ov-nic-tv-í
tlapkách 	 tlap-k-á-ch 	 tlap-k-ách
tomáš 	 tomáš 	 tom-á-š
traktorů 	 traktor-ů 	 trakt-or-ů
treperendo 	 treper-end-o 	 treperend-o
truhlářský 	 truhl-ář-sk-ý 	 truhlář-sk-ý
tržním 	 trž-n-ím 	 trž-n-í-m
turbovrtulových 	 turbo-vrt-ul-ov-ých 	 turbovrtul-ov-ých
turné 	 turné 	 turn-é
tvrzeními 	 tvrz-en-í-m-i 	 tvrz-en-ími
tzv 	 t-z-v 	 t-zv
téhož 	 t-é-ho-ž 	 t-ého-ž
tématu 	 tém-at-u 	 témat-u
tímto 	 t-í-m-t-o 	 t-ím-t-o
těhotenství 	 těhoten-ství 	 těhoten-stv-í
těmi 	 t-ě-m-i 	 t-ěmi
třemi 	 tř-e-m-i 	 tř-emi
třetím 	 tř-e-t-í-m 	 tř-et-í-m
třiceti 	 tř-i-cet-i 	 tř-i-ceti
třineckých 	 třinec-k-ých 	 tři-neck-ých
ukazuju 	 u-kaz-u-j-u 	 u-kaz-uj-u
ukrutným 	 u-krut-n-ý-m 	 u-krut-n-ým
ulici 	 ul-ic-i 	 ulic-i
uloženými 	 u-lož-en-ý-m-i 	 u-lož-en-ými
umožnilo 	 u-možn-i-l-o 	 u-mož-n-i-l-o
umožnily 	 u-možn-i-l-y 	 u-mož-n-i-l-y
uměle 	 u-m-ě-l-e 	 um-ě-l-e
umělostech 	 u-m-ě-l-ost-e-ch 	 um-ě-l-ost-ech
urgenci 	 urg-enc-i 	 urgenc-i
určitě 	 urč-it-ě 	 u-rč-it-ě
uschovávat 	 u-s-chov-á-v-a-t 	 u-s-chová-v-a-t
usd 	 u-s-d 	 u-sd
uskutečnily 	 u-s-kut-eč-n-i-l-y 	 u-skuteč-n-i-l-y
ustavičně 	 u-stav-ič-n-ě 	 u-stavič-n-ě
ustrnule 	 u-s-trn-u-l-e 	 u-s-tr-nu-l-e
uzpůsobit 	 u-z-působ-i-t 	 u-z-pů-sob-i-t
uživit 	 u-živ-i-t 	 u-ži-v-i-t
vanka 	 van-k-a 	 vank-a
velikou 	 vel-ik-ou 	 velik-ou
velkého 	 vel-k-é-ho 	 vel-k-ého
velvyslanectví 	 vel-vy-sl-a-n-ec-tv-í 	 velvy-slan-ec-tv-í
ventures 	 venture-s 	 ventures
vepsat 	 ve-ps-a-t 	 veps-a-t
veslař 	 vesl-ař 	 veslař
vesnici 	 ves-nic-i 	 vesnic-i
vespolek 	 ve-s-pol-ek 	 ve-spolek
vezmeš 	 vez-m-e-š 	 vez-meš
vezmou 	 vez-m-ou 	 vez-mou
veřejně 	 veř-ej-n-ě 	 veřej-n-ě
veškerým 	 veš-k-er-ý-m 	 veš-k-er-ým
vinohradského 	 vinohrad-sk-é-ho 	 vinohrad-sk-ého
virile 	 virile 	 viril-e
vlastního 	 vlast-n-í-ho 	 vlast-n-ího
vnitřnostech 	 v-nitř-n-ost-e-ch 	 v-nitř-n-ost-ech
vobléknutelný 	 v-ob-lék-nu-teln-ý 	 v-oblék-nu-teln-ý
vodolově 	 vodolov-ě 	 vodol-ov-ě
vrtulníky 	 vrt-ul-ník-y 	 vrtul-n-ík-y
vstupenek 	 vs-tup-en-ek 	 v-stup-en-ek
vstupenka 	 v-stup-enk-a 	 v-stupenk-a
vstupenku 	 v-stup-enk-u 	 v-stupen-k-u
vstupenky 	 vstup-enk-y 	 v-stupen-k-y
vyabstrahovat 	 vy-abs-trah-ova-t 	 vy-abstrah-ova-t
vydávaje 	 vy-d-á-v-aj-e 	 vy-d-áv-aj-e
vyjel 	 vy-je-l 	 vy-jel
vynaložením 	 vy-na-lož-en-í-m 	 vy-na-lož-en-ím
vynesla 	 vy-nes-l-a 	 vy-nesl-a
vypočísti 	 vy-po-číst-i 	 vy-po-čís-ti
vysokoškolské 	 vys-ok-o-škol-sk-é 	 vys-oko-škol-sk-é
vysokoškolský 	 vys-ok-o-škol-sk-ý 	 vys-oko-škol-sk-ý
vyspinkat 	 vy-sp-ink-a-t 	 vy-spink-a-t
vyspělým 	 vy-spě-l-ým 	 vy-spěl-ým
vyčísti 	 vy-číst-i 	 vy-čís-ti
vyřinout 	 vy-řin-ou-t 	 vy-ři-nou-t
vzdělání 	 vz-děl-án-í 	 vz-děl-á-n-í
vzít 	 vz-í-t 	 v-z-í-t
válka 	 válk-a 	 vál-k-a
vás 	 v-á-s 	 v-ás
víte 	 v-í-te 	 ví-te
vítkovice 	 vít-k-ov-ic-e 	 vít-k-ovic-e
vítězství 	 vítěz-ství 	 vítěz-stv-í
výdělečných 	 vý-děl-eč-n-ých 	 vý-děleč-n-ých
výsostným 	 výs-ost-n-ý-m 	 výs-ost-n-ým
výukových 	 vý-uk-ov-ých 	 výuk-ov-ých
výčitek 	 vý-čit-e-k 	 vý-čit-ek
výší 	 výš-í 	 vý-š-í
všeobecně 	 vš-e-obec-n-ě 	 vš-eobec-n-ě
vůnička 	 vůn-ič-k-a 	 vůn-ičk-a
westermannem 	 westermann-e-m 	 westermann-em
yse 	 y-s-e 	 ys-e
zabijeme 	 za-bi-je-me 	 za-bije-me
zafilosofovat 	 za-filo-sof-ova-t 	 za-filosof-ova-t
zahozených 	 za-hoz-en-ý-ch 	 za-hoz-en-ých
zahynul 	 za-hyn-u-l 	 za-hy-nu-l
zakusitelno 	 za-kus-i-tel-n-o 	 za-kus-i-teln-o
zapomínat 	 za-pomín-a-t 	 za-po-mín-a-t
započísti 	 za-po-číst-i 	 za-po-čís-ti
zasahují 	 za-sah-u-j-í 	 za-sah-uj-í
zatvrzují 	 za-tvrz-u-j-í 	 za-tvrz-uj-í
zaujatý 	 z-au-j-a-t-ý 	 za-u-j-a-t-ý
zaujmouti 	 zau-jm-ou-ti 	 za-uj-mou-ti
zavřeny 	 za-vř-e-n-y 	 za-vř-en-y
zchlapčilý 	 z-chlap-č-i-l-ý 	 z-chlapč-i-l-ý
zdeformovat 	 z-de-form-ova-t 	 z-deform-ova-t
zdeničky 	 zden-ič-k-y 	 zden-ičk-y
zdeněk 	 zdeněk 	 z-den-ěk
zemím 	 zem-ím 	 zem-í-m
zemědělských 	 zem-ě-děl-sk-ých 	 země-děl-sk-ých
zfalšování 	 z-falš-ová-n-í 	 z-fal-š-ová-n-í
zločinem 	 zl-o-čin-e-m 	 zl-o-čin-em
změněném 	 z-měn-ěn-é-m 	 z-měn-ěn-ém
zneužití 	 z-ne-u-ži-t-í 	 z-ne-uži-t-í
znovuoživenost 	 z-nov-u-o-živ-en-ost 	 z-nov-u-o-ži-v-en-ost
zostoudit 	 z-o-stoud-i-t 	 z-ostoud-i-t
zprůmyslnělost 	 z-prů-mysl-n-ě-l-ost 	 z-prů-mysln-ěl-ost
zpět 	 zpět 	 zp-ě-t
zpěvačka 	 z-pě-v-a-č-k-a 	 z-pěv-ačk-a
zrakový 	 zrak-ov-ý 	 z-rak-ov-ý
ztotožnit 	 z-to-tož-n-i-t 	 z-totož-n-i-t
zuhelnět 	 z-uhel-n-ě-t 	 z-uheln-ě-t
zveřejněné 	 z-veřej-n-ě-n-é 	 z-veřejn-ěn-é
zveřejnění 	 z-veřej-n-ě-n-í 	 z-veřejn-ěn-í
zvláště 	 zvláště 	 z-vlášt-ě
zvlášť 	 zvlášť 	 z-vlášť
zvroucnit 	 z-vr-ou-c-n-i-t 	 z-vrou-c-n-i-t
zvídavější 	 z-víd-a-v-ějš-í 	 z-víd-a-vějš-í
zádech 	 zád-e-ch 	 zád-ech
základem 	 zá-klad-e-m 	 zá-klad-em
závojnatkách 	 zá-voj-n-at-k-á-ch 	 zá-voj-n-at-k-ách
zůstal 	 z-ů-sta-l 	 zů-sta-l
zůstanou 	 z-ů-sta-n-ou 	 zů-sta-n-ou
útrobách 	 útrob-ách 	 ú-trob-ách
úžasem 	 ú-žas-e-m 	 ú-žas-em
čepice 	 čep-ic-e 	 čepic-e
černým 	 čern-ý-m 	 čern-ým
černýšovice 	 čern-ýš-ov-ic-e 	 čern-ýšovic-e
českomalínský 	 česk-o-malín-sk-ý 	 čes-k-o-malín-sk-ý
českého 	 čes-k-é-ho 	 čes-k-ého
článkem 	 člán-k-e-m 	 člán-k-em
čsfr 	 č-s-f-r 	 čsfr
čsn 	 č-s-n 	 čsn
čssr 	 č-s-s-r 	 čssr
čubička 	 čub-ič-k-a 	 čub-ičk-a
čubičku 	 čub-ič-k-u 	 čub-ičk-u
čzpi 	 č-z-p-i 	 čzp-i
řepkového 	 řep-k-ov-ého 	 řepk-ov-ého
šifrovaných 	 šifr-ova-n-ý-ch 	 šifr-ova-n-ých
šumperka 	 šumperk-a 	 šumper-k-a
šíblová 	 šíbl-ová 	 šíbl-ov-á
žehravost 	 žehr-a-v-ost 	 žehrav-ost
železárnách 	 želez-árn-ách 	 železár-n-ách
ženatý 	 žen-at-ý 	 ženat-ý
živnostenského 	 ži-v-n-ost-ensk-ého 	 živ-nosten-sk-ého
životními 	 ži-v-ot-n-í-m-i 	 ži-v-ot-n-ími
žlábkovávající 	 žláb-k-ová-v-aj-íc-í 	 žlábk-ová-v-aj-íc-í
