absolutno 	 absolut-n-o 	 absolut-no
absolventi 	 ab-solv-ent-i 	 absolventi
abychom 	 a-by-chom 	 abychom
achronisticky 	 a-chron-ist-ic-k-y 	 achronist-ick-y
adaptabilní 	 adapt-abil-n-í 	 adaptabiln-í
adresátů 	 adres-át-ů 	 adresát-ů
advokát 	 advok-át 	 advokát
aeromagneticky 	 aero-magnet-ic-k-y 	 aeromagneticky
agovávat 	 agov-á-v-a-t 	 agová-v-a-t
akceptovat 	 akcept-ova-t 	 akcept-ovat
aktivitami 	 akt-iv-it-ami 	 aktiv-itami
aktovce 	 akt-ov-c-e 	 akt-ovc-e
aktuálního 	 akt-uál-n-ího 	 aktuálního
albigenský 	 albigen-sk-ý 	 albigensk-ý
aloise 	 alois-e 	 aloise
amerikanismem 	 amerik-an-ism-e-m 	 amerik-anismem
amerikánská 	 amerik-án-sk-á 	 amerik-ánsk-á
američanům 	 američ-an-ům 	 američan-ům
amplifikovat 	 ampli-fik-ova-t 	 amplifik-ovat
anatólii 	 anatól-i-i 	 anatólii
anglii 	 angl-i-i 	 angl-ii
anglosaskou 	 angl-o-sas-k-ou 	 anglosaskou
antala 	 antal-a 	 anta-l-a
anthony 	 anthony 	 anthon-y
anticipovat 	 anti-cip-ova-t 	 anticipovat
antidatujeme 	 anti-dat-uje-me 	 antidat-ujeme
architektury 	 archi-tekt-ur-y 	 architektury
arcilotras 	 arci-lotr-as 	 arcilotras
argentiny 	 argentin-y 	 argentiny
aristokratismu 	 aristo-krat-ism-u 	 aristokratismu
asekurovat 	 a-sekur-ova-t 	 asekur-ova-t
asistentů 	 asist-ent-ů 	 asistent-ů
atamanem 	 ataman-e-m 	 atamanem
austrálie 	 austrál-i-e 	 austrálie
autobazar 	 aut-o-bazar 	 autobazar
automobilka 	 automobil-k-a 	 aut-o-mobilka
autorská 	 autor-sk-á 	 autorsk-á
avšak 	 a-však 	 avšak
babičku 	 bab-ič-k-u 	 bab-ičk-u
bafnout 	 baf-nou-t 	 baf-nout
bakalářském 	 bakalář-sk-ém 	 bakalářském
balený 	 bal-en-ý 	 balen-ý
balených 	 bal-en-ých 	 balen-ých
balgarův 	 balgar-ův 	 balgarův
balit 	 bal-i-t 	 bali-t
bankovek 	 bank-ovek 	 bankovek
bankovním 	 bank-ovn-ím 	 bank-ov-n-ím
barikádovat 	 barik-ád-ova-t 	 barikád-ovat
bartoch 	 bartoch 	 bart-och
basovat 	 bas-ova-t 	 bas-ovat
batňovic 	 batňovic 	 bat-ň-ovic
bekem 	 bekem 	 bek-em
benediktýnů 	 benedikt-ýn-ů 	 benediktýnů
benzylchorid 	 benz-yl-chor-id 	 benzylchorid
beranit 	 beran-i-t 	 beran-it
berehovsky 	 bereh-ov-sk-y 	 berehovsk-y
bezesných 	 beze-sn-ých 	 bezesných
bezpečný 	 bezpeč-n-ý 	 bez-peč-n-ý
bezpředpokladová 	 bez-před-po-klad-ov-á 	 bez-před-pokladová
bečce 	 beč-c-e 	 bečc-e
bionaftu 	 bio-naft-u 	 bionaft-u
bionafty 	 bio-naft-y 	 bionaft-y
biřmovat 	 biřm-ova-t 	 biřm-ovat
blahopřejeme 	 blah-o-pře-je-me 	 blahopřejeme
blechu 	 blech-u 	 blechu
blekotat 	 blek-ot-a-t 	 blekota-t
bloku 	 blok-u 	 bloku
blouznit 	 blouzn-i-t 	 blouz-ni-t
bludišti 	 blud-išt-i 	 blud-išti
bobek 	 bob-ek 	 bobek
bodiny 	 bod-in-y 	 bodin-y
bolení 	 bol-e-n-í 	 bol-en-í
bolest 	 bol-est 	 bolest
bolívie 	 bolív-i-e 	 bol-ív-ie
božínku 	 bož-ín-k-u 	 bož-ínk-u
branka 	 bran-k-a 	 brank-a
brankář 	 bran-k-ář 	 brankář
brečeli 	 breč-e-l-i 	 breč-eli
britské 	 brit-sk-é 	 britsk-é
bráchův 	 brách-ův 	 bráchův
brázdit 	 brázd-i-t 	 brázdi-t
brýlemi 	 brýl-emi 	 brýlemi
budoucnosti 	 bud-ou-c-n-ost-i 	 bud-ouc-n-osti
budoucím 	 bud-ouc-ím 	 budouc-í-m
budweiserová 	 budweiser-ov-á 	 bud-weiserová
bujně 	 buj-n-ě 	 bujn-ě
bych 	 by-ch 	 bych
byla 	 by-l-a 	 byl-a
bytu 	 by-t-u 	 byt-u
bytě 	 by-t-ě 	 byt-ě
bázlivá 	 bá-z-l-iv-á 	 báz-liv-á
bít 	 bí-t 	 bít
bývávaly 	 bý-v-á-v-a-l-y 	 býváv-al-y
běláskové 	 běl-ás-k-ové 	 bělásk-ové
běžně 	 běž-ně 	 běž-n-ě
bříško 	 bříš-k-o 	 bříšk-o
celkovou 	 cel-k-ov-ou 	 celk-ovou
celková 	 cel-k-ov-á 	 celk-ová
celkové 	 cel-k-ov-é 	 celk-ové
celníky 	 cel-n-ík-y 	 cel-ník-y
celoživotní 	 cel-o-ži-v-ot-n-í 	 celož-ivot-n-í
centru 	 centr-u 	 centru
ceník 	 cen-ík 	 ceník
cepovat 	 cep-ova-t 	 cep-ovat
cestovní 	 cest-ov-n-í 	 cest-ovn-í
cestující 	 cest-uj-í-c-í 	 cest-uj-íc-í
charakterem 	 charakter-em 	 charakterem
charakteru 	 charakter-u 	 charakteru
chcete 	 chc-e-te 	 chcete
chcíplá 	 chcíp-l-á 	 chcípl-á
chladná 	 chlad-n-á 	 chladn-á
chlapec 	 chlap-ec 	 chlapec
chlapík 	 chlap-ík 	 chlapík
chlácholil 	 chláchol-i-l 	 chlácholil
chromou 	 chrom-ou 	 chromou
chrstat 	 chrst-a-t 	 chrsta-t
chránit 	 chrán-i-t 	 chrán-it
chtěli 	 cht-ě-l-i 	 chtě-l-i
chudáci 	 chud-ác-i 	 chud-áci
chutnání 	 chut-n-á-n-í 	 chut-n-án-í
chvalořečit 	 chval-o-řeč-i-t 	 chvalořeči-t
chvilce 	 chvil-c-e 	 chvilc-e
chvílích 	 chvíl-í-ch 	 chvíl-ích
chyběl 	 chyb-ě-l 	 chyb-ěl
chystané 	 chyst-a-n-é 	 chyst-an-é
cigarety 	 cigar-et-y 	 cigaret-y
cimrmanovština 	 cimrman-ov-št-in-a 	 cimrman-ovština
citlivostí 	 cit-l-iv-ost-í 	 citl-ivost-í
cizince 	 ciz-in-c-e 	 cizince
cos 	 c-o-s 	 cos
couvnout 	 couv-nou-t 	 couv-nout
ctihodnými 	 ct-i-hod-n-ý-m-i 	 cti-hod-n-ými
cyklu 	 cykl-u 	 cyklu
cácorka 	 các-or-k-a 	 cácork-a
cílem 	 cíl-e-m 	 cíl-em
cílevědomý 	 cíl-e-věd-om-ý 	 cíl-evědom-ý
daktyloskopie 	 daktylo-skopi-e 	 daktyloskopie
dali 	 d-a-l-i 	 dal-i
daly 	 d-a-l-y 	 dal-y
danost 	 d-a-n-ost 	 dan-ost
dané 	 d-a-n-é 	 dan-é
degradovat 	 de-grad-ova-t 	 degrad-ova-t
deklarována 	 de-klar-ová-n-a 	 deklar-ována
deklarováno 	 de-klar-ová-n-o 	 deklar-ováno
deklarují 	 de-klar-uj-í 	 deklar-uj-í
delikátnostem 	 delikát-n-ost-e-m 	 delikát-n-ostem
delonovsky 	 delon-ov-sk-y 	 delonovsk-y
delší 	 del-š-í 	 delš-í
demokratizovat 	 demo-krat-iz-ova-t 	 demokratizovat
demoralizovat 	 de-moral-iz-ova-t 	 demoral-iz-ovat
denním 	 den-n-í-m 	 den-n-ím
desíti 	 desít-i 	 desíti
devět 	 devět 	 devě-t
dezinfikovat 	 dez-infik-ova-t 	 dezin-fik-ovat
dezinteresovat 	 dez-interes-ova-t 	 dezinteresovat
dezorganizovat 	 dez-organ-iz-ova-t 	 dez-organ-izovat
dešifrovat 	 de-šifr-ova-t 	 dešifr-ova-t
diavolo 	 diavolo 	 diav-olo
diplomové 	 diplom-ov-é 	 diplom-ové
disciplíny 	 disciplín-y 	 dis-ciplín-y
diskařský 	 disk-ař-sk-ý 	 diskařsk-ý
diskreditovat 	 dis-kred-it-ova-t 	 dis-kred-it-ovat
distanční 	 dis-tanč-n-í 	 distanč-n-í
divoši 	 div-oš-i 	 divoši
divák 	 div-ák 	 divák
dkp 	 d-k-p 	 dkp
dlouhodobého 	 dlouh-o-dob-ého 	 dlouhodob-ého
dnešek 	 dneš-ek 	 dnešek
dno 	 dn-o 	 dno
dober 	 do-ber 	 dober
dobrodiní 	 dobr-o-di-n-í 	 dobrodiní
dobrozdání 	 dobr-o-zd-á-n-í 	 dobrozdán-í
dobráka 	 dobr-ák-a 	 dobrák-a
dobudovat 	 do-bud-ova-t 	 dobud-ova-t
dobyli 	 do-by-l-i 	 doby-l-i
dobytek 	 do-byt-ek 	 dobytek
dobytí 	 do-by-tí 	 dobyt-í
dobíhají 	 do-bíh-aj-í 	 dobíh-aj-í
dodacích 	 do-d-a-c-ích 	 doda-c-ích
dodat 	 do-d-a-t 	 doda-t
dodavatel 	 do-d-a-v-a-tel 	 dod-a-v-atel
dodavatelem 	 do-d-a-v-a-tel-em 	 dod-a-v-atelem
dodiveně 	 do-div-en-ě 	 dodiv-en-ě
dodržovat 	 do-drž-ova-t 	 dodrž-ovat
dodáno 	 do-d-á-n-o 	 dodá-n-o
dodávat 	 do-d-á-v-a-t 	 dod-á-v-at
dodávka 	 do-d-á-v-k-a 	 dod-ávk-a
dohodou 	 do-hod-ou 	 dohod-ou
dojmů 	 do-jm-ů 	 dojm-ů
doklady 	 do-klad-y 	 doklad-y
doklopýtat 	 do-klopýt-a-t 	 doklopýt-a-t
dokonaleji 	 do-kon-a-l-eji 	 dokon-al-eji
dokonalého 	 do-kon-a-l-é-ho 	 dokon-al-ého
dokončovat 	 do-konč-ova-t 	 dokonč-ova-t
dokáže 	 do-káž-e 	 dokáže
dokáží 	 do-káž-í 	 dokáž-í
doletovat 	 do-let-ova-t 	 dolet-ova-t
dolnolužický 	 doln-o-luž-ick-ý 	 dol-nolužický
doloudat 	 do-loud-a-t 	 doloud-a-t
donést 	 do-nés-t 	 donést
dopomáhat 	 do-po-máh-a-t 	 dopo-máh-a-t
dopít 	 do-pí-t 	 dopí-t
dorachtávatelnost 	 do-racht-á-v-a-teln-ost 	 do-racht-á-v-a-telnost
dotazníky 	 do-taz-ník-y 	 dotaz-ník-y
dotazy 	 do-taz-y 	 dotaz-y
dovedeš 	 do-ved-e-š 	 dovedeš
dovinout 	 do-vi-nou-t 	 dovi-nou-t
dovnitř 	 do-v-nitř 	 dovnitř
dovolí 	 do-vol-í 	 dovol-í
dovozem 	 do-voz-em 	 dovoz-em
dovřít 	 do-vř-í-t 	 dovř-í-t
dozvíte 	 do-z-v-í-te 	 dozv-í-te
dozvěděli 	 do-z-věd-ě-l-i 	 doz-věd-ěli
dočtete 	 do-čt-e-te 	 dočtete
dočíst 	 do-čís-t 	 dočíst
doštupování 	 do-štup-ová-n-í 	 do-štup-ová-ní
dožebrat 	 do-žebr-a-t 	 dožebr-a-t
drbaný 	 drb-a-n-ý 	 drba-n-ý
drkotali 	 drk-ot-a-l-i 	 drkotal-i
druhém 	 druh-é-m 	 druh-ém
družnosti 	 druž-n-ost-i 	 druž-n-osti
drápek 	 dráp-ek 	 drápek
dubnové 	 dubn-ov-é 	 dubn-ové
dupání 	 dup-á-n-í 	 dupá-n-í
dvanáct 	 dv-a-náct 	 dvanáct
dveřích 	 dveř-í-ch 	 dveř-ích
dvojnásobek 	 dv-oj-ná-sob-ek 	 dvoj-n-ásobek
dvojí 	 dv-oj-í 	 dvoj-í
dvouměsíční 	 dv-ou-měsíč-n-í 	 dvouměsíčn-í
dvoustraně 	 dv-ou-stran-ě 	 dvoustran-ě
dynamická 	 dynam-ic-k-á 	 dynamick-á
dynamika 	 dynam-ik-a 	 dynamik-a
dálkové 	 dál-k-ov-é 	 dálk-ové
dává 	 d-á-v-á 	 dáv-á
dávána 	 d-á-v-á-n-a 	 dáván-a
dívám 	 dív-á-m 	 dív-ám
díváš 	 dív-á-š 	 dív-áš
dědečkův 	 děd-eč-k-ův 	 děd-ečk-ův
dějiny 	 děj-in-y 	 dějin-y
děkovat 	 děk-ova-t 	 děk-ovat
dělostřelec 	 děl-o-střel-ec 	 děl-ostřelec
děti 	 dět-i 	 děti
dětské 	 dět-sk-é 	 dětsk-é
dětským 	 dět-sk-ým 	 dětsk-ým
dřevěný 	 dřev-ě-n-ý 	 dřev-ěn-ý
dřít 	 dř-í-t 	 dří-t
dřívějších 	 dřív-ějš-ích 	 dřívěj-š-ích
důchod 	 dů-chod 	 důchod
důchodového 	 dů-chod-ov-ého 	 důchod-ového
důkladněji 	 dů-klad-n-ěji 	 důklad-n-ěji
důležitost 	 dů-lež-it-ost 	 důlež-itost
důležitá 	 dů-lež-it-á 	 důlež-it-á
důsledky 	 dů-sled-k-y 	 důsledk-y
důvěrnosti 	 dů-věr-n-ost-i 	 důvěr-n-osti
důvěře 	 dů-věř-e 	 důvěř-e
ekologického 	 eko-log-ick-ého 	 eko-logick-ého
ekonomech 	 eko-nom-ech 	 eko-nomech
ekonomickou 	 eko-nom-ick-ou 	 eko-nomickou
ekonomové 	 eko-nom-ov-é 	 eko-nom-ové
empirických 	 empir-ic-k-ý-ch 	 empir-ick-ých
energie 	 energ-i-e 	 energie
epocha 	 epoch-a 	 epocha
eva 	 ev-a 	 eva
experiment 	 experi-ment 	 experiment
experimentaci 	 experi-ment-ac-i 	 experimentaci
exportu 	 ex-port-u 	 export-u
faktorů 	 fakt-or-ů 	 faktor-ů
faktury 	 fakt-ur-y 	 faktur-y
fanoušků 	 fan-oušk-ů 	 fanoušk-ů
farmaceutické 	 farmac-eut-ick-é 	 farm-aceutické
filiace 	 fili-ac-e 	 fili-ace
filozofické 	 filo-zof-ic-k-é 	 fil-o-zofické
finesami 	 fines-ami 	 finesami
finálním 	 fin-ál-n-ím 	 finál-ním
fondem 	 fondem 	 fond-em
formosu 	 formos-u 	 form-os-u
formulací 	 form-ul-ac-í 	 formulac-í
fosforeskovat 	 fosfor-esk-ova-t 	 fos-foreskovat
fošen 	 fošen 	 foš-en
francouzsky 	 franc-ouz-sk-y 	 francouzsky
francouzského 	 franc-ouz-sk-ého 	 francouzského
františek 	 frant-iš-ek 	 františek
friesovský 	 fries-ov-sk-ý 	 friesovsk-ý
frotýrovat 	 frot-ýr-ova-t 	 frotýr-ova-t
ft 	 f-t 	 ft
fyzický 	 fyz-ic-k-ý 	 fyzick-ý
fólie 	 fóli-e 	 fól-ie
garance 	 garanc-e 	 garance
gastronomie 	 gastr-o-nom-i-e 	 gastronomie
generace 	 gener-ac-e 	 generace
generál 	 gener-ál 	 generál
gestikulovat 	 gestik-ul-ova-t 	 gestikul-ovat
greenwalda 	 green-wald-a 	 greenwald-a
greenwaldovi 	 green-wald-ovi 	 greenwaldovi
gurkhský 	 gurkh-sk-ý 	 gurkhsk-ý
haló 	 haló 	 hal-ó
hamonit 	 hamon-i-t 	 hamon-it
hegelianism 	 hegelian-ism 	 hegelianism
hejkavec 	 hejkavec 	 hejk-avec
hematologického 	 hemat-o-log-ick-ého 	 hemat-o-log-ického
hladověli 	 hlad-ov-ě-l-i 	 hlad-ověli
hledajíc 	 hled-aj-íc 	 hled-ajíc
hledisku 	 hled-isk-u 	 hledisk-u
hledám 	 hled-á-m 	 hled-ám
hluboká 	 hlub-ok-á 	 hlubok-á
hlášeno 	 hláš-en-o 	 hláš-eno
hmotnostech 	 hmot-n-ost-ech 	 hmot-n-ostech
hmotnosti 	 hmot-n-ost-i 	 hmot-n-osti
hmotného 	 hmot-n-é-ho 	 hmot-n-ého
hnedle 	 hned-le 	 hnedle
hnutí 	 h-nu-t-í 	 hnut-í
hnízdech 	 hnízd-e-ch 	 hnízdech
hochschule 	 hoch-schule 	 hochschule
hodinek 	 hodin-ek 	 hodinek
hodinou 	 hodin-ou 	 hod-in-ou
hodnotu 	 hod-n-ot-u 	 hodn-ot-u
hodnotím 	 hod-n-ot-í-m 	 hod-n-otím
hodnotíte 	 hodn-ot-í-te 	 hod-n-otí-te
hojně 	 hoj-n-ě 	 hojn-ě
holandsku 	 holand-sk-u 	 holandsk-u
holanďan 	 holanď-an 	 holanďan
holiči 	 hol-i-č-i 	 holič-i
holčičkou 	 hol-č-ič-k-ou 	 holč-ičk-ou
honoráře 	 honor-ář-e 	 honoráře
horolezci 	 hor-o-lez-c-i 	 horolezci
horoucně 	 hor-ou-c-n-ě 	 horouc-n-ě
hotovostí 	 hotov-ost-í 	 hotov-ostí
houževnatá 	 houžev-n-at-á 	 houževnat-á
hovět 	 hov-ě-t 	 hově-t
hra 	 hr-a 	 hra
hrbáčův 	 hrb-áč-ův 	 hrbáč-ův
hromková 	 hrom-k-ov-á 	 hromk-ov-á
hroznou 	 hrozn-ou 	 hroz-n-ou
hry 	 hr-y 	 hry
hrála 	 hrá-l-a 	 hrál-a
hrálo 	 hrá-l-o 	 hrál-o
hubovat 	 hub-ova-t 	 hub-ovat
hudby 	 hud-b-y 	 hudb-y
hudební 	 hud-eb-n-í 	 hudeb-n-í
hudebníci 	 hud-eb-níc-i 	 hudeb-níc-i
husími 	 hus-í-m-i 	 hus-ími
huti 	 hut-i 	 huti
hvězdičky 	 hvězd-ič-k-y 	 hvězd-ičk-y
hřbitov 	 hřbitov 	 hřbit-ov
hřebec 	 hřeb-ec 	 hřebec
hřmět 	 hřm-ě-t 	 hřmě-t
identifikační 	 identi-fik-ač-n-í 	 identi-fik-ační
imigraci 	 i-migr-ac-i 	 imigrac-i
improvizovat 	 im-prov-iz-ova-t 	 improvizovat
imunoenzymatický 	 imun-o-enzym-at-ick-ý 	 imun-oenzymatic-k-ý
inaugurován 	 inaugur-ová-n 	 inaugur-ován
indikátorem 	 in-dik-át-or-em 	 indikátorem
individuální 	 in-divid-u-ál-n-í 	 individuální
informačním 	 in-form-ač-n-ím 	 informač-n-ím
informovat 	 in-form-ova-t 	 inform-ova-t
informován 	 in-form-ová-n 	 inform-ován
informuje 	 in-form-uje 	 inform-uje
inkriminované 	 in-krimin-ova-n-é 	 inkrimin-ova-n-é
inspektor 	 in-spekt-or 	 inspektor
inspirovat 	 in-spir-ova-t 	 inspir-ova-t
instalaci 	 in-stal-ac-i 	 instalac-i
instrumentovat 	 instrument-ova-t 	 instrumentovat
instrumentů 	 instru-ment-ů 	 instrumentů
inteligenci 	 intelig-enc-i 	 inteligenci
interesovat 	 interes-ova-t 	 interes-ovat
intuice 	 intuic-e 	 intuice
invalidní 	 in-valid-n-í 	 invalid-n-í
investičními 	 in-vest-ič-n-ími 	 investič-n-ími
investovalo 	 in-vest-ova-l-o 	 invest-ovalo
inzerátech 	 inzer-át-e-ch 	 inzerát-ech
inženýrském 	 inženýr-sk-ém 	 inženýrsk-ém
ivančic 	 ivan-č-ic 	 ivan-čic
jablíčko 	 jablíč-k-o 	 jabl-íčk-o
jakoby 	 jak-o-by 	 jakob-y
jakoupak 	 jak-ou-pak 	 jakoupak
jakého 	 jak-é-ho 	 jak-ého
jakéhokoliv 	 jak-é-ho-koliv 	 jak-éhokoliv
jakže 	 jak-že 	 jakže
jamese 	 james-e 	 jamese
janků 	 jan-k-ů 	 jank-ů
jazejček 	 jazejč-ek 	 jazejček
jděte 	 jd-ě-te 	 jdě-te
jednak 	 jednak 	 jedn-ak
jednali 	 jedn-a-l-i 	 jedn-a-li
jednatelem 	 jedn-a-tel-e-m 	 jedn-a-telem
jednom 	 jedn-o-m 	 jedn-om
jednomotorových 	 jedn-o-motor-ov-ých 	 jedn-omotorových
jednomu 	 jedn-o-mu 	 jedn-omu
jednoosý 	 jedn-o-os-ý 	 jedn-oos-ý
jednorázové 	 jedn-o-ráz-ov-é 	 jedn-orázové
jednotlivina 	 jedn-ot-liv-in-a 	 jedn-ot-l-ivina
jednotlivými 	 jedn-ot-liv-ými 	 jed-n-otliv-ými
jedním 	 jedn-í-m 	 jedn-ím
jejích 	 je-j-í-ch 	 jej-ích
jela 	 je-l-a 	 jel-a
jenjen 	 jen-jen 	 jenjen
jenže 	 jen-že 	 jenže
jeskyni 	 jeskyn-i 	 jeskyni
jevil 	 jev-i-l 	 jevi-l
ješitnost 	 ješit-n-ost 	 ješit-nost
ježibabo 	 ježibab-o 	 ježibabo
jimž 	 j-i-m-ž 	 jimž
jindy 	 jin-d-y 	 jind-y
jinonice 	 jinonic-e 	 jinonice
jistota 	 jist-ot-a 	 jist-ota
jmenují 	 jmen-u-j-í 	 jmen-uj-í
jupiterovy 	 jupiter-ov-y 	 jupiterov-y
juránkův 	 jur-ánk-ův 	 juránk-ův
jídlo 	 jí-dl-o 	 jídl-o
kadidlo 	 kad-i-dl-o 	 kadidl-o
kalkulovat 	 kalk-ul-ova-t 	 kalkul-ova-t
kanada 	 kanad-a 	 kanada
kanadou 	 kanad-ou 	 kanadou
kanadské 	 kanad-sk-é 	 kanadsk-é
kanadský 	 kanad-sk-ý 	 kanadsk-ý
kanadských 	 kanad-sk-ých 	 kanadsk-ých
kanadským 	 kanad-sk-ým 	 kanadsk-ým
kanady 	 kanad-y 	 kanady
kanadě 	 kanad-ě 	 kanadě
kanonizovat 	 kanon-iz-ova-t 	 kanon-izovat
kapelu 	 kapel-u 	 kapelu
kapesníček 	 kapes-níč-ek 	 kapes-níček
kapli 	 kapl-i 	 kap-li
karlík 	 karl-ík 	 karlík
katalogy 	 kata-log-y 	 katalog-y
katalozích 	 kata-loz-ích 	 kataloz-ích
kavalírem 	 kaval-ír-e-m 	 kavalírem
kavkám 	 kav-k-ám 	 kavk-ám
každému 	 každ-é-mu 	 každ-ému
kdovíkdo 	 kd-o-v-í-kd-o 	 kdovíkdo
kdož 	 kdo-ž 	 kdož
kg 	 k-g 	 kg
klasifikaci 	 klasi-fik-ac-i 	 klasifik-aci
klečela 	 kleč-e-l-a 	 kleč-el-a
klnout 	 kl-nou-t 	 klnou-t
klást 	 klás-t 	 klást
klášterem 	 klášter-e-m 	 klášterem
knihovat 	 knih-ova-t 	 knih-ovat
knížete 	 kníž-et-e 	 kníž-e-te
kocouří 	 koc-ouř-í 	 kocouř-í
kodrcat 	 kodrc-a-t 	 kodrcat
koho 	 k-o-ho 	 koho
koledovat 	 koled-ova-t 	 koled-ovat
koleno 	 kolen-o 	 koleno
kolísat 	 kolís-a-t 	 kolís-at
komorník 	 komor-n-ík 	 komor-ník
kompetenci 	 kompet-enc-i 	 kompetenc-i
komu 	 k-o-mu 	 kom-u
konceptem 	 koncept-em 	 konceptem
koncert 	 koncert 	 kon-cert
koncertem 	 koncert-em 	 koncertem
koncertní 	 koncert-n-í 	 koncert-ní
koncertě 	 koncert-ě 	 kon-cert-ě
koncipováním 	 kon-cip-ová-n-ím 	 koncip-ová-ním
kondenzátor 	 kondenz-átor 	 kondenzátor
konečná 	 koneč-n-á 	 konečn-á
konfederovat 	 kon-feder-ova-t 	 kon-federovat
konkretizovat 	 kon-kret-iz-ova-t 	 kon-kret-izovat
konkrétního 	 konkrét-n-ího 	 konkrét-ního
konkrétnímu 	 kon-krét-n-í-mu 	 konkrét-nímu
konstatování 	 kon-stat-ová-n-í 	 kon-stat-ová-ní
kontaminovat 	 kon-tamin-ova-t 	 kontaminovat
kontilití 	 konti-li-t-í 	 kontilit-í
kontraindikace 	 kontra-in-dik-ac-e 	 kontraindik-ace
kontrolorů 	 kontrol-or-ů 	 kontrolor-ů
kontrolovaná 	 kontrol-ova-n-á 	 kontrol-ovan-á
kontroloři 	 kontrol-oř-i 	 kontroloři
konvenovat 	 konven-ova-t 	 konven-ovat
konviktem 	 kon-vikt-e-m 	 konviktem
konírny 	 kon-ír-n-y 	 konírn-y
kopce 	 kop-c-e 	 kopc-e
kopnout 	 kop-nou-t 	 kop-nout
kopřivnická 	 kopřiv-n-ic-k-á 	 kopřiv-nick-á
korat 	 kor-a-t 	 korat
korespondenčními 	 ko-re-spond-enč-n-ími 	 korespond-enč-ními
korovatět 	 kor-ov-at-ě-t 	 korovatět
kosmického 	 kosm-ic-k-é-ho 	 kosmick-ého
kostička 	 kost-ič-k-a 	 kost-ičk-a
kostýmy 	 kostým-y 	 kostýmy
koupete 	 koup-e-te 	 koup-ete
koutcíc 	 kout-c-íc 	 kout-cíc
koňských 	 koň-sk-ý-ch 	 koň-sk-ých
kožiše 	 kož-iš-e 	 kožiše
krakově 	 krakov-ě 	 krak-ov-ě
kristapána 	 krist-a-pán-a 	 kristapán-a
kroužila 	 krouž-i-l-a 	 krouž-il-a
krumlova 	 krumlov-a 	 kruml-ova
krušanov 	 kruš-an-ov 	 krušan-ov
krvavět 	 krv-av-ě-t 	 krv-avět
krylová 	 kryl-ov-á 	 kryl-ová
krytý 	 kry-t-ý 	 kryt-ý
krádeže 	 krád-ež-e 	 krád-eže
kráse 	 krás-e 	 kráse
krásným 	 krás-n-ý-m 	 krás-n-ým
krátkodobé 	 krát-k-o-dob-é 	 krátkodob-é
kterého 	 kter-é-ho 	 kter-ého
kudrnatět 	 kudr-n-at-ě-t 	 kudrn-atě-t
kunovice 	 kun-ovic-e 	 kun-ovice
kupkovat 	 kup-k-ova-t 	 kupk-ovat
kupující 	 kup-uj-íc-í 	 kup-uj-ící
kuriozity 	 kurioz-it-y 	 kuriozity
kučeravět 	 kučer-av-ě-t 	 kučer-avě-t
kušovat 	 kuš-ova-t 	 kuš-ovat
kvalitou 	 kval-it-ou 	 kval-itou
kvičela 	 kvič-e-l-a 	 kvič-ela
kyčel 	 kyčel 	 kyče-l
křestním 	 křest-n-í-m 	 křest-ním
křivkami 	 křiv-k-a-m-i 	 křivk-ami
křižovatce 	 křiž-ovat-c-e 	 křiž-ovatc-e
křídlem 	 kří-dl-e-m 	 křídlem
kůzlátek 	 kůzl-át-ek 	 kůzlátek
lavina 	 lav-in-a 	 lavin-a
lavírovat 	 lav-ír-ova-t 	 lavír-ovat
laťkovat 	 lať-k-ova-t 	 laťk-ova-t
lecčems 	 lec-č-e-m-s 	 lec-č-ems
ledna 	 led-n-a 	 ledn-a
lehce 	 leh-c-e 	 lehc-e
lehkým 	 leh-k-ý-m 	 lehk-ým
letadel 	 let-a-del 	 letadel
letadlech 	 let-a-dl-ech 	 letadlech
letouny 	 let-oun-y 	 letoun-y
letáky 	 let-ák-y 	 leták-y
letíš 	 let-í-š 	 letíš
ležákem 	 lež-ák-em 	 lež-ákem
lhostejnět 	 lhostej-n-ě-t 	 lhostejnět
lidem 	 lid-e-m 	 lid-em
ligni 	 ligni 	 lig-n-i
limit 	 limit 	 lim-i-t
linkovat 	 lin-k-ova-t 	 link-ova-t
listech 	 list-ech 	 listech
lkát 	 lk-á-t 	 lká-t
loupežníkem 	 loup-ež-n-ík-e-m 	 loupež-ník-em
loupežníkovi 	 loup-ež-n-ík-ovi 	 loupež-ník-ovi
loupežníku 	 loup-ež-n-ík-u 	 loupež-ník-u
loupežníky 	 loup-ež-n-ík-y 	 loupež-ník-y
ltd 	 l-t-d 	 ltd
lukách 	 luk-á-ch 	 luk-ách
lumpačit 	 lump-ač-i-t 	 lumpači-t
látky 	 lát-k-y 	 látk-y
lázní 	 lázn-í 	 láz-n-í
lékařem 	 lék-ař-e-m 	 lék-ař-em
lékem 	 lék-e-m 	 lék-em
lékárnám 	 lék-ár-n-ám 	 lék-árn-ám
léčbě 	 léč-b-ě 	 léčb-ě
líbezně 	 líb-ez-n-ě 	 líbezn-ě
lístek 	 líst-ek 	 lístek
lístečcích 	 líst-ečc-ích 	 lístečc-ích
lístku 	 líst-k-u 	 lístk-u
lístky 	 líst-k-y 	 lístk-y
lístků 	 líst-k-ů 	 lístk-ů
lítosti 	 lít-ost-i 	 lít-osti
maiden 	 maid-en 	 maiden
majíce 	 m-aj-íc-e 	 majíce
makrokonvertor 	 makro-kon-ver-t-or 	 makrokonvertor
maličkosti 	 mal-ič-k-ost-i 	 mal-ičkosti
maličký 	 mal-ič-k-ý 	 mal-ičk-ý
malkovského 	 malkovsk-ého 	 malk-ovského
mamlasovi 	 maml-as-ovi 	 mamlasovi
manager 	 manag-er 	 manager
manažerovi 	 manažer-ovi 	 manažerovi
manýrám 	 manýr-á-m 	 manýrám
manšestrovém 	 manšestr-ov-ém 	 manšestrovém
manšestrový 	 manšestr-ov-ý 	 manšestrový
manželský 	 manžel-sk-ý 	 manželsk-ý
mariánských 	 mari-án-sk-ých 	 marián-sk-ých
marketingový 	 market-ing-ov-ý 	 marketingový
marně 	 mar-n-ě 	 marn-ě
martina 	 martin-a 	 martina
materialisty 	 mater-i-al-ist-y 	 materialisty
materiálové 	 materi-ál-ov-é 	 materiál-ové
materiálu 	 mater-i-ál-u 	 materiál-u
matrice 	 matr-ic-e 	 matrice
mazání 	 maz-á-n-í 	 mazá-n-í
melodie 	 melod-i-e 	 melodie
metafyzických 	 meta-fyz-ic-k-ý-ch 	 meta-fyzick-ých
metafyziku 	 meta-fyz-ik-u 	 metafyziku
metodologicky 	 metodo-log-ic-k-y 	 metod-olog-icky
mezitím 	 mezi-t-ím 	 mezit-ím
meziříčí 	 mezi-říč-í 	 meziříč-í
mečení 	 meč-e-n-í 	 meč-en-í
mikroorganismy 	 mikro-organ-ism-y 	 mikroorganismy
milionů 	 mili-on-ů 	 milion-ů
milost 	 mil-ost 	 milost
milostpane 	 mil-ost-pan-e 	 mil-ostpane
mimoškolními 	 mimo-škol-n-ími 	 mim-oškol-n-ími
minimem 	 minim-em 	 min-imem
minimum 	 minim-um 	 minimum
ministerstva 	 minister-stv-a 	 ministerstva
ministři 	 ministř-i 	 ministři
minulý 	 min-ul-ý 	 minul-ý
mj 	 m-j 	 mj
mladého 	 mlad-é-ho 	 mlad-ého
mluvila 	 mluv-i-l-a 	 mluv-il-a
mlýna 	 ml-ýn-a 	 mlýn-a
mlčeli 	 mlč-e-l-i 	 mlče-l-i
mnichově 	 mnichov-ě 	 mnich-ově
mocná 	 moc-n-á 	 mocn-á
moderního 	 modern-í-ho 	 moder-n-ího
mohutnět 	 moh-ut-n-ě-t 	 mohut-ně-t
moje 	 moj-e 	 moje
mokro 	 mok-r-o 	 mokro
monopol 	 mono-pol 	 monopol
monopolu 	 mon-o-pol-u 	 monopol-u
montáž 	 mont-áž 	 montáž
moravec 	 morav-ec 	 moravec
morseovka 	 morse-ov-k-a 	 morseovk-a
motivací 	 motiv-ac-í 	 mot-iv-ac-í
motole 	 motol-e 	 motole
motorlet 	 motor-let 	 motorlet
motorletu 	 motor-let-u 	 motorletu
možnostech 	 možn-ost-ech 	 mož-n-ost-ech
mrcho 	 mrch-o 	 mrcho
mrtvé 	 mr-tv-é 	 mrtv-é
musela 	 mus-e-l-a 	 musel-a
muselo 	 mus-e-l-o 	 mus-el-o
mučírna 	 muč-írn-a 	 mučírn-a
mužského 	 muž-sk-é-ho 	 muž-sk-ého
mužství 	 muž-stv-í 	 muž-ství
mylná 	 myl-n-á 	 myln-á
mysleli 	 mysl-e-l-i 	 mysl-e-li
mávne 	 máv-n-e 	 mávne
mésti 	 mést-i 	 mésti
míním 	 mín-í-m 	 mín-ím
místo 	 míst-o 	 místo
mých 	 m-ý-ch 	 mých
měli 	 mě-l-i 	 měl-i
měněn 	 měn-ěn 	 měněn
měřítka 	 měř-í-tk-a 	 měř-ítk-a
měřítku 	 měř-í-tk-u 	 měřítk-u
měšťanské 	 měšť-an-sk-é 	 měšťansk-é
mřížovec 	 mříž-ov-ec 	 mříž-ovec
nabitý 	 na-bi-t-ý 	 nabit-ý
nabyl 	 na-by-l 	 nabyl
nabytí 	 na-by-t-í 	 nabyt-í
nabídkových 	 na-bíd-k-ov-ých 	 nabídk-ov-ých
nabídla 	 na-bíd-l-a 	 na-bídl-a
nabízených 	 na-bíz-en-ých 	 nabíz-en-ých
nachlemtat 	 na-chlemt-a-t 	 nachlemtat
nachomýtnout 	 na-chomýt-nou-t 	 nachomýt-nout
nacizovávatelnost 	 na-ciz-ová-v-a-teln-ost 	 na-ciz-ová-v-atelnost
nadcházející 	 nad-cház-ej-íc-í 	 nad-cház-ej-ící
nadindividuálního 	 nad-in-divid-u-ál-n-í-ho 	 nadindivi-du-ál-n-ího
nadout 	 na-dou-t 	 nadou-t
nadpočetné 	 nad-po-čet-n-é 	 nad-počet-n-é
nadychovat 	 na-dych-ova-t 	 nadych-ova-t
nadčlověctví 	 nad-člověc-tv-í 	 nadčl-ověctví
nadějemi 	 na-děj-e-m-i 	 nadějemi
nadřaděného 	 nad-řad-ěn-é-ho 	 nad-řad-ěn-ého
nadšení 	 na-dš-en-í 	 nadš-ení
nadšením 	 na-dš-en-í-m 	 nadš-ením
najatí 	 na-j-a-t-í 	 najat-í
najezdit 	 na-jezd-i-t 	 najezd-i-t
nakolkovat 	 na-kol-k-ova-t 	 na-kolk-ova-t
namasírovat 	 na-mas-ír-ova-t 	 na-masír-ovat
namoci 	 na-moc-i 	 namoc-i
namésti 	 na-mést-i 	 na-mésti
nanášet 	 na-náš-e-t 	 na-náš-et
napajcovávání 	 na-pajc-ová-v-á-n-í 	 na-pajc-ová-ván-í
naprosto 	 na-prost-o 	 naprosto
napsali 	 na-ps-a-l-i 	 na-ps-a-li
narodilo 	 na-rod-i-l-o 	 na-rod-il-o
naruší 	 na-ruš-í 	 naruš-í
nasbíral 	 na-s-bír-a-l 	 na-sbír-a-l
naskicovat 	 na-skic-ova-t 	 naskic-ova-t
nasnídat 	 na-s-níd-a-t 	 nas-níd-a-t
nasázet 	 na-sáz-e-t 	 na-sáz-et
navagónovávatelnost 	 na-vagón-ová-v-a-teln-ost 	 na-vagón-ová-v-a-telnost
naveskrz 	 na-ve-skrz 	 naveskrz
navát 	 na-vá-t 	 navát
načal 	 na-č-a-l 	 nača-l
naškrábnout 	 na-škráb-nou-t 	 na-škráb-nout
naštvat 	 na-štv-a-t 	 na-štv-at
nebaleného 	 ne-bal-en-ého 	 nebal-en-ého
nebalený 	 ne-bal-en-ý 	 nebalen-ý
neboj 	 ne-boj 	 neboj
nebrat 	 ne-br-a-t 	 nebr-a-t
nebrání 	 ne-brán-í 	 nebr-á-n-í
nebyl 	 ne-by-l 	 neby-l
nechtěj 	 ne-cht-ě-j 	 nechtěj
nechybí 	 ne-chyb-í 	 nechyb-í
nechává 	 nech-á-v-á 	 ne-ch-á-v-á
necítím 	 ne-cít-í-m 	 ne-cít-ím
nedaleko 	 ne-dal-ek-o 	 nedaleko
nedat 	 ne-d-a-t 	 ned-a-t
nedaří 	 ne-dař-í 	 nedař-í
nedefinovatelné 	 ne-de-fin-ova-teln-é 	 nedefin-ovatelné
nedoceňuje 	 ne-do-ceň-uje 	 nedo-ceň-uje
nedávají 	 ne-d-á-v-aj-í 	 nedá-v-aj-í
nedávna 	 ne-dávn-a 	 nedávn-a
nedýchali 	 ne-dých-a-l-i 	 ne-dých-a-li
neexistovalo 	 ne-exist-ova-l-o 	 ne-exist-ova-lo
nehodlám 	 ne-hodl-á-m 	 ne-hodl-ám
neinkasoval 	 ne-in-kas-ova-l 	 ne-inkas-oval
nejaktivnější 	 nej-akt-iv-n-ějš-í 	 nej-aktiv-n-ěj-š-í
nejcitlivějším 	 nej-cit-liv-ějš-ím 	 nej-cit-l-iv-ějším
nejdivočejší 	 nej-div-oč-ej-š-í 	 nej-divo-č-ejší
nejdříve 	 nej-dřív-e 	 nejdříve
nejkrásnějších 	 nej-krás-n-ěj-š-í-ch 	 nej-krás-n-ějších
nejlahodnější 	 nej-lahod-n-ěj-š-í 	 nej-la-hod-n-ěj-š-í
nejmenší 	 nej-men-š-í 	 nej-menš-í
nejpalčivější 	 nej-pal-č-iv-ěj-š-í 	 nej-pal-č-iv-ějš-í
nejpovolanějšímu 	 nej-po-vol-a-n-ějš-ímu 	 nej-povola-nějšímu
nejprve 	 nej-prv-e 	 nej-prve
nejsladšího 	 nej-slad-š-í-ho 	 nej-slad-š-ího
nejsladším 	 nej-slad-š-í-m 	 nej-slad-š-ím
nejvzdálenější 	 nej-vz-dál-e-n-ěj-š-í 	 nej-vzdálen-ějš-í
nejvzácnější 	 nej-vzácn-ějš-í 	 nej-vzác-n-ějš-í
nejzřetelněji 	 nej-zř-e-tel-n-ěji 	 nej-zřetelněji
nejčastějších 	 nej-čast-ěj-š-í-ch 	 nej-čast-ějších
nejžha 	 nej-žh-a 	 nejžha
nekompetentní 	 ne-kompet-ent-n-í 	 ne-kompetent-n-í
nekrytý 	 ne-kry-t-ý 	 ne-kryt-ý
nekvete 	 ne-kvet-e 	 ne-kvete
nelegální 	 ne-leg-ál-n-í 	 nelegál-n-í
nemocenského 	 ne-moc-en-sk-ého 	 ne-mocen-sk-ého
nemálo 	 ne-mál-o 	 nem-á-l-o
neměly 	 ne-m-ě-l-y 	 nemě-l-y
nemůže 	 ne-můž-e 	 nemůže
nenahradí 	 ne-na-hrad-í 	 nenahrad-í
nenamaže 	 ne-na-maž-e 	 nenamaže
nenech 	 ne-nech 	 nen-ech
neobtížím 	 ne-ob-tíž-í-m 	 ne-obtíž-ím
neodpovídající 	 ne-od-po-víd-aj-íc-í 	 ne-odpovíd-ající
neodpovídala 	 ne-od-po-víd-a-l-a 	 ne-odpov-íd-ala
neodvažujeme 	 ne-od-važ-uje-me 	 ne-od-važ-ujeme
neohrabané 	 ne-o-hrab-a-n-é 	 ne-o-hrab-an-é
nepodaří 	 ne-po-dař-í 	 nepod-ař-í
nepohnutě 	 ne-po-h-nu-t-ě 	 ne-pohnut-ě
nepolemizujme 	 ne-polem-iz-uj-me 	 ne-polem-izujme
neposkytnul 	 ne-po-skyt-nu-l 	 ne-po-skytnul
nepotápí 	 ne-po-táp-í 	 ne-potáp-í
nepotřebujete 	 ne-po-třeb-u-j-e-te 	 ne-po-třeb-ujete
nepravdivých 	 ne-prav-d-iv-ých 	 ne-pravd-iv-ých
neprodejným 	 ne-pro-dej-n-ým 	 ne-prodejn-ým
neprodělá 	 ne-pro-děl-á 	 ne-proděl-á
neprokáže 	 ne-pro-káž-e 	 ne-pro-káže
nepředepisují 	 ne-přede-pis-uj-í 	 ne-předepisují
nepředpokládám 	 ne-před-po-klád-á-m 	 ne-pře-dp-okládám
nepřehlédněte 	 ne-pře-hléd-n-ě-te 	 ne-přehléd-n-ěte
nepřesných 	 ne-přesn-ých 	 ne-přes-n-ých
nepřidává 	 ne-při-d-á-v-á 	 ne-přid-á-v-á
nepřišla 	 ne-při-š-l-a 	 ne-při-šl-a
nepříjemná 	 ne-pří-jem-n-á 	 ne-příjemn-á
nereálný 	 ne-reál-n-ý 	 nereáln-ý
nerozlišuje 	 ne-roz-liš-uje 	 ne-rozliš-uje
neroztříštěná 	 ne-roz-tříšt-ěn-á 	 ne-roz-tříštěn-á
nerušili 	 ne-ruš-i-l-i 	 ne-ruš-i-li
nervóznět 	 nerv-óz-n-ě-t 	 ne-rvóz-n-ě-t
nesena 	 nes-en-a 	 nesen-a
nesesedl 	 ne-se-sed-l 	 nesesedl
neshoří 	 ne-s-hoř-í 	 ne-shoř-í
neskromně 	 ne-s-krom-n-ě 	 ne-skrom-n-ě
nesmírná 	 ne-s-mír-n-á 	 ne-s-mírn-á
nesnesitelna 	 ne-s-nes-i-teln-a 	 ne-s-nes-i-telna
netušícího 	 ne-tuš-íc-ího 	 netuš-íc-ího
neudělal 	 ne-u-děl-a-l 	 ne-uděla-l
neukáže 	 ne-u-káž-e 	 neukáže
neumožňuje 	 ne-u-možň-uje 	 ne-umožňuje
neumí 	 ne-um-í 	 neum-í
neuměla 	 ne-um-ě-l-a 	 ne-umě-l-a
neupije 	 ne-u-pi-je 	 neupije
neuteče 	 ne-u-teč-e 	 ne-uteč-e
neuznává 	 ne-u-zn-á-v-á 	 ne-uzn-áv-á
nevhodnost 	 ne-v-hod-n-ost 	 nevhod-n-ost
nevinen 	 ne-vin-en 	 nevinen
nevrley 	 nevrley 	 ne-vrley
nevyhnutelné 	 ne-vy-h-nu-teln-é 	 ne-vy-hnu-telné
nevyskytly 	 ne-vy-skyt-l-y 	 ne-vy-skytl-y
nevysvětlíš 	 ne-vy-svět-l-í-š 	 ne-vy-světlíš
nevyznám 	 ne-vy-zn-á-m 	 nevyznám
nezahořeli 	 ne-za-hoř-e-l-i 	 ne-za-hoř-el-i
nezaměstnanosti 	 ne-za-měst-n-an-ost-i 	 ne-z-a-městnanosti
nezaoblená 	 ne-za-obl-en-á 	 ne-z-a-oblen-á
nezapsané 	 ne-za-ps-a-n-é 	 ne-za-psa-n-é
nezapíchnul 	 ne-za-pích-nu-l 	 ne-za-píchnul
nezavolali 	 ne-za-vol-a-l-i 	 ne-za-vol-al-i
nezačínej 	 ne-za-č-ín-ej 	 ne-za-čín-ej
nezbytné 	 ne-z-by-t-n-é 	 ne-z-byt-n-é
nezbytnými 	 ne-z-by-t-n-ými 	 ne-z-byt-n-ými
nezlob 	 ne-zlob 	 nez-lob
neznámého 	 ne-zn-á-m-é-ho 	 ne-zn-á-mého
neztratitelnost 	 ne-z-trat-i-tel-n-ost 	 ne-z-trat-i-telnost
neúplných 	 ne-ú-pln-ých 	 ne-úpln-ých
nečinnosti 	 ne-čin-n-ost-i 	 ne-čin-n-osti
neříkejte 	 ne-řík-ej-te 	 ne-říkej-te
nijetzscheovi 	 nijetzsche-ovi 	 nij-etzscheovi
nimiž 	 n-imi-ž 	 nimiž
nitěných 	 nit-ěn-ý-ch 	 nitěn-ých
nocovávající 	 noc-ová-v-aj-íc-í 	 noc-ová-v-aj-ící
norem 	 norem 	 nor-em
nosatá 	 nos-at-á 	 nosat-á
nosem 	 nos-e-m 	 nos-em
novinám 	 nov-in-á-m 	 novin-ám
novočerkasku 	 novočerkask-u 	 nov-očerkask-u
náborové 	 ná-bor-ov-é 	 nábor-ov-é
nábytek 	 ná-by-tek 	 nábytek
nájemné 	 ná-jem-n-é 	 ná-jemn-é
náležela 	 ná-lež-e-l-a 	 ná-lež-el-a
námořník 	 ná-moř-n-ík 	 námoř-ník
náměty 	 ná-mět-y 	 námět-y
nápad 	 ná-pad 	 nápad
náramného 	 ná-ram-n-é-ho 	 ná-ram-n-ého
nás 	 n-á-s 	 nás
následek 	 ná-sled-ek 	 ná-sledek
následujících 	 ná-sled-uj-íc-ích 	 ná-sled-ujících
následujícího 	 ná-sled-uj-íc-ího 	 ná-sled-uj-ícího
nástroj 	 ná-stroj 	 nástroj
návod 	 ná-vod 	 návod
návštěva 	 návštěv-a 	 návšt-ěv-a
návštěvnost 	 návštěv-n-ost 	 návštěv-nost
návštěvnosti 	 návštěv-n-ost-i 	 návštěv-n-osti
návštěvou 	 návštěv-ou 	 návšt-ěv-ou
názory 	 ná-zor-y 	 názor-y
ně 	 n-ě 	 ně
nějakém 	 ně-jak-é-m 	 něj-akém
nějakými 	 ně-jak-ými 	 něj-akými
někde 	 ně-kd-e 	 někde
něm 	 n-ě-m 	 něm
německý 	 něm-ec-k-ý 	 německ-ý
oba 	 ob-a 	 oba
obal 	 o-bal 	 oba-l
obalu 	 o-bal-u 	 obal-u
obchod 	 ob-chod 	 obchod
obchodům 	 ob-chod-ům 	 obchod-ům
obcích 	 obc-ích 	 obcích
obelstil 	 obe-lst-i-l 	 obelsti-l
obemknout 	 obe-mk-nou-t 	 obemk-nou-t
obepnout 	 obe-pn-ou-t 	 obep-nou-t
obetkat 	 obe-tk-a-t 	 obetk-at
obeznámit 	 obe-znám-i-t 	 obezn-ámi-t
objektem 	 ob-jekt-e-m 	 ob-jektem
objem 	 ob-jem 	 objem
obklíčit 	 ob-klíč-i-t 	 obklíč-i-t
oblastech 	 oblast-ech 	 oblastech
oblažit 	 o-blaž-i-t 	 ob-laž-i-t
oblíbený 	 ob-líb-en-ý 	 oblíb-en-ý
obnitkovat 	 ob-nit-k-ova-t 	 ob-nitk-ova-t
obnovovat 	 ob-nov-ova-t 	 obnov-ova-t
obor 	 o-bor 	 obor
oborat 	 ob-or-a-t 	 obor-a-t
obouvatelný 	 ob-ouv-a-teln-ý 	 obouv-a-teln-ý
obrali 	 o-br-a-l-i 	 obra-l-i
obrat 	 o-br-a-t 	 obrat
obrátek 	 ob-rát-ek 	 obrátek
obtahovat 	 ob-tah-ova-t 	 obtah-ova-t
obtěžkávat 	 ob-těž-k-á-v-a-t 	 ob-těžk-á-v-a-t
obydlet 	 o-bydl-e-t 	 obydlet
obzvlášť 	 ob-zvlášť 	 obzvlášť
občanského 	 obč-an-sk-ého 	 občan-sk-ého
ocejchovat 	 o-cejch-ova-t 	 o-cejchova-t
ocejchovávací 	 o-cejch-ová-v-a-c-í 	 o-cejch-ová-vac-í
oceli 	 ocel-i 	 oceli
ocenzurovávanost 	 o-cenzur-ová-v-a-n-ost 	 ocenzur-ovávanost
ochmatat 	 o-chmat-a-t 	 o-chmata-t
ochotna 	 ochot-n-a 	 o-chotn-a
ochranka 	 o-chran-k-a 	 o-chrank-a
octovat 	 oct-ova-t 	 oct-ovat
odborníky 	 od-bor-n-ík-y 	 odbor-ník-y
odbytové 	 od-by-t-ov-é 	 odbyt-ov-é
odběratel 	 od-běr-a-tel 	 od-běr-atel
odběratelem 	 od-běr-a-tel-em 	 od-běr-atel-em
odběru 	 od-běr-u 	 odběr-u
odchylka 	 od-chyl-k-a 	 odchylk-a
odchylky 	 od-chyl-k-y 	 odchylk-y
odcloňovat 	 od-cloň-ova-t 	 odcloň-ova-t
oddanosti 	 od-d-a-n-ost-i 	 odda-n-osti
oddat 	 od-d-a-t 	 odd-a-t
oddati 	 od-d-a-ti 	 odda-ti
oddechnout 	 od-dech-nou-t 	 oddech-nou-t
oddrolit 	 od-drol-i-t 	 oddrol-i-t
oddychovat 	 od-dych-ova-t 	 oddych-ova-t
oddávat 	 od-d-á-v-a-t 	 odd-á-v-at
odehnat 	 ode-hn-a-t 	 odehn-at
odehrávají 	 ode-hrá-v-aj-í 	 odehráv-aj-í
odepřela 	 ode-př-e-l-a 	 ode-přel-a
odervat 	 ode-rv-a-t 	 oderv-at
odeslaném 	 ode-sl-a-n-ém 	 odesl-a-n-ém
odesílat 	 ode-síl-a-t 	 odesíl-a-t
odevzdám 	 ode-vz-d-á-m 	 ode-vzdám
odevšad 	 ode-vš-ad 	 odevšad
odečte 	 ode-čt-e 	 odečte
odečtení 	 ode-čt-en-í 	 odečt-en-í
odečtou 	 ode-čt-ou 	 odečt-ou
odečítat 	 ode-čít-a-t 	 odečít-a-t
odfrčet 	 od-frč-e-t 	 od-frč-et
odhad 	 od-had 	 odhad
odhadu 	 od-had-u 	 odhad-u
odklad 	 od-klad 	 odklad
odkladem 	 od-klad-em 	 odklad-em
odkladu 	 od-klad-u 	 odklad-u
odkrvovat 	 od-krv-ova-t 	 odkrv-ova-t
odkývat 	 od-kýv-a-t 	 od-ký-v-at
odlevovat 	 od-lev-ova-t 	 odlev-ova-t
odlévání 	 od-lév-á-n-í 	 odlév-á-n-í
odmlčela 	 od-mlč-e-l-a 	 odmlč-el-a
odmésti 	 od-mést-i 	 od-mésti
odnoží 	 od-nož-í 	 odnož-í
odpluje 	 od-plu-je 	 od-pluje
odpomoci 	 od-po-moc-i 	 odpomoc-i
odpověď 	 od-po-věď 	 odpověď
odsoudcovat 	 od-soud-c-ova-t 	 od-soudc-ovat
odst 	 od-st 	 odst
odstartovat 	 od-start-ova-t 	 od-start-ovat
odstrašovat 	 od-straš-ova-t 	 od-straš-ovat
odtlouci 	 od-tlouc-i 	 odtlouc-i
odtrojmocnit 	 od-troj-moc-n-i-t 	 od-troj-m-oc-n-it
odtáhne 	 od-táh-ne 	 odtáhne
oduševnit 	 o-duš-ev-n-i-t 	 odušev-n-i-t
odvažuješ 	 od-važ-uje-š 	 od-važ-uješ
odřít 	 o-dř-í-t 	 odř-í-t
odžít 	 od-ží-t 	 odží-t
ohlodat 	 o-hlod-a-t 	 o-hloda-t
ohořelému 	 o-hoř-e-l-é-mu 	 ohoř-elému
ohřebelcovat 	 o-hřeb-el-c-ova-t 	 o-hřebelc-ovat
ojínět 	 o-jín-ě-t 	 ojín-ě-t
okamžitě 	 ok-a-mžit-ě 	 okamžit-ě
okartáčovat 	 o-kartáč-ova-t 	 okartáč-ovat
okolkovat 	 o-kol-k-ova-t 	 okol-k-ovat
okounět 	 okoun-ě-t 	 okoun-ět
okozlit 	 o-koz-l-i-t 	 o-kozl-i-t
oktrojovat 	 oktroj-ova-t 	 oktroj-ovat
oloupil 	 o-loup-i-l 	 oloup-i-l
olšanech 	 olšan-e-ch 	 olš-an-ech
omdlívat 	 o-mdl-í-v-a-t 	 omdl-í-v-a-t
omegou 	 omeg-ou 	 omegou
omezování 	 o-mez-ová-n-í 	 omez-ová-n-í
omlouval 	 o-mlouv-a-l 	 o-mlouva-l
omítce 	 o-mít-c-e 	 omítc-e
omžít 	 o-mž-í-t 	 omží-t
onen 	 on-en 	 onen
opancéřovat 	 o-pancéř-ova-t 	 opancéř-ovat
opatrností 	 o-patr-n-ost-í 	 o-patrn-ost-í
opatrný 	 o-patr-n-ý 	 opatr-n-ý
opačném 	 o-pač-n-é-m 	 opač-n-ém
opelichat 	 o-pelich-a-t 	 opelich-a-t
oplodňovat 	 o-plod-ň-ova-t 	 o-plodň-ova-t
oplésti 	 o-plést-i 	 o-plésti
opotřebovat 	 o-po-třeb-ova-t 	 opotřeb-ovat
opouští 	 o-pouš-t-í 	 opoušt-í
opouštějí 	 o-poušt-ěj-í 	 opoušt-ěj-í
opouštěl 	 o-poušt-ě-l 	 opouštěl
opovažuješ 	 o-po-važ-u-j-e-š 	 o-po-važ-uje-š
oranžista 	 oranž-ist-a 	 oranžista
orazítkovat 	 o-raz-í-tk-ova-t 	 orazítk-ovat
orchestrem 	 orchestr-e-m 	 orchestrem
organizují 	 organ-iz-u-j-í 	 organiz-uj-í
orientální 	 orient-ál-n-í 	 orientál-n-í
orlik 	 orl-ik 	 orlik
oroubovat 	 o-roub-ova-t 	 oroub-ova-t
osednout 	 o-sed-nou-t 	 osed-nou-t
oslintat 	 o-slint-a-t 	 oslinta-t
osmitisícový 	 osm-i-tisíc-ov-ý 	 osm-itisícov-ý
osmnácté 	 osm-náct-é 	 osmnáct-é
osmou 	 osm-ou 	 osmou
osobu 	 o-sob-u 	 osob-u
ospalost 	 o-sp-a-l-ost 	 o-spalost
ostatních 	 o-stat-n-í-ch 	 ostat-n-ích
ostrouhat 	 o-strouh-a-t 	 ostrouh-a-t
ostřihovat 	 o-střih-ova-t 	 o-střih-ovat
ostřit 	 ostř-i-t 	 o-stř-i-t
osudem 	 o-sud-e-m 	 osud-em
osudně 	 osud-n-ě 	 o-sud-n-ě
osvobození 	 o-svoboz-en-í 	 osvoboz-en-í
osvědčují 	 o-s-věd-č-u-j-í 	 o-svěd-č-uj-í
otevřel 	 ote-vř-e-l 	 otevřel
otevřely 	 ote-vř-e-l-y 	 otevřel-y
otevřena 	 ote-vř-en-a 	 otevřen-a
otevřít 	 ote-vř-í-t 	 otevří-t
otvírá 	 ot-vír-á 	 otvír-á
otěhotnět 	 o-těhot-n-ě-t 	 o-těhot-n-ět
ovadnout 	 o-vad-nou-t 	 ovad-nou-t
ovládání 	 o-vlád-á-n-í 	 ovlád-án-í
ovít 	 o-ví-t 	 oví-t
ověnčil 	 o-věn-č-i-l 	 ověn-č-i-l
oxfordského 	 oxford-sk-é-ho 	 oxford-sk-ého
ozdobovat 	 o-z-dob-ova-t 	 ozdob-ova-t
ozvalo 	 o-zv-a-l-o 	 ozv-a-l-o
ozřejmit 	 o-zřejm-i-t 	 ozřejm-i-t
očarování 	 o-čar-ová-n-í 	 očar-ová-n-í
očenichat 	 o-čenich-a-t 	 očenich-a-t
očima 	 oč-ima 	 očima
očí 	 oč-í 	 očí
ošukat 	 ošuk-a-t 	 o-šuk-a-t
ošvindlovat 	 o-švindl-ova-t 	 o-švindl-ovat
ošívat 	 o-ší-v-a-t 	 ošív-a-t
paběrkovat 	 pa-běr-k-ova-t 	 paběrk-ova-t
pacientovi 	 pac-i-ent-ovi 	 pacientovi
padesát 	 pa-desát 	 padesát
padesátku 	 pade-sát-k-u 	 padesátk-u
pageův 	 page-ův 	 pageův
pakovat 	 pak-ova-t 	 pak-ovat
palba 	 pal-b-a 	 palb-a
palermě 	 palerm-ě 	 palermě
panenka 	 pan-en-k-a 	 panenk-a
paničko 	 pan-ič-k-o 	 pan-ičko
panoval 	 pan-ova-l 	 pan-oval
panáček 	 pan-áč-ek 	 pan-áček
papouškovat 	 papouš-k-ova-t 	 papoušk-ovat
parasoudně 	 para-soud-n-ě 	 paras-oud-n-ě
parukou 	 paruk-ou 	 par-uk-ou
pasírovat 	 pasír-ova-t 	 pasír-ovat
patroni 	 patr-on-i 	 patroni
patřily 	 patř-i-l-y 	 patř-il-y
pavouček 	 pavouč-ek 	 pav-ouček
pekárenských 	 pek-ár-en-sk-ých 	 pekárensk-ých
perfektně 	 per-fekt-n-ě 	 per-fekt-ně
perutková 	 perut-k-ov-á 	 perutk-ov-á
petrolejově 	 petrolej-ov-ě 	 petrolej-ově
petynce 	 pety-n-c-e 	 petynce
pf 	 p-f 	 pf
pfeffermann 	 pfeffer-mann 	 pfeffermann
pil 	 pi-l 	 pil
pilují 	 pil-u-j-í 	 pil-uj-í
pisklavě 	 pisk-l-av-ě 	 pisklav-ě
pitomej 	 pitom-ej 	 pit-omej
plakáty 	 plakát-y 	 plak-át-y
planul 	 plan-u-l 	 planu-l
plat 	 plat 	 pla-t
platba 	 plat-b-a 	 platb-a
plačící 	 plač-í-c-í 	 plač-ící
pleteného 	 plet-en-é-ho 	 plet-en-ého
plivám 	 pliv-á-m 	 pliv-ám
plnohodnotné 	 pln-o-hod-n-ot-n-é 	 pln-ohod-notn-é
plnění 	 pln-ěn-í 	 plně-n-í
plodem 	 plod-e-m 	 plod-em
plují 	 plu-j-í 	 pluj-í
plukovník 	 pluk-ov-n-ík 	 pluk-ov-ník
plutokratismus 	 plut-o-krat-ism-us 	 plut-o-kratismus
plynulé 	 ply-nu-l-é 	 ply-nul-é
pobočkové 	 po-boč-k-ov-é 	 po-boč-k-ové
pobožnější 	 po-bož-n-ěj-š-í 	 po-bož-n-ějš-í
pochválena 	 po-chvál-en-a 	 pochválen-a
pochybnostech 	 po-chyb-n-ost-ech 	 po-chyb-n-ostech
podařilo 	 po-dař-i-l-o 	 podař-il-o
podaří 	 po-dař-í 	 pod-ař-í
podepsat 	 pode-ps-a-t 	 podepsa-t
podhrnout 	 pod-hrn-ou-t 	 pod-hr-nou-t
podivila 	 po-div-i-l-a 	 podiv-il-a
podivně 	 po-div-n-ě 	 pod-iv-n-ě
podivuhodné 	 po-div-u-hod-n-é 	 podiv-uhod-n-é
podklesat 	 pod-kles-a-t 	 pod-klesat
podlec 	 podl-ec 	 podlec
podlitina 	 pod-li-t-in-a 	 pod-litina
podmínkami 	 pod-mín-k-ami 	 pod-mínkami
podmíněny 	 pod-mín-ěn-y 	 pod-míněny
podnikatelskou 	 pod-nik-a-tel-sk-ou 	 pod-nik-a-telskou
podnikám 	 pod-nik-á-m 	 pod-nik-ám
podobalo 	 po-dob-a-l-o 	 podob-a-l-o
podobného 	 po-dob-n-é-ho 	 podob-n-ého
podobě 	 po-dob-ě 	 podob-ě
podotkl 	 po-do-tk-l 	 pod-otkl
podpírala 	 pod-pír-a-l-a 	 pod-pír-al-a
podružstevnit 	 po-druž-stev-n-i-t 	 podružstevnit
podráždění 	 po-drážd-ěn-í 	 pod-rážděn-í
podstupovat 	 pod-stup-ova-t 	 pod-stup-ovat
podtít 	 pod-t-í-t 	 podt-í-t
podupovat 	 po-dup-ova-t 	 podup-ova-t
podvésti 	 pod-vést-i 	 pod-vésti
podívala 	 po-dív-a-l-a 	 pod-ív-al-a
podívali 	 po-dív-a-l-i 	 pod-ív-al-i
podělí 	 po-děl-í 	 poděl-í
pohaněné 	 po-han-ě-n-é 	 po-han-ěn-é
pohlavkoval 	 po-hlav-k-ova-l 	 po-hlavk-oval
pohnuly 	 po-h-nu-l-y 	 pohnul-y
pohnutlivé 	 po-h-nu-t-l-i-v-é 	 pohnut-liv-é
pohoda 	 po-hod-a 	 pohod-a
pohotovějším 	 po-hotov-ějš-ím 	 pohot-ov-ějším
pohrůžku 	 po-hrůž-k-u 	 po-hrůžk-u
pojaty 	 po-j-a-t-y 	 pojat-y
pojedu 	 po-jed-u 	 pojed-u
pojímá 	 po-jím-á 	 pojím-á
pojísti 	 po-jíst-i 	 po-jísti
poklad 	 po-klad 	 poklad
poklade 	 po-klad-e 	 poklade
poklást 	 po-klás-t 	 poklást
pokoj 	 po-koj 	 pokoj
pokročilejším 	 po-kroč-i-l-ejš-ím 	 po-kroč-i-l-ejším
pokárat 	 po-kár-a-t 	 pokár-a-t
policajtovat 	 policajt-ova-t 	 policajt-ovat
politických 	 polit-ic-k-ý-ch 	 polit-ick-ých
polska 	 pol-sk-a 	 polsk-a
polská 	 pol-sk-á 	 polsk-á
polyvalence 	 poly-valenc-e 	 polyvalence
polít 	 po-lí-t 	 polí-t
pomatený 	 po-mat-en-ý 	 pomat-en-ý
pomohla 	 po-moh-l-a 	 po-mohl-a
pomáhám 	 po-máh-á-m 	 po-máh-ám
pomást 	 po-más-t 	 pomást
poměrem 	 po-měr-e-m 	 poměr-em
pomůcek 	 po-můc-ek 	 pomůcek
poobědvat 	 po-oběd-v-a-t 	 po-obědv-a-t
pooddychnout 	 po-od-dych-nou-t 	 pooddych-nout
poodhalit 	 po-od-hal-i-t 	 po-odhal-i-t
popelnic 	 po-pel-nic 	 popel-nic
popište 	 po-piš-te 	 popište
popkultura 	 pop-kult-ur-a 	 popkultura
poplatků 	 po-plat-k-ů 	 po-platk-ů
poplatník 	 po-plat-ník 	 po-plat-n-ík
poplatníky 	 po-plat-ník-y 	 po-plat-n-ík-y
poproduktivní 	 po-pro-duk-t-iv-n-í 	 pop-rodukt-ivn-í
popráškovat 	 po-práš-k-ova-t 	 po-prášk-ovat
poptat 	 po-pt-a-t 	 popt-a-t
poptávky 	 po-pt-á-v-k-y 	 poptávk-y
poradců 	 po-rad-c-ů 	 po-radc-ů
poroučel 	 po-rouč-e-l 	 po-rouč-el
porovnání 	 po-rovn-ání 	 porovn-á-n-í
porozhlédnout 	 po-roz-hléd-nou-t 	 po-roz-hléd-nout
porůsti 	 po-růst-i 	 porůsti
posily 	 po-sil-y 	 posil-y
poskytováním 	 po-skyt-ová-n-ím 	 poskyt-ová-ním
poskytují 	 po-skyt-uj-í 	 poskyt-uj-í
poslal 	 po-sl-a-l 	 posla-l
poslouchej 	 po-slouch-ej 	 poslouchej
posluchače 	 po-sluch-a-č-e 	 po-sluch-ače
posluchačů 	 po-sluch-a-č-ů 	 po-sluchač-ů
posmyknout 	 po-s-myk-nou-t 	 pos-myk-nou-t
postih 	 po-stih 	 postih
postrádám 	 po-strád-á-m 	 postrád-ám
postup 	 po-stup 	 postup
postátňovat 	 po-stát-ň-ova-t 	 po-stát-ň-ovat
postýlky 	 po-stýl-k-y 	 postýlk-y
postříknout 	 po-střík-nou-t 	 po-střík-nout
posunovávatelnost 	 po-sun-ová-v-a-teln-ost 	 po-sun-ová-v-atelnost
posílám 	 po-síl-á-m 	 po-síl-ám
potit 	 pot-i-t 	 poti-t
potká 	 po-tk-á 	 potk-á
potkáme 	 po-tk-á-me 	 potk-á-me
potkáte 	 po-tk-á-te 	 potk-á-te
potravin 	 po-trav-in 	 potravin
potrefený 	 po-tref-en-ý 	 po-trefen-ý
potud 	 po-t-ud 	 potud
potulují 	 po-tul-uj-í 	 potul-uj-í
potvrdili 	 po-tvrd-i-l-i 	 po-tvrd-i-li
potěžkat 	 po-těž-k-a-t 	 po-těžk-a-t
pouhém 	 pouh-é-m 	 pouh-ém
poupátko 	 poup-át-k-o 	 poup-átko
pouzdro 	 pouzdr-o 	 pouzdro
poučit 	 po-uč-i-t 	 pouč-i-t
použije 	 po-u-ži-je 	 pou-žije
použito 	 po-u-ži-t-o 	 pou-ži-to
považovány 	 po-važ-ová-n-y 	 po-važ-ován-y
povečeřet 	 po-večeř-e-t 	 po-večeř-et
povolaný 	 po-vol-an-ý 	 po-vol-a-n-ý
povylézt 	 po-vy-léz-t 	 povyléz-t
povyrůsti 	 po-vy-růst-i 	 povyrůsti
povyskakovat 	 po-vy-skak-ova-t 	 po-vy-skakovat
povzbudivé 	 po-vz-bud-i-v-é 	 po-vzbud-iv-é
povzbuzení 	 po-vz-buz-en-í 	 po-vzbuz-en-í
povzdychnout 	 po-vz-dych-nou-t 	 po-vzdych-nout
povznáší 	 po-vz-náš-í 	 povznáš-í
pověra 	 po-věr-a 	 pověr-a
povšimli 	 po-všim-l-i 	 povšim-l-i
pozměňovat 	 po-z-měň-ova-t 	 poz-měň-ova-t
poznat 	 po-zn-a-t 	 pozn-a-t
poznatku 	 po-zn-a-t-k-u 	 poznatk-u
poznačit 	 po-znač-i-t 	 poznač-i-t
poznání 	 po-zn-á-n-í 	 pozn-á-n-í
pozornost 	 po-zor-n-ost 	 pozor-n-ost
poztrácet 	 po-z-trác-e-t 	 poztrác-et
počasí 	 po-čas-í 	 počas-í
početí 	 po-č-e-t-í 	 počet-í
počkal 	 po-čk-a-l 	 počk-a-l
počkej 	 po-čk-ej 	 počkej
počkám 	 po-čk-á-m 	 počk-ám
počnu 	 po-č-n-u 	 počn-u
počtu 	 po-čt-u 	 počt-u
pořadatel 	 po-řad-a-tel 	 po-řad-atel
pořadatele 	 po-řad-a-tel-e 	 po-řad-atele
pořadatelé 	 po-řad-a-tel-é 	 po-řad-atel-é
pořadatelů 	 po-řad-a-tel-ů 	 po-řad-atel-ů
poškozovat 	 po-škoz-ova-t 	 poškoz-ovat
pošla 	 po-š-l-a 	 pošl-a
pošle 	 po-šl-e 	 pošle
pošlete 	 po-šl-e-te 	 pošle-te
pošlu 	 po-šl-u 	 pošl-u
požadovanou 	 po-žad-ova-n-ou 	 požad-ova-n-ou
požáru 	 po-žár-u 	 požár-u
pracovníka 	 prac-ov-ník-a 	 pracov-ník-a
pragmatismus 	 pragm-at-ism-us 	 pragm-atismus
pragokoncertu 	 prag-o-koncert-u 	 pra-gokoncertu
praktickým 	 prakt-ic-k-ý-m 	 prakt-ick-ým
praktikantům 	 prakt-ik-ant-ům 	 praktikantům
pramene 	 pramen-e 	 pramene
pravidel 	 prav-i-del 	 prav-idel
prchavý 	 prch-a-v-ý 	 prch-av-ý
prejudikovat 	 pre-ju-dik-ova-t 	 pre-judikovat
prezidentů 	 prezid-ent-ů 	 pre-zident-ů
princezna 	 princ-ez-n-a 	 princezn-a
princeznu 	 princ-ez-n-u 	 princeznu
princmetálovou 	 princ-metál-ov-ou 	 pri-nc-metálovou
princátky 	 princ-át-k-y 	 princátk-y
probudila 	 pro-bud-i-l-a 	 probudil-a
probudím 	 pro-bud-í-m 	 probudím
procházka 	 pro-cház-k-a 	 pro-cházk-a
prodejce 	 pro-d-ej-c-e 	 pro-dejce
prodejna 	 pro-d-ej-n-a 	 prodejn-a
prodejně 	 pro-d-ej-n-ě 	 pro-dej-n-ě
prodlužuje 	 pro-dluž-uje 	 prodluž-uje
producent 	 pro-duc-ent 	 producent
produktů 	 pro-dukt-ů 	 produkt-ů
produševňovat 	 pro-duš-ev-ň-ova-t 	 pro-duševň-ovat
prodával 	 pro-d-á-v-a-l 	 pro-dá-v-a-l
prodávaná 	 pro-d-á-v-a-n-á 	 pro-dá-v-a-n-á
prodávaných 	 pro-d-á-v-a-n-ých 	 pro-dá-v-a-n-ých
prodělek 	 pro-děl-ek 	 prodělek
profesora 	 pro-fes-or-a 	 pro-fesora
profesory 	 pro-fes-or-y 	 pro-fesory
prohlásila 	 pro-hlás-i-l-a 	 pro-hlásil-a
prohrával 	 pro-hrá-v-a-l 	 pro-hráv-a-l
projede 	 pro-jed-e 	 pro-jede
projednáním 	 pro-jed-n-án-ím 	 pro-jednán-ím
projet 	 pro-je-t 	 proje-t
proklábosit 	 pro-klábos-i-t 	 pro-klábosit
prokládkovost 	 pro-klád-k-ov-ost 	 pro-kládkovost
proklásti 	 pro-klást-i 	 pro-klásti
proklímat 	 pro-klím-a-t 	 proklím-at
proklímávání 	 pro-klím-á-v-á-n-í 	 pro-klím-á-v-án-í
prokormidlovavší 	 pro-kormidl-ova-vš-í 	 pro-kormidlovavší
prokouknout 	 pro-kouk-nou-t 	 pro-kouk-nout
prokousnout 	 pro-kous-nou-t 	 pro-kous-nout
prokrindapána 	 pro-krind-a-pán-a 	 pro-krindapána
prokvétat 	 pro-kvét-a-t 	 pro-kvét-at
promarnit 	 pro-mar-n-i-t 	 pro-marn-i-t
prometání 	 pro-met-á-n-í 	 pro-met-án-í
promnout 	 pro-mn-ou-t 	 prom-nou-t
propachtovat 	 pro-pacht-ova-t 	 pro-pacht-ovat
propagace 	 propag-ac-e 	 pro-pag-ace
propastné 	 pro-past-n-é 	 pro-past-né
propláchnout 	 pro-plách-nou-t 	 pro-pláchnout
propíchávat 	 pro-pích-á-v-a-t 	 pro-píchá-v-a-t
prosciutto 	 prosciutt-o 	 prosciutto
proset 	 pro-se-t 	 proset
proslulá 	 pro-slu-l-á 	 pro-slul-á
prospěch 	 pro-spěch 	 prospěch
prostorově 	 pro-stor-ov-ě 	 prostorov-ě
prostrkovat 	 pro-strk-ova-t 	 pro-strk-ovat
prostějovsko 	 prostějov-sk-o 	 prostějovsko
prostředky 	 pro-střed-k-y 	 pro-středk-y
prosvítat 	 pro-svít-a-t 	 prosvít-a-t
prosychat 	 pro-sych-a-t 	 prosych-a-t
protagorovi 	 protagor-ovi 	 protagorovi
proteplit 	 pro-tep-l-i-t 	 protepl-i-t
protiabcházský 	 proti-abcház-sk-ý 	 proti-abcházský
protisluneční 	 proti-slun-eč-n-í 	 pro-tislunečn-í
protivit 	 protiv-i-t 	 pro-tivi-t
protkání 	 pro-tk-á-n-í 	 protk-án-í
proto 	 pro-t-o 	 proto
proužek 	 prouž-ek 	 proužek
provincií 	 provinc-i-í 	 pro-vinc-i-í
provzdychat 	 pro-vz-dych-a-t 	 pro-vzdych-at
prováděný 	 pro-vád-ě-n-ý 	 pro-vád-ěn-ý
prozradit 	 pro-z-rad-i-t 	 pro-zrad-i-t
pročež 	 pro-č-e-ž 	 pročež
pročpak 	 proč-pak 	 pročpak
prošel 	 pro-še-l 	 proš-el
prožívám 	 pro-ží-v-á-m 	 pro-ží-v-ám
prstíčky 	 prst-íč-k-y 	 prst-íčk-y
právem 	 práv-e-m 	 práv-em
pršelo 	 prš-e-l-o 	 prš-el-o
průběh 	 prů-běh 	 průběh
průhledy 	 prů-hled-y 	 průhled-y
průmyslově 	 prů-mysl-ov-ě 	 prů-myslov-ě
psacím 	 ps-a-c-í-m 	 psac-í-m
psali 	 ps-a-l-i 	 psa-l-i
psaním 	 ps-a-n-í-m 	 psan-í-m
psychično 	 psych-ič-n-o 	 psychič-n-o
psychologistickou 	 psycho-log-ist-ic-k-ou 	 psych-o-log-ist-ic-k-ou
psům 	 ps-ů-m 	 psům
ptejme 	 pt-ej-me 	 ptej-me
publicita 	 public-it-a 	 publicit-a
pusinka 	 pus-in-k-a 	 pus-ink-a
pučálka 	 pučálk-a 	 puč-álk-a
pyšnit 	 pyš-n-i-t 	 pyšn-i-t
pzt 	 p-z-t 	 pzt
pápěrka 	 pá-pěr-k-a 	 pápěrk-a
párkovat 	 pár-k-ova-t 	 pár-k-ovat
píti 	 pít-i 	 píti
pódium 	 pódi-um 	 pódium
pěkném 	 pěkn-é-m 	 pěkn-ém
pětikorunovou 	 pět-i-korun-ov-ou 	 pět-ikorunovou
pětistovkou 	 pět-i-st-ovk-ou 	 pětistovkou
přebásnitelně 	 pře-básn-i-teln-ě 	 pře-bás-n-i-teln-ě
předcházejí 	 před-cház-e-j-í 	 před-cház-ejí
předcházet 	 před-cház-e-t 	 před-cház-et
předepsanou 	 přede-ps-a-n-ou 	 předepsanou
předepíše 	 přede-píš-e 	 předepíše
předlétnout 	 před-lét-nou-t 	 předlét-nout
předobjednávání 	 před-ob-jedn-á-v-á-n-í 	 pře-dobjed-nává-n-í
předpojaté 	 před-po-j-a-t-é 	 před-pojaté
předpoklady 	 před-po-klad-y 	 před-poklady
předprodeje 	 před-pro-d-ej-e 	 před-prodeje
předrahá 	 pře-drah-á 	 předrah-á
předražit 	 pře-draž-i-t 	 předraž-i-t
předražovat 	 pře-draž-ova-t 	 předraž-ovat
předsedům 	 před-sed-ů-m 	 před-sed-ům
představiteli 	 před-stav-i-tel-i 	 před-stav-i-teli
předstihujícím 	 před-stih-uj-í-c-í-m 	 před-stihujícím
předvýrobní 	 před-vý-rob-n-í 	 předvýrobn-í
předvědecky 	 před-věd-ec-k-y 	 před-věd-ecky
předzpívat 	 před-zpí-v-a-t 	 před-zpí-v-at
předělati 	 pře-děl-a-ti 	 předělati
přehled 	 pře-hled 	 přehled
přehlušováno 	 pře-hluš-ová-n-o 	 pře-hluš-ováno
přehnojit 	 pře-hnoj-i-t 	 přehn-oj-i-t
přehrazovat 	 pře-hraz-ova-t 	 pře-hraz-ovat
přehryzovat 	 pře-hryz-ova-t 	 pře-hryzovat
přehrát 	 pře-hrá-t 	 pře-hrát
přejmenovat 	 pře-jmen-ova-t 	 přejmen-ovat
přejímce 	 pře-j-í-m-c-e 	 pře-jímce
překontrolovat 	 pře-kontrol-ova-t 	 pře-kontrolovat
překontrolována 	 pře-kontrol-ová-n-a 	 pře-kontrolována
překrucování 	 pře-kruc-ová-n-í 	 pře-kruc-ová-ní
překrájet 	 pře-kráj-e-t 	 překrájet
překrýt 	 pře-krý-t 	 pře-krýt
překvapen 	 pře-kvap-en 	 překvapen
překážky 	 pře-káž-k-y 	 pře-kážk-y
přeložte 	 pře-lož-te 	 pře-ložte
přemnohý 	 pře-mnoh-ý 	 přemnoh-ý
přemýšlel 	 pře-mýšl-e-l 	 pře-mýšlel
přemýšlivější 	 pře-mýšl-iv-ějš-í 	 pře-mýšliv-ější
přeorientovat 	 pře-orient-ova-t 	 pře-orient-ovat
přepnout 	 pře-pn-ou-t 	 přep-nou-t
přeroubovat 	 pře-roub-ova-t 	 přeroub-ovat
přesahovaly 	 pře-sah-ova-l-y 	 pře-sah-ova-ly
přeslabikovat 	 pře-slabik-ova-t 	 pře-slabik-ovat
přesný 	 přesn-ý 	 přes-n-ý
přesnější 	 přesn-ěj-š-í 	 přes-n-ějš-í
přestanou 	 pře-sta-n-ou 	 přestan-ou
přestavovat 	 pře-stav-ova-t 	 pře-stav-ovat
přestoupnout 	 pře-stoup-nou-t 	 pře-stoup-nout
přestřelit 	 pře-střel-i-t 	 pře-střeli-t
přesunuly 	 pře-su-nu-l-y 	 přesunul-y
přesáhl 	 pře-sáh-l 	 pře-sáhl
přesáhla 	 pře-sáh-l-a 	 pře-sáhl-a
přesázet 	 pře-sáz-e-t 	 pře-sáz-et
přetisknout 	 pře-tisk-nou-t 	 přetisk-nou-t
přetřásat 	 pře-třás-a-t 	 pře-třásat
převedeny 	 pře-ved-en-y 	 pře-ved-eny
převálet 	 pře-vál-e-t 	 pře-vál-et
převést 	 pře-vés-t 	 pře-vést
převýšil 	 pře-výš-i-l 	 pře-výši-l
přezdít 	 pře-zd-í-t 	 pře-zdít
přezout 	 pře-zou-t 	 pře-zout
přečin 	 pře-čin 	 přečin
přečíslovat 	 pře-čísl-ova-t 	 pře-čísl-ovat
přežití 	 pře-ži-t-í 	 pře-žit-í
přicházet 	 při-cház-e-t 	 přicházet
přihřívat 	 při-hří-v-a-t 	 při-hřív-a-t
přijali 	 při-j-a-l-i 	 při-j-a-li
přijatelná 	 při-j-a-teln-á 	 při-ja-teln-á
přijdu 	 při-jd-u 	 přijd-u
přijmout 	 při-j-mou-t 	 při-jmout
přijíždějí 	 při-jížd-ěj-í 	 při-jížděj-í
přikračovat 	 při-krač-ova-t 	 při-krač-ovat
přikrádat 	 při-krád-a-t 	 při-krád-at
přilepšit 	 při-lep-š-i-t 	 při-lepš-i-t
připluje 	 při-plu-je 	 připluje
připochodovat 	 při-po-chod-ova-t 	 při-pochod-ovat
připodobit 	 při-po-dob-i-t 	 při-podobi-t
připomenout 	 při-po-men-ou-t 	 při-pomenout
připomínky 	 při-po-mín-k-y 	 při-pomínk-y
přirovnat 	 při-rov-n-a-t 	 přirovnat
přispořit 	 při-spoř-i-t 	 přispoř-i-t
přistrojit 	 při-stroj-i-t 	 při-stroji-t
přistříhat 	 při-stříh-a-t 	 při-stříha-t
přisvědčit 	 při-svědč-i-t 	 při-svěd-č-i-t
přitiskne 	 při-tisk-ne 	 při-tiskne
přitiskovat 	 při-tisk-ova-t 	 při-tisk-ovat
přivydělávat 	 při-vy-děl-á-v-a-t 	 při-vyděl-á-vat
přiznej 	 při-zn-e-j 	 přiznej
přizpůsobení 	 při-z-pů-sob-en-í 	 při-způ-sobení
přizpůsobivosti 	 při-z-pů-sob-i-v-ost-i 	 při-způsob-ivosti
přišinout 	 při-šin-ou-t 	 přiši-nout
přišpendlit 	 při-špendl-i-t 	 při-špendl-it
přídavky 	 pří-d-a-v-k-y 	 příd-avk-y
příjemně 	 pří-jem-n-ě 	 pří-jemn-ě
příjmy 	 pří-jm-y 	 příjm-y
příkladně 	 pří-klad-n-ě 	 příklad-n-ě
příležitost 	 pří-lež-it-ost 	 pří-ležitost
přímé 	 přím-é 	 přímé
přímém 	 přím-é-m 	 přímém
přísaze 	 pří-saz-e 	 přísaze
přísné 	 přísn-é 	 přís-n-é
přísní 	 přísn-í 	 přís-n-í
přístupna 	 pří-stup-n-a 	 přístupna
přístupy 	 pří-stup-y 	 přístup-y
přítomny 	 pří-t-o-m-n-y 	 pří-tomn-y
přítomném 	 pří-t-o-m-n-é-m 	 pří-tom-n-ém
přítomnými 	 pří-t-o-m-n-ý-m-i 	 pří-tom-n-ými
přízemí 	 pří-zem-í 	 přízemí
příznivý 	 pří-zn-iv-ý 	 přízn-iv-ý
příštipkovat 	 pří-štip-k-ova-t 	 příštipk-ovat
příštího 	 příšt-í-ho 	 příšt-ího
pšeničné 	 pšen-ič-n-é 	 pšenič-n-é
pšenka 	 pšen-k-a 	 pšenk-a
půjdu 	 pů-jd-u 	 půjd-u
půlsnímkovost 	 půl-s-ním-k-ov-ost 	 půls-n-ímkovost
působí 	 pů-sob-í 	 působ-í
původ 	 pů-vod 	 původ
původní 	 pů-vod-n-í 	 původ-n-í
rachotit 	 rach-ot-i-t 	 rachot-i-t
racionalism 	 racion-al-ism 	 racion-alism
radikalizovat 	 radik-al-iz-ova-t 	 radik-al-izovat
radili 	 rad-i-l-i 	 radi-l-i
radomír 	 radomír 	 rad-omír
raději 	 rad-ěji 	 raději
rakousku 	 rakous-k-u 	 rakousk-u
rameni 	 ram-en-i 	 ramen-i
raneček 	 raneč-ek 	 raneček
razítky 	 raz-í-tk-y 	 raz-ítk-y
realizovat 	 real-iz-ova-t 	 realizova-t
referát 	 re-fer-át 	 referát
reflex 	 re-flex 	 reflex
regentíkův 	 regent-ík-ův 	 regentík-ův
rejstříku 	 rejstřík-u 	 rejstříku
reklamace 	 reklam-ac-e 	 reklamac-e
reklamu 	 reklam-u 	 reklamu
rektorem 	 rekt-or-em 	 rektorem
relativita 	 rel-at-iv-it-a 	 relativita
relativizování 	 relat-iv-izová-n-í 	 relat-iv-izování
repeal 	 repeal 	 repea-l
replikovat 	 re-plik-ova-t 	 replik-ova-t
reportáž 	 re-port-áž 	 reportáž
reprodukční 	 re-pro-duk-č-n-í 	 reprodukč-n-í
resignovat 	 re-sign-ova-t 	 resign-ova-t
restriktivní 	 re-strikt-iv-n-í 	 restrikt-ivn-í
revidovat 	 re-vid-ova-t 	 revid-ova-t
revolucí 	 revol-uc-í 	 revoluc-í
rezervy 	 re-zerv-y 	 rezerv-y
rider 	 rid-er 	 rider
rivalové 	 rival-ové 	 rival-ov-é
rohovatět 	 roh-ov-at-ě-t 	 roh-ov-at-ět
roháček 	 roh-áč-ek 	 roháček
rolling 	 roll-ing 	 rolling
rolničit 	 rol-n-ič-i-t 	 rol-niči-t
rostl 	 rost-l 	 rostl
roxby 	 roxby 	 roxb-y
rozběhli 	 roz-běh-l-i 	 roz-běh-li
rozchlípnout 	 roz-chlíp-nou-t 	 roz-chlíp-nout
rozchraptit 	 roz-chrap-t-i-t 	 roz-chrapt-it
rozdrnčet 	 roz-drnč-e-t 	 rozdrnč-et
rozdělení 	 roz-děl-en-í 	 roz-dělen-í
rozecpávat 	 roze-cp-á-v-a-t 	 roze-cpá-v-a-t
rozeklát 	 roze-kl-á-t 	 rozeklá-t
rozestřel 	 roze-stř-e-l 	 roze-střel
rozestřít 	 roze-stř-í-t 	 roze-střít
rozesílán 	 roze-síl-á-n 	 roze-síl-án
rozevírat 	 roze-vír-a-t 	 roze-vír-at
rozhrnula 	 roz-hrn-u-l-a 	 roz-hrnu-l-a
rozjet 	 roz-je-t 	 rozje-t
rozjíždět 	 roz-jížd-ě-t 	 roz-jížd-ět
rozkout 	 roz-kou-t 	 roz-kout
rozkošným 	 roz-koš-n-ý-m 	 roz-koš-n-ým
rozkročen 	 roz-kroč-en 	 roz-kročen
rozkuckat 	 roz-kuc-k-a-t 	 roz-kuck-at
rozkývat 	 roz-kýv-a-t 	 roz-ký-v-a-t
rozkřiknout 	 roz-křik-nou-t 	 roz-křik-nout
rozmotat 	 roz-mot-a-t 	 roz-mota-t
rozmělnit 	 roz-měl-n-i-t 	 roz-měln-i-t
rozplýtvat 	 roz-plýtv-a-t 	 roz-plýtva-t
rozplývat 	 roz-plý-v-a-t 	 roz-plýv-a-t
rozpočísti 	 roz-po-číst-i 	 roz-počísti
rozpracovat 	 roz-prac-ova-t 	 roz-prac-ovat
rozprasknout 	 roz-prask-nou-t 	 roz-prasknout
rozpraskovat 	 roz-prask-ova-t 	 roz-praskovat
rozprodávat 	 roz-pro-d-á-v-a-t 	 roz-prodá-v-at
rozpíchat 	 roz-pích-a-t 	 roz-pích-at
rozstupovat 	 roz-stup-ova-t 	 roz-stup-ovat
rozstřihnout 	 roz-střih-nou-t 	 roz-střihnout
rozstříknout 	 roz-střík-nou-t 	 roz-stříknout
rozteskňovat 	 roz-tesk-ň-ova-t 	 roz-tesk-ň-ovat
rozumových 	 roz-um-ov-ý-ch 	 rozum-ov-ých
rozutíkat 	 roz-utík-a-t 	 rozutík-at
rozuzlovat 	 roz-uzl-ova-t 	 rozuzl-ova-t
rozvinovat 	 roz-vi-n-ova-t 	 roz-vin-ova-t
rozvlékat 	 roz-vlék-a-t 	 roz-vlék-at
rozvojem 	 roz-voj-em 	 roz-vojem
rozvíjeny 	 roz-víj-en-y 	 roz-víjen-y
rozvětvené 	 roz-větv-en-é 	 roz-větven-é
rozčechrávat 	 roz-čechr-á-v-a-t 	 roz-čechrá-vat
rozšiřování 	 roz-šiř-ová-n-í 	 roz-šiř-ová-ní
rozškvařovat 	 roz-škvař-ova-t 	 roz-škvař-ovat
rozšlapávat 	 roz-šlap-á-v-a-t 	 roz-šlap-á-v-at
rošťák 	 rošť-ák 	 rošťák
rupií 	 rupi-í 	 rup-i-í
ruské 	 rus-k-é 	 rusk-é
rusové 	 rus-ové 	 rus-ov-é
ručkovat 	 ruč-k-ova-t 	 ručk-ovat
ryzost 	 ryz-ost 	 ryzost
ráfovat 	 ráf-ova-t 	 ráf-ovat
rázem 	 ráz-e-m 	 ráz-em
rázná 	 ráz-n-á 	 rázn-á
ráčkovat 	 ráč-k-ova-t 	 ráčk-ovat
různými 	 různ-ý-m-i 	 růz-n-ými
sagnac 	 sagnac 	 sagn-ac
salonku 	 salon-k-u 	 salonk-u
salutuju 	 salut-uj-u 	 salut-uju
samcoložník 	 samc-o-lož-n-ík 	 samco-lož-n-ík
sametově 	 samet-ov-ě 	 samet-ově
samostatnější 	 sam-o-stat-n-ějš-í 	 sam-ostat-n-ější
samotáři 	 sam-ot-ář-i 	 samotáři
samozřejmá 	 sam-o-zř-ejm-á 	 sam-ozřejm-á
sankcemi 	 sankc-emi 	 sankcemi
sazeb 	 saz-eb 	 sazeb
sbratřit 	 s-bratř-i-t 	 sbratř-i-t
sbubnovat 	 s-bubn-ova-t 	 sbubn-ova-t
sbuntován 	 s-bunt-ová-n 	 sbunt-ován
sbírala 	 s-bír-a-l-a 	 sbír-a-l-a
schodech 	 s-chod-e-ch 	 schodech
schody 	 s-chod-y 	 schod-y
schopných 	 s-chop-n-ých 	 schop-n-ých
schovat 	 s-chov-a-t 	 sch-ova-t
schumlat 	 s-chuml-a-t 	 schumla-t
scienza 	 scienza 	 scienz-a
scorpions 	 scorpion-s 	 scorpions
sdružil 	 s-druž-i-l 	 sdruž-i-l
sebelepší 	 seb-e-lep-š-í 	 sebelepší
sebeničením 	 s-eb-e-ni-č-en-í-m 	 seb-eničen-ím
sebevíce 	 seb-e-víc-e 	 sebevíce
sebral 	 se-br-a-l 	 sebr-al
secvičit 	 se-cvič-i-t 	 secviči-t
sedla 	 sed-l-a 	 sedl-a
sedláková 	 sedl-ák-ov-á 	 sedlák-ov-á
sedmihradsku 	 sedmihradsk-u 	 sedmihradsku
sehrávat 	 se-hrá-v-a-t 	 sehrá-v-a-t
seknout 	 sek-nou-t 	 sek-nout
seminární 	 semin-ár-n-í 	 seminárn-í
semílat 	 se-míl-a-t 	 semíl-a-t
separátní 	 se-par-át-n-í 	 separát-n-í
sepnout 	 se-pn-ou-t 	 sep-nout
sesekat 	 se-sek-a-t 	 sesek-at
seskupit 	 se-skup-i-t 	 seskup-i-t
sesmyknout 	 se-s-myk-nou-t 	 ses-myk-nou-t
sestává 	 se-stá-v-á 	 se-st-á-v-á
setkal 	 se-tk-a-l 	 setk-a-l
seychelančin 	 seychel-an-č-in 	 seychelančin
seznamuji 	 se-znam-uj-i 	 seznamuji
seznámit 	 se-znám-i-t 	 seznámi-t
seřizovat 	 se-řiz-ova-t 	 seřiz-ovat
seškrabovat 	 se-škrab-ova-t 	 se-škrab-ovat
shodou 	 s-hod-ou 	 shod-ou
shora 	 s-hor-a 	 shor-a
shrnout 	 s-hr-nou-t 	 shr-nou-t
sháňku 	 s-háň-k-u 	 sháň-k-u
signalizovali 	 signal-iz-ova-l-i 	 sign-al-iz-ovali
silná 	 sil-n-á 	 siln-á
skasat 	 s-kas-a-t 	 skas-a-t
sklapne 	 s-klap-n-e 	 sklapne
skličovat 	 s-klič-ova-t 	 sklič-ova-t
skládala 	 s-klád-a-l-a 	 sklád-al-a
skládaly 	 s-klád-a-l-y 	 sklád-a-l-y
skomírat 	 s-ko-mír-a-t 	 skomír-a-t
skončení 	 s-konč-en-í 	 skonč-en-í
skončil 	 s-konč-i-l 	 skon-či-l
skončila 	 s-konč-i-l-a 	 skonč-il-a
skončí 	 s-konč-í 	 skon-č-í
skroutit 	 s-krout-i-t 	 skrout-i-t
skrývala 	 s-krýv-a-l-a 	 skrýv-al-a
skutečnosti 	 s-kut-eč-n-ost-i 	 skuteč-n-osti
skutečném 	 s-kut-eč-n-é-m 	 skut-eč-n-ém
skříňce 	 skříň-c-e 	 skříňc-e
slavnějším 	 slav-n-ěj-š-í-m 	 slav-n-ějš-ím
sledovány 	 sled-ová-n-y 	 sled-ován-y
slejvat 	 s-lej-v-a-t 	 slej-v-at
slev 	 s-lev 	 slev
slevu 	 s-lev-u 	 slev-u
slez 	 s-lez 	 slez
slibuji 	 s-lib-uj-i 	 slib-uji
sloupoví 	 sloup-ov-í 	 sloup-oví
slovensko 	 sloven-sk-o 	 sloven-sko
slovným 	 slov-n-ý-m 	 slov-n-ým
sluchu 	 sluch-u 	 sluchu
slízal 	 s-líz-a-l 	 slíz-a-l
smekl 	 s-mek-l 	 smekl
smiřovat 	 s-miř-ova-t 	 smiř-ovat
smrtelném 	 s-mr-tel-n-é-m 	 smrtelném
smrtelnému 	 s-mr-tel-n-é-mu 	 smrtelnému
smyslových 	 s-mysl-ov-ý-ch 	 smysl-ov-ých
smésti 	 s-mést-i 	 smésti
smířit 	 s-míř-i-t 	 smíř-i-t
směrem 	 s-měr-e-m 	 směr-em
snahami 	 snah-a-m-i 	 snah-ami
snů 	 sn-ů 	 snů
sobectví 	 sob-ec-tv-í 	 sobectví
sobě 	 s-ob-ě 	 sob-ě
socializovat 	 soci-al-iz-ova-t 	 social-izovat
solarmax 	 solar-max 	 solarmax
solidních 	 solid-n-í-ch 	 solid-n-ích
sonduje 	 sond-uje 	 sonduje
sotva 	 sotva 	 sotv-a
souboj 	 sou-boj 	 souboj
souborů 	 sou-bor-ů 	 soubor-ů
soucitně 	 sou-cit-n-ě 	 soucit-n-ě
souhlasný 	 sou-hlas-n-ý 	 souhlas-n-ý
souhlasí 	 sou-hlas-í 	 souhlas-í
soukromník 	 sou-krom-ník 	 soukromník
soused 	 sou-sed 	 soused
sousedit 	 sou-sed-i-t 	 soused-i-t
sousedního 	 sou-sed-n-í-ho 	 sousedn-ího
soustava 	 sou-stav-a 	 soustav-a
soustružit 	 sou-struž-i-t 	 sou-struži-t
soutěž 	 sou-těž 	 soutěž
soutěže 	 sou-těž-e 	 soutěže
soutěži 	 sou-těž-i 	 soutěži
soutěžit 	 sou-těž-i-t 	 soutěž-i-t
souvislost 	 sou-vis-l-ost 	 souvisl-ost
současná 	 sou-čas-n-á 	 současn-á
spadla 	 s-pad-l-a 	 spadl-a
spadne 	 s-pad-ne 	 spadne
spaly 	 sp-a-l-y 	 spal-y
specialisté 	 speci-al-ist-é 	 specialisté
specializované 	 speci-al-iz-ova-n-é 	 speci-al-iz-ova-né
specifickým 	 speci-fic-k-ý-m 	 specifick-ým
speciál 	 speci-ál 	 speciál
spekulací 	 spekul-ac-í 	 spekulac-í
spekulantem 	 spek-ul-ant-e-m 	 spekulantem
spekulativní 	 spekul-at-iv-n-í 	 spekulativn-í
spis 	 s-pis 	 spis
spisovat 	 s-pis-ova-t 	 spis-ovat
splatit 	 s-plat-i-t 	 splat-i-t
splašené 	 s-plaš-en-é 	 splaš-ené
splnit 	 s-pln-i-t 	 spln-i-t
splněno 	 s-pln-ěn-o 	 spln-ěn-o
spojkami 	 s-poj-k-a-m-i 	 spojk-ami
spokojena 	 s-po-koj-en-a 	 spokoj-en-a
spokojíte 	 s-pokoj-í-te 	 spokoj-í-te
spolehliví 	 s-po-leh-liv-í 	 spolehliv-í
společných 	 spol-eč-n-ých 	 společ-n-ých
spolupodepsat 	 spol-u-pode-ps-a-t 	 spolu-podepsat
spolupůsobit 	 spol-u-působ-i-t 	 spolupůsobi-t
spolutvořit 	 spol-u-tvoř-i-t 	 spolu-tvoři-t
spoléhej 	 s-po-léh-ej 	 spoléhej
sponzorsky 	 sponzor-sk-y 	 sponzorsk-y
spotřebitel 	 s-po-třeb-i-tel 	 spotřeb-i-tel
spotřebitele 	 s-po-třeb-i-tel-e 	 spo-třeb-i-tele
spoután 	 s-pout-á-n 	 spoután
spočítal 	 s-po-čít-a-l 	 spočít-a-l
spočítá 	 s-po-čít-á 	 spočít-á
spoří 	 s-poř-í 	 spoř-í
spravedlivost 	 s-prav-ed-l-iv-ost 	 spravedl-ivost
spáchat 	 s-pách-a-t 	 spách-a-t
srdečně 	 srd-eč-n-ě 	 srd-ečn-ě
srovnatelná 	 s-rov-n-a-teln-á 	 srovn-atelná
srozumitelně 	 s-roz-um-i-teln-ě 	 srozum-i-telně
stanoven 	 stanov-en 	 stanoven
stanovení 	 stan-ov-en-í 	 stanoven-í
stanovil 	 stanov-i-l 	 stan-ovi-l
stanovit 	 stan-ov-i-t 	 stanovi-t
stanoví 	 stan-ov-í 	 stan-oví
starat 	 star-a-t 	 star-at
starobní 	 star-ob-n-í 	 starob-n-í
starožitných 	 star-o-ži-t-n-ých 	 starožit-n-ých
starých 	 star-ý-ch 	 starých
stavení 	 sta-v-en-í 	 stav-en-í
staříkovi 	 stař-ík-ovi 	 staříkovi
staška 	 staš-k-a 	 stašk-a
stejkaně 	 s-tejk-a-n-ě 	 stejk-an-ě
stejném 	 stej-n-é-m 	 stej-n-ém
stipendium 	 stipendi-um 	 stipendium
stlačit 	 s-tlač-i-t 	 stlači-t
stlouci 	 s-tlouc-i 	 stlouc-i
stokorunovou 	 st-o-korun-ov-ou 	 stokorunovou
století 	 st-o-let-í 	 stolet-í
stones 	 stone-s 	 stones
stovkou 	 st-ovk-ou 	 stov-k-ou
stovku 	 st-ovk-u 	 stovk-u
strahova 	 strahov-a 	 strah-ova
strahově 	 strahov-ě 	 strah-ově
strava 	 s-trav-a 	 strav-a
strašnicích 	 strašnic-í-ch 	 straš-nic-ích
strnutí 	 s-trn-u-t-í 	 strnut-í
stroje 	 stroj-e 	 stroje
strojírenské 	 stroj-íren-sk-é 	 strojírenské
stránku 	 strán-k-u 	 stránk-u
student 	 stud-ent 	 student
studentů 	 stud-ent-ů 	 student-ů
studenět 	 stud-en-ě-t 	 studenět
studijní 	 stud-ij-n-í 	 studijn-í
studiích 	 stud-i-í-ch 	 stud-i-ích
stulit 	 s-tul-i-t 	 stul-i-t
stužka 	 stuž-k-a 	 stužk-a
stála 	 stá-l-a 	 stál-a
stýkati 	 s-týk-a-ti 	 stýk-ati
stěžovatel 	 stěž-ova-tel 	 s-těž-ova-tel
střechách 	 střech-á-ch 	 střech-ách
střelit 	 střel-i-t 	 střeli-t
střepávat 	 s-třep-á-v-a-t 	 střep-á-v-a-t
stříbro 	 stříbr-o 	 stříbro
stříbrolesklého 	 stříbr-o-lesk-l-é-ho 	 stříbrolesklého
střízlivět 	 stříz-l-iv-ě-t 	 stříz-liv-ě-t
sundavat 	 s-und-a-v-a-t 	 sund-ava-t
superdobrý 	 super-dobr-ý 	 sup-erdobr-ý
supernova 	 super-nova 	 supern-ova
supraphon 	 supra-phon 	 supraphon
svalnatý 	 sval-nat-ý 	 svaln-at-ý
svedena 	 s-ved-en-a 	 sved-en-a
svlékat 	 s-vlék-a-t 	 svlék-a-t
svlékla 	 s-vlék-l-a 	 svlékl-a
svraštil 	 s-vrašt-i-l 	 svraštil
svrtět 	 s-vrt-ě-t 	 svrt-ě-t
svát 	 s-vá-t 	 svá-t
svídnici 	 svídnic-i 	 svíd-n-ic-i
svítily 	 svít-i-l-y 	 svít-il-y
svědkové 	 s-věd-k-ové 	 svěd-k-ov-é
svědomím 	 s-věd-om-í-m 	 svěd-omím
světelné 	 svět-el-n-é 	 světelné
světelných 	 svět-el-n-ých 	 světeln-ých
světově 	 svět-ov-ě 	 svět-ově
světskému 	 svět-sk-ému 	 svět-skému
synchronizovat 	 syn-chron-iz-ova-t 	 synchronizovat
systematický 	 system-at-ic-k-ý 	 systematický
systémem 	 systém-e-m 	 systémem
sáňkovávací 	 sáň-k-ová-v-a-c-í 	 sáňková-v-ac-í
sít 	 sí-t 	 sít
sčítávat 	 s-čít-á-v-a-t 	 sčít-á-v-a-t
sžívat 	 s-ží-v-a-t 	 sžív-a-t
tabule 	 tabul-e 	 tabule
tahal 	 tah-a-l 	 taha-l
tajemství 	 taj-em-stv-í 	 tajemstv-í
tajná 	 taj-n-á 	 tajn-á
takzvaném 	 tak-zv-a-n-é-m 	 takzv-an-ém
také 	 také 	 tak-é
takřečená 	 tak-řeč-en-á 	 takřeč-en-á
tati 	 tat-i 	 tati
taxík 	 tax-ík 	 taxík
technickým 	 techn-ic-k-ým 	 techn-ick-ým
technika 	 techn-ik-a 	 technik-a
telat 	 tel-at 	 tela-t
telefonního 	 tele-fon-n-í-ho 	 tele-fon-ního
temporalizovatelný 	 tempor-al-izova-teln-ý 	 temporal-izovatelný
tendenci 	 tend-enc-i 	 tendenc-i
tenhle 	 t-en-hle 	 tenhle
tenounkým 	 ten-oun-k-ý-m 	 tenounk-ým
terminologii 	 termino-log-i-i 	 terminologii
termínovat 	 termín-ova-t 	 termín-ovat
tesklivých 	 tesk-l-iv-ý-ch 	 teskl-iv-ých
tetička 	 tet-ič-k-a 	 tet-ičk-a
textil 	 textil 	 text-i-l
thajska 	 thaj-sk-a 	 thajsk-a
theodicée 	 theodicée 	 theod-ic-ée
tikem 	 tik-e-m 	 tik-em
tipnout 	 tip-nou-t 	 tip-nout
tipovali 	 tip-ova-l-i 	 tip-oval-i
tisovitý 	 tis-ovit-ý 	 tisovit-ý
tj 	 t-j 	 tj
tkalcovnictví 	 tka-lc-ovnic-tv-í 	 tkalc-ov-nictví
tlapkách 	 tlap-k-á-ch 	 tlap-k-ách
totožný 	 totožn-ý 	 totož-n-ý
tou 	 t-ou 	 tou
tragičnost 	 trag-ič-n-ost 	 trag-ičn-ost
transplantační 	 trans-plant-ač-n-í 	 transplantační
treperendo 	 treper-end-o 	 treperendo
trestat 	 trest-a-t 	 trest-at
trochu 	 troch-u 	 trochu
trojí 	 tr-oj-í 	 troj-í
trpělivě 	 trp-ě-l-iv-ě 	 trpěl-iv-ě
truhlářský 	 truhl-ář-sk-ý 	 truhlářsk-ý
trutnovský 	 trutnov-sk-ý 	 trutn-ovsk-ý
tržba 	 trž-b-a 	 tržb-a
tull 	 tull 	 tul-l
tupnout 	 tup-nou-t 	 tup-nout
turbodmychadlo 	 turbo-dmych-adl-o 	 turbodmychadlo
turbovrtulových 	 turbo-vrt-ul-ov-ých 	 turb-ovrtulových
turecký 	 turec-k-ý 	 tur-eck-ý
turistiky 	 tur-ist-ik-y 	 turistik-y
turné 	 turné 	 turn-é
tužba 	 tuž-b-a 	 tužb-a
tužeb 	 tuž-eb 	 tužeb
tvrzeními 	 tvrz-en-í-m-i 	 tvrz-eními
tzv 	 t-z-v 	 tzv
táhlo 	 táh-l-o 	 táhl-o
téhož 	 t-é-ho-ž 	 téhož
tématu 	 tém-at-u 	 témat-u
tímhle 	 t-í-m-hle 	 tímhle
tímto 	 t-í-m-t-o 	 tímt-o
tít 	 t-í-t 	 tít
týrat 	 týr-a-t 	 týra-t
těmi 	 t-ě-m-i 	 těmi
těšili 	 těš-i-l-i 	 těši-l-i
třemi 	 tř-e-m-i 	 třemi
třepetat 	 třep-et-a-t 	 třepeta-t
třesoucí 	 třes-ou-c-í 	 třesouc-í
třetím 	 tř-e-t-í-m 	 třet-í-m
třiceti 	 tř-i-cet-i 	 třiceti
třineckých 	 třinec-k-ých 	 třineck-ých
třísla 	 třís-l-a 	 třísl-a
udýchanej 	 u-dých-a-n-ej 	 u-dýchan-ej
uhasnout 	 u-has-nou-t 	 uhas-nou-t
uhořet 	 u-hoř-e-t 	 uhoř-e-t
ujelo 	 u-je-l-o 	 ujelo
ukazuju 	 u-kaz-u-j-u 	 u-kaz-uj-u
ukaž 	 u-kaž 	 ukaž
ukrutným 	 u-krut-n-ý-m 	 u-krut-n-ým
ukryl 	 u-kry-l 	 u-kryl
ukuckat 	 u-kuc-k-a-t 	 u-kuck-a-t
ulici 	 ul-ic-i 	 ulic-i
uloupení 	 u-loup-en-í 	 uloup-en-í
ulovit 	 u-lov-i-t 	 ulov-i-t
uloženými 	 u-lož-en-ý-m-i 	 u-lož-en-ými
ulíznout 	 u-líz-nou-t 	 ulíz-nou-t
umačkat 	 u-mačk-a-t 	 umačk-at
umdlívat 	 u-mdl-í-v-a-t 	 umdl-í-v-a-t
umožnilo 	 u-možn-i-l-o 	 u-mož-n-il-o
umožnily 	 u-možn-i-l-y 	 u-možn-il-y
umrtvení 	 u-mr-tv-en-í 	 umrtv-en-í
uměle 	 u-m-ě-l-e 	 uměle
umělkovat 	 um-ě-l-k-ova-t 	 umělk-ova-t
umělostech 	 u-m-ě-l-ost-e-ch 	 umělost-ech
unese 	 u-nes-e 	 u-nese
univerzitního 	 uni-verz-it-n-ího 	 univerzitn-ího
uplynulo 	 u-ply-nu-l-o 	 u-ply-nul-o
upokojovat 	 u-po-koj-ova-t 	 u-pokoj-ova-t
upozornit 	 u-po-zor-n-i-t 	 upozor-n-i-t
upozorňujeme 	 u-po-zor-ň-uje-me 	 u-pozorňujeme
upravili 	 u-prav-i-l-i 	 u-prav-i-li
urgenci 	 urg-enc-i 	 urgenc-i
urgencích 	 urgenc-ích 	 urgen-c-ích
urychlila 	 u-rychl-i-l-a 	 u-rychl-il-a
určeno 	 u-rč-en-o 	 urč-en-o
určenou 	 u-rč-en-ou 	 urč-en-ou
určovaly 	 u-rč-ova-l-y 	 urč-ova-l-y
usa 	 u-s-a 	 usa
uschovávat 	 u-s-chov-á-v-a-t 	 u-schov-á-v-a-t
usd 	 u-s-d 	 usd
usilovně 	 u-sil-ov-n-ě 	 usil-ov-n-ě
usiluje 	 u-sil-uje 	 usiluje
uskladňovat 	 u-s-klad-ň-ova-t 	 u-sklad-ň-ovat
uskutečnila 	 u-skuteč-n-i-l-a 	 u-skuteč-n-il-a
uskutečnily 	 u-s-kut-eč-n-i-l-y 	 u-skuteč-nily
uspokojen 	 u-s-po-koj-en 	 u-spokojen
uspořádat 	 u-s-po-řád-a-t 	 u-spořád-a-t
ustanoveními 	 u-stanov-en-ími 	 u-stan-oven-ími
ustrnule 	 u-s-trn-u-l-e 	 u-str-nule
usvědčit 	 u-svědč-i-t 	 u-svěd-č-i-t
utrmácet 	 u-trmác-e-t 	 u-trmác-et
utřel 	 u-tř-e-l 	 u-třel
uvidíte 	 u-vid-í-te 	 uvid-í-te
uváděním 	 u-vád-ě-n-ím 	 u-vád-ěn-ím
uzavírá 	 u-za-vír-á 	 uzavír-á
uzavřeli 	 u-za-vř-e-l-i 	 u-zavř-e-li
uzdraví 	 u-zdrav-í 	 u-zdr-av-í
uzpůsobit 	 u-z-působ-i-t 	 u-způsob-i-t
učitel 	 uč-i-tel 	 uči-tel
učitelů 	 uč-i-tel-ů 	 uči-tel-ů
uštelovavší 	 u-štel-ova-vš-í 	 u-štel-ovavší
uším 	 uš-ím 	 uší-m
užitečné 	 u-žit-eč-n-é 	 užiteč-n-é
užívá 	 u-ží-v-á 	 u-žív-á
vakuářskost 	 vaku-ář-sk-ost 	 vakuářskost
valašské 	 valaš-sk-é 	 valašsk-é
vanka 	 van-k-a 	 vank-a
vašnosti 	 vaš-n-ost-i 	 vaš-n-osti
vcházet 	 v-cház-e-t 	 vcház-et
vdechnout 	 v-dech-nou-t 	 vdech-nou-t
vegetovat 	 veget-ova-t 	 veget-ovat
vejci 	 vej-c-i 	 vejc-i
velikost 	 vel-ik-ost 	 vel-ikost
velká 	 vel-k-á 	 velk-á
velkého 	 vel-k-é-ho 	 velk-ého
velvyslanectví 	 vel-vy-sl-a-n-ec-tv-í 	 vel-vyslanectví
vemluvit 	 ve-mluv-i-t 	 vemluv-i-t
venkovan 	 ven-k-ov-an 	 venk-ovan
ventures 	 venture-s 	 ventures
venčit 	 ven-č-i-t 	 venč-i-t
vepsat 	 ve-ps-a-t 	 veps-a-t
veslař 	 vesl-ař 	 veslař
vesnici 	 ves-nic-i 	 ves-nici
vespolek 	 ve-s-pol-ek 	 vespolek
vetkat 	 ve-tk-a-t 	 vetk-a-t
vetkávat 	 ve-tk-á-v-a-t 	 vetk-á-v-a-t
vezmeš 	 vez-m-e-š 	 vez-meš
večera 	 večer-a 	 večera
veřejně 	 veř-ej-n-ě 	 veřejn-ě
veškeré 	 veš-k-er-é 	 vešk-eré
veškerým 	 veš-k-er-ý-m 	 vešk-erým
vhodným 	 v-hod-n-ým 	 vhod-n-ým
viděls 	 vid-ě-l-s 	 viděls
vinohradského 	 vinohrad-sk-é-ho 	 vin-ohradského
vkluzovávaně 	 v-kluz-ová-v-a-n-ě 	 v-kluz-ová-van-ě
vladařit 	 vlad-ař-i-t 	 vladaři-t
vlastního 	 vlast-n-í-ho 	 vlast-n-ího
vlaštovčí 	 vlašt-ov-č-í 	 vlašt-ovč-í
vlažnět 	 vlaž-n-ě-t 	 vlaž-n-ět
vlepovat 	 v-lep-ova-t 	 vlep-ova-t
vložit 	 v-lož-i-t 	 vlož-i-t
vložkovací 	 v-lož-k-ova-c-í 	 vložk-ovac-í
vloží 	 v-lož-í 	 vlož-í
vládávatelnost 	 vlád-á-v-a-teln-ost 	 vlád-á-v-a-telnost
vlézt 	 v-léz-t 	 vléz-t
vlítat 	 v-lít-a-t 	 vlít-a-t
vnitřnostech 	 v-nitř-n-ost-e-ch 	 v-nitř-n-ost-ech
vobléknutelný 	 v-ob-lék-nu-teln-ý 	 vob-lék-nu-teln-ý
vodolově 	 vodolov-ě 	 vodol-ov-ě
vodotiskem 	 vod-o-tisk-em 	 vodotiskem
vojenskou 	 voj-en-sk-ou 	 vojen-sk-ou
volán 	 vol-á-n 	 volán
vozidly 	 voz-i-dl-y 	 vozidl-y
vpisovat 	 v-pis-ova-t 	 vpis-ova-t
vplížit 	 v-plíž-i-t 	 vplíž-i-t
vproudit 	 v-proud-i-t 	 vproud-i-t
vpít 	 v-pí-t 	 vpí-t
vraštět 	 vraš-t-ě-t 	 vrašt-ět
vrcholu 	 vrch-ol-u 	 vrchol-u
vrtulníky 	 vrt-ul-ník-y 	 vrtul-ník-y
vrátnice 	 vrát-nic-e 	 vrát-n-ic-e
vstoupil 	 v-stoup-i-l 	 vstoup-i-l
vstoupnutelný 	 v-stoup-nu-teln-ý 	 vstoup-nu-teln-ý
vstup 	 v-stup 	 vstup
vstupenek 	 vs-tup-en-ek 	 v-stup-enek
vstupenka 	 v-stup-enk-a 	 vstupenk-a
vstupenky 	 vstup-enk-y 	 vstupenk-y
vtiskávat 	 v-tisk-á-v-a-t 	 vtisk-á-va-t
vtokový 	 v-tok-ov-ý 	 vtok-ov-ý
vtírá 	 v-tír-á 	 vtír-á
vyabstrahovat 	 vy-abs-trah-ova-t 	 vyabstrah-ova-t
vybafčit 	 vy-baf-č-i-t 	 vy-bafč-i-t
vybojovat 	 vy-boj-ova-t 	 vyboj-ova-t
vybryndat 	 vy-brynd-a-t 	 vy-brynd-at
vybírá 	 vy-bír-á 	 vybír-á
vybízí 	 vy-bíz-í 	 vybíz-í
vyceňovat 	 vy-ceň-ova-t 	 vyceň-ovat
vychlastat 	 vy-chlast-a-t 	 vy-chlasta-t
vychovat 	 vy-chov-a-t 	 vy-chova-t
vydařeném 	 vy-dař-en-ém 	 vydař-en-ém
vydechl 	 vy-dech-l 	 vydechl
vydávaje 	 vy-d-á-v-aj-e 	 vydá-v-aje
vydělávají 	 vy-děl-á-v-aj-í 	 vy-děl-áv-aj-í
vyhlásil 	 vy-hlás-i-l 	 vy-hlási-l
vyhodnocovat 	 vy-hod-n-oc-ova-t 	 vy-hod-noc-ovat
vyhoří 	 vy-hoř-í 	 vyhoř-í
vyjasněný 	 vy-jas-n-ěn-ý 	 vy-jas-něn-ý
vyjel 	 vy-je-l 	 vyjel
vyklopýtat 	 vy-klopýt-a-t 	 vy-klopýta-t
vykonávali 	 vy-kon-á-v-a-l-i 	 vy-kon-áv-al-i
vykramařit 	 vy-kram-ař-i-t 	 vy-kramaři-t
vykrášlit 	 vy-kráš-l-i-t 	 vy-krášl-i-t
vyl 	 vy-l 	 vyl
vylisovat 	 vy-lis-ova-t 	 vylis-ova-t
vyluhovat 	 vy-luh-ova-t 	 vyluh-ova-t
vymezovat 	 vy-mez-ova-t 	 vy-mez-ovat
vymyšlené 	 vy-myšl-e-n-é 	 vy-myšlen-é
vymáčkl 	 vy-máčk-l 	 vymáčk-l
vyměřovacímu 	 vy-měř-ova-c-ímu 	 vy-měř-ovac-ímu
vynaložením 	 vy-na-lož-en-í-m 	 vyna-ložen-ím
vynaloží 	 vy-na-lož-í 	 vyna-lož-í
vynalézání 	 vy-na-léz-á-n-í 	 vy-na-léz-án-í
vyndal 	 vy-nd-a-l 	 vynd-a-l
vynesla 	 vy-nes-l-a 	 vy-nesl-a
vynášejí 	 vy-náš-ej-í 	 vynáš-ej-í
vypancéřovat 	 vy-pancéř-ova-t 	 vy-pancéřovat
vypeckovat 	 vy-pec-k-ova-t 	 vypeck-ova-t
vypejkání 	 vy-pejk-á-n-í 	 vy-pejk-án-í
vyplaněný 	 vy-plan-ě-n-ý 	 vy-plan-ěn-ý
vyplul 	 vy-plu-l 	 vyplu-l
vyplísnit 	 vy-plísn-i-t 	 vy-plís-n-i-t
vypojovat 	 vy-poj-ova-t 	 vypoj-ova-t
vypočísti 	 vy-po-číst-i 	 vy-po-čísti
vypočítávat 	 vy-po-čít-á-v-a-t 	 vy-po-čít-á-v-at
vyprovokovat 	 vy-pro-vok-ova-t 	 vy-provokovat
vypárovací 	 vy-pár-ova-c-í 	 vypár-ovac-í
vypátrat 	 vy-pátr-a-t 	 vy-pátra-t
vypůjčil 	 vy-půjč-i-l 	 vy-půjči-l
vyrobila 	 vy-rob-i-l-a 	 vy-rob-il-a
vyrýžovat 	 vy-rýž-ova-t 	 vy-rýž-ovat
vysazovat 	 vy-saz-ova-t 	 vy-saz-ovat
vyslovený 	 vy-slov-en-ý 	 vy-sloven-ý
vyslyšeti 	 vy-slyš-e-ti 	 vy-slyše-ti
vysokoškolské 	 vys-ok-o-škol-sk-é 	 vysok-oškolsk-é
vysokoškolský 	 vys-ok-o-škol-sk-ý 	 vysok-oškolsk-ý
vysoká 	 vys-ok-á 	 vysok-á
vysokém 	 vys-ok-ém 	 vysok-ém
vyspinkat 	 vy-sp-ink-a-t 	 vy-spink-a-t
vyspravit 	 vy-s-prav-i-t 	 vysprav-i-t
vyspělým 	 vy-spě-l-ým 	 vy-spěl-ým
vystavil 	 vy-stav-i-l 	 vy-stavi-l
vystavila 	 vy-stav-i-l-a 	 vy-stavi-l-a
vystoupením 	 vy-stoup-en-ím 	 vy-stoupen-ím
vysvětlení 	 vy-svět-l-en-í 	 vy-světlen-í
vysvětloval 	 vy-svět-l-ova-l 	 vy-světl-oval
vysílací 	 vy-síl-a-c-í 	 vy-síl-ac-í
vytištěny 	 vy-tišt-ěn-y 	 vy-tišt-ěny
vytlouci 	 vy-tlouc-i 	 vytlouc-i
vytvořeno 	 vy-tvoř-en-o 	 vy-tvořen-o
vytít 	 vy-t-í-t 	 vytí-t
vytýkáno 	 vy-týk-á-n-o 	 vy-týk-án-o
vyvozovat 	 vy-voz-ova-t 	 vy-voz-ovat
vyvážecí 	 vy-váž-e-c-í 	 vy-váž-ec-í
vyzpytovat 	 vy-z-pyt-ova-t 	 vyzpyt-ova-t
vyzvracet 	 vy-z-vrac-e-t 	 vy-zvrac-et
vyčpět 	 vy-čp-ě-t 	 vyčp-ě-t
vyčísti 	 vy-číst-i 	 vy-čísti
vyřinout 	 vy-řin-ou-t 	 vyři-nou-t
vyšetřilo 	 vy-šetř-i-l-o 	 vy-šetři-l-o
vyšpehovat 	 vy-špeh-ova-t 	 vy-špeh-ovat
vyžadonit 	 vy-žad-on-i-t 	 vy-žadon-i-t
vyžehnout 	 vy-žeh-nou-t 	 vy-žeh-nout
vzdorovat 	 vz-dor-ova-t 	 vzdor-ova-t
vzdálený 	 vz-dál-en-ý 	 vzdálen-ý
vzdělání 	 vz-děl-án-í 	 vzděl-á-n-í
vzhlížet 	 vz-hlíž-e-t 	 vzhlíž-e-t
vzlínat 	 vz-lín-a-t 	 vzlín-at
vzlítnout 	 vz-lít-nou-t 	 vzlít-nou-t
vznikají 	 vz-nik-aj-í 	 vznik-aj-í
vznikla 	 vz-nik-l-a 	 vznikl-a
vzniku 	 vz-nik-u 	 vznik-u
vzniká 	 vz-nik-á 	 vznik-á
vztahů 	 vz-tah-ů 	 vztah-ů
vztekle 	 vz-tek-l-e 	 vztekle
vzteknout 	 vz-tek-nou-t 	 vztek-nou-t
vzteku 	 vz-tek-u 	 vztek-u
vzájemná 	 v-zá-jem-n-á 	 vzájemn-á
vzít 	 vz-í-t 	 vzí-t
vás 	 v-á-s 	 vás
víte 	 v-í-te 	 víte
vítkovice 	 vít-k-ov-ic-e 	 vít-k-ovice
vítkovického 	 vítk-ovic-k-ého 	 vít-kovick-ého
vítkovickém 	 vítk-ovic-k-ém 	 vít-kovick-ém
vítěze 	 vítěz-e 	 vítěze
vítězství 	 vítěz-ství 	 vítězstv-í
vítězům 	 vítěz-ům 	 vítězům
výdělek 	 vý-děl-ek 	 výdělek
výdělečných 	 vý-děl-eč-n-ých 	 vý-děleč-n-ých
výherci 	 vý-her-c-i 	 vý-herc-i
výhled 	 vý-hled 	 výhled
výhodou 	 vý-hod-ou 	 výhod-ou
výklad 	 vý-klad 	 výklad
výluka 	 vý-luk-a 	 výluk-a
výpotek 	 vý-pot-ek 	 výpotek
výsostným 	 výs-ost-n-ý-m 	 vý-sost-n-ým
výstavbě 	 vý-stav-b-ě 	 vý-stavb-ě
výuce 	 vý-uc-e 	 výuce
vývoj 	 vý-voj 	 vývoj
významu 	 vý-znam-u 	 vý-znamu
výčitek 	 vý-čit-e-k 	 výčitek
větrovka 	 větr-ovk-a 	 větrovk-a
větrů 	 větr-ů 	 větrů
všeho 	 vš-eho 	 všeho
všeobecně 	 vš-e-obec-n-ě 	 všeobec-n-ě
vševědova 	 vševěd-ov-a 	 vševěd-ova
vštípit 	 v-štíp-i-t 	 vštíp-i-t
vštěpuji 	 v-štěp-uj-i 	 vštěp-uji
vůnička 	 vůn-ič-k-a 	 vůn-ičk-a
westermannem 	 westermann-e-m 	 westermannem
whitney 	 whitney 	 whit-ney
yse 	 y-s-e 	 yse
zabedňovat 	 za-bedň-ova-t 	 za-bed-ň-ova-t
zabijeme 	 za-bi-je-me 	 zabijeme
zachmuřen 	 za-chmuř-en 	 zachmuřen
zachovávat 	 za-chov-á-v-a-t 	 za-chová-v-a-t
zachrániti 	 za-chrán-i-ti 	 za-chrán-iti
zachvěla 	 za-chvě-l-a 	 za-chvěl-a
zacloumat 	 za-cloum-a-t 	 za-cloum-at
zadek 	 zad-ek 	 zadek
zadrhl 	 za-drh-l 	 zadrh-l
zadrhnout 	 za-drh-nou-t 	 za-drh-nout
zafilosofovat 	 za-filo-sof-ova-t 	 za-fil-osof-ovat
zahanbit 	 za-han-b-i-t 	 za-hanb-i-t
zahozených 	 za-hoz-en-ý-ch 	 za-hoz-en-ých
zahradník 	 za-hrad-n-ík 	 za-hrad-ník
zahraničním 	 za-hran-ič-n-ím 	 za-hranič-n-ím
zahrnutí 	 za-hr-nu-t-í 	 za-hrnut-í
zahynul 	 za-hyn-u-l 	 za-hynul
zahájila 	 za-háj-i-l-a 	 za-háj-il-a
zahřměl 	 za-hřm-ě-l 	 za-hřmě-l
zainteresované 	 za-interes-ova-n-é 	 zaint-er-es-ova-n-é
zajatec 	 za-j-at-ec 	 zajatec
zajištěno 	 za-jišt-ěn-o 	 za-jišt-ěno
zaklenout 	 za-kle-nou-t 	 za-kle-nout
zakonzervování 	 za-konzerv-ová-n-í 	 za-konzerv-ován-í
zakopaný 	 za-kop-a-n-ý 	 za-kop-an-ý
zakopán 	 za-kop-á-n 	 za-kopán
zakusitelno 	 za-kus-i-tel-n-o 	 za-kus-i-telno
zakvílet 	 za-kvíl-e-t 	 za-kvíl-et
zakysávat 	 za-kys-á-v-a-t 	 za-kys-á-v-at
zakývat 	 za-kýv-a-t 	 za-ký-v-a-t
zalepilo 	 za-lep-i-l-o 	 za-lep-il-o
zalil 	 za-li-l 	 zali-l
zamkl 	 za-mk-l 	 zamk-l
zamotávat 	 za-mot-á-v-a-t 	 za-mot-á-v-at
zamyslel 	 za-mysl-e-l 	 za-myslel
zamyšlená 	 za-myšl-e-n-á 	 za-myšlen-á
zamyšlený 	 za-myšl-e-n-ý 	 za-myšlen-ý
zamyšleně 	 za-myšl-e-n-ě 	 za-myšl-en-ě
zaměstnancům 	 za-měst-n-an-c-ům 	 za-městnancům
zaměstnání 	 za-měst-n-á-n-í 	 za-městn-án-í
zanadávat 	 za-na-d-á-v-a-t 	 za-nad-á-v-a-t
zandat 	 za-nd-a-t 	 zand-a-t
zanedbávat 	 za-ne-db-á-v-a-t 	 za-nedb-á-v-a-t
zanést 	 za-nés-t 	 za-nést
zanýtovat 	 za-nýt-ova-t 	 za-nýt-ovat
zaplítatelnost 	 za-plít-a-teln-ost 	 za-plít-a-telnost
zapomnění 	 za-po-mn-ě-n-í 	 za-pomněn-í
zapomínat 	 za-pomín-a-t 	 za-pomín-at
započísti 	 za-po-číst-i 	 za-po-čísti
zapošít 	 za-po-ší-t 	 za-poší-t
zaprodávat 	 za-pro-d-á-v-a-t 	 za-prod-á-v-a-t
zapsal 	 za-ps-a-l 	 zaps-a-l
zapříčiněné 	 za-pří-čin-ěn-é 	 za-příčiněn-é
zardousil 	 za-rdous-i-l 	 za-rdous-il
zareagovat 	 za-re-ag-ova-t 	 za-reag-ova-t
zaregistrovat 	 za-registr-ova-t 	 zaregistr-ova-t
zarámovány 	 za-rám-ová-n-y 	 za-rám-ován-y
zasahují 	 za-sah-u-j-í 	 za-sah-uj-í
zasklít 	 za-skl-í-t 	 za-sklít
zasklívaně 	 za-skl-í-v-a-n-ě 	 za-skl-ív-a-n-ě
zaslíbeni 	 za-s-líb-en-i 	 zaslíbeni
zasmyčkování 	 za-smyč-k-ová-n-í 	 za-smyčk-ová-ní
zasršela 	 za-srš-e-l-a 	 za-srš-el-a
zastřelili 	 za-střel-i-l-i 	 za-střel-ili
zastřelovat 	 za-střel-ova-t 	 za-střel-ovat
zatelegrafovat 	 za-tele-graf-ova-t 	 za-telegrafovat
zatkneme 	 za-tk-ne-me 	 zatk-neme
zatrubňovávatelnost 	 za-trub-ň-ová-v-a-teln-ost 	 za-trubň-ová-v-a-telnost
zatvrzují 	 za-tvrz-u-j-í 	 za-tvrz-uj-í
zatáčka 	 za-táč-k-a 	 za-táčk-a
zatčený 	 za-tč-en-ý 	 za-tčen-ý
zaujatý 	 z-au-j-a-t-ý 	 zaujat-ý
zaujmouti 	 zau-jm-ou-ti 	 zauj-mouti
zavolám 	 za-vol-á-m 	 za-vol-ám
zavtipkovat 	 za-vtip-k-ova-t 	 za-vtipk-ovat
zavzdychnout 	 za-vz-dych-nou-t 	 za-vzdych-nout
zavést 	 za-vés-t 	 za-vést
zavřeny 	 za-vř-e-n-y 	 za-vřen-y
zazimovat 	 za-zim-ova-t 	 za-zim-ovat
zazátkovat 	 za-zá-tk-ova-t 	 za-zát-k-ova-t
začne 	 za-č-ne 	 začne
začpít 	 za-čp-í-t 	 začp-í-t
zašustět 	 za-šust-ě-t 	 za-šust-ět
zaťal 	 za-ť-a-l 	 zaťa-l
zblízka 	 z-blíz-k-a 	 zblízk-a
zbytečné 	 z-by-t-eč-n-é 	 zbyteč-n-é
zchlapčilý 	 z-chlap-č-i-l-ý 	 z-chlapčil-ý
zdaleka 	 z-dal-ek-a 	 zdalek-a
zdanitelná 	 z-dan-i-teln-á 	 zdan-i-teln-á
zdechat 	 z-dech-a-t 	 zdech-a-t
zdeformovat 	 z-de-form-ova-t 	 zdeform-ovat
zdegenerovat 	 z-de-gener-ova-t 	 zdegener-ovat
zdeničky 	 zden-ič-k-y 	 zden-ičk-y
zdeněk 	 zdeněk 	 zden-ěk
zdi 	 zd-i 	 zdi
zdobit 	 z-dob-i-t 	 zdob-i-t
zdokonalit 	 z-do-kon-a-l-i-t 	 z-do-kon-al-i-t
zdražovat 	 z-draž-ova-t 	 zdraž-ova-t
zdrchat 	 z-drch-a-t 	 zdrch-a-t
zdrhnout 	 z-drh-nou-t 	 zdrh-nou-t
zdrsnět 	 z-drs-n-ě-t 	 zdrs-n-ět
zdržoval 	 z-drž-ova-l 	 zdrž-ova-l
zdít 	 zd-í-t 	 zdí-t
zemím 	 zem-ím 	 zem-í-m
zemědělské 	 zem-ě-děl-sk-é 	 zeměděl-sk-é
zemědělských 	 zem-ě-děl-sk-ých 	 zeměd-ělsk-ých
zemřeli 	 ze-mř-e-l-i 	 ze-mř-e-li
zeptá 	 ze-pt-á 	 zept-á
zespolečenšťovat 	 ze-spol-eč-en-šť-ova-t 	 ze-společ-enšťovat
zesvětštět 	 ze-svět-št-ě-t 	 ze-s-vět-ště-t
zfalšování 	 z-falš-ová-n-í 	 zfalš-ová-n-í
zhanit 	 z-han-i-t 	 zhan-i-t
zhasl 	 z-has-l 	 z-hasl
zheroizovavší 	 z-hero-izova-vš-í 	 z-hero-izovavší
zhospodárnit 	 z-hospod-ár-n-i-t 	 z-hospodárnit
zhypnotizovat 	 z-hypn-ot-iz-ova-t 	 z-hypn-ot-izovat
zinventovat 	 z-invent-ova-t 	 zinvent-ovat
zjednat 	 z-jedn-a-t 	 z-jedn-at
zjednodušení 	 z-jedn-o-duš-en-í 	 z-jedn-odušení
zjednodušilo 	 z-jedn-o-duš-i-l-o 	 z-jedn-odušilo
zjízlivět 	 z-jíz-l-iv-ě-t 	 z-jízl-ivě-t
zkalit 	 z-kal-i-t 	 zkal-i-t
zkamenět 	 z-kamen-ě-t 	 zkamen-ě-t
zkombinovat 	 z-kombin-ova-t 	 zkombin-ovat
zkrácena 	 z-krác-en-a 	 zkrác-en-a
zkrácené 	 z-krác-en-é 	 zkrác-en-é
zkrásnět 	 z-krás-n-ě-t 	 z-krás-nět
zkypřovat 	 z-kypř-ova-t 	 z-kypř-ovat
zlatovlasé 	 zlat-o-vlas-é 	 zlat-ovlas-é
zloděj 	 zl-o-děj 	 zloděj
zlodějsku 	 zl-o-děj-sk-u 	 zloděj-sk-u
zločinem 	 zl-o-čin-e-m 	 zločin-em
zlákat 	 z-lák-a-t 	 zlák-a-t
zlézt 	 z-léz-t 	 zléz-t
zlí 	 zl-í 	 zlí
zmateného 	 z-mat-en-ého 	 zmat-en-ého
zmizely 	 z-miz-e-l-y 	 z-miz-el-y
zmiňuji 	 z-miň-uj-i 	 z-miň-uji
zmoralizování 	 z-moral-iz-ová-n-í 	 z-moral-iz-ován-í
zmramorovatěnost 	 z-mramor-ovat-ě-n-ost 	 z-mramor-ovatěnost
zmultiplicírovaný 	 z-multi-plic-ír-ova-n-ý 	 z-multi-p-licírovaný
zmátl 	 z-mát-l 	 zmát-l
zmírňovat 	 z-mír-ň-ova-t 	 z-mír-ň-ovat
zmýdelnět 	 z-mýdel-n-ě-t 	 z-mýdel-n-ět
změněném 	 z-měn-ěn-é-m 	 z-měn-ěn-ém
znalec 	 zn-a-l-ec 	 znalec
znali 	 zn-a-l-i 	 zna-l-i
znalých 	 zn-a-l-ých 	 zna-lých
znamenaly 	 znam-en-a-l-y 	 znamen-a-l-y
znesnadňovat 	 z-ne-snad-ň-ova-t 	 z-nesnad-ň-ovat
znesvětit 	 z-ne-svět-i-t 	 z-nesvět-i-t
zneužití 	 z-ne-u-ži-t-í 	 zneužit-í
znešvařena 	 z-ne-švař-en-a 	 z-nešvařen-a
znešvařovat 	 z-ne-švař-ova-t 	 z-nešvař-ovat
znovu 	 z-nov-u 	 znov-u
znovuoživenost 	 z-nov-u-o-živ-en-ost 	 z-novu-o-živ-enost
znásilňovat 	 z-ná-sil-ň-ova-t 	 znásil-ň-ovat
znásobit 	 z-násob-i-t 	 zná-sob-i-t
znáte 	 zn-á-te 	 zná-te
zněkolikanásobit 	 z-ně-kolik-a-násob-i-t 	 zně-kolik-a-násob-it
znět 	 zn-ě-t 	 zně-t
zobecnět 	 z-obec-n-ě-t 	 zobec-ně-t
zorat 	 z-or-a-t 	 zorat
zorganizovaný 	 z-organ-iz-ova-n-ý 	 z-organ-iz-ovan-ý
zosobnit 	 z-osob-n-i-t 	 zosob-n-i-t
zostoudit 	 z-o-stoud-i-t 	 zostoud-i-t
zouvat 	 zou-v-a-t 	 zouv-a-t
zpatlat 	 z-patl-a-t 	 zpatl-at
zpevnět 	 z-pevn-ě-t 	 zpev-n-ět
zplnomocňovat 	 z-pln-o-moc-ň-ova-t 	 z-plno-mocň-ova-t
zpocený 	 z-poc-en-ý 	 zpocen-ý
zpohlavkovat 	 z-po-hlav-k-ova-t 	 zpo-hlavk-ovat
zprostředkovatelské 	 z-pro-střed-k-ova-tel-sk-é 	 z-pro-střed-k-ova-t-elské
zprostředkuje 	 z-pro-střed-k-uje 	 z-prostředk-uje
zprůmyslnělost 	 z-prů-mysl-n-ě-l-ost 	 z-prům-yslnělost
zpuchlý 	 z-puch-l-ý 	 zpuch-l-ý
zpustošit 	 z-pust-oš-i-t 	 zpustoš-i-t
zpívá 	 z-pí-v-á 	 zpív-á
zpět 	 zpět 	 zpě-t
zpěvačka 	 z-pě-v-a-č-k-a 	 zpěv-ačk-a
zpřevracovat 	 z-pře-vrac-ova-t 	 z-převrac-ovat
zpřísnět 	 z-přísn-ě-t 	 z-přís-n-ě-t
zrcadle 	 zrc-a-dl-e 	 zrcadle
zregenerovat 	 z-re-gener-ova-t 	 zregener-ovat
zrentgenovat 	 z-rentgen-ova-t 	 zrentgen-ova-t
ztenčovat 	 z-ten-č-ova-t 	 z-tenč-ova-t
ztotožnit 	 z-to-tož-n-i-t 	 ztotož-n-i-t
ztotožňovat 	 z-to-tož-ň-ova-t 	 z-totož-ň-ovat
ztratiti 	 z-trat-i-ti 	 z-trat-iti
ztroskotat 	 z-trosk-ot-a-t 	 z-troskota-t
ztéci 	 z-téc-i 	 ztéc-i
zutrhat 	 z-u-trh-a-t 	 zutrh-a-t
zveřejněné 	 z-veřej-n-ě-n-é 	 zveřejn-ěn-é
zveřejnění 	 z-veřej-n-ě-n-í 	 zveřejn-ěn-í
zviklat 	 z-vikl-a-t 	 zviklat
zvládnou 	 z-vlád-n-ou 	 zvlád-n-ou
zvláčet 	 z-vláč-e-t 	 zvláč-e-t
zvláště 	 zvláště 	 zvlášt-ě
zvolal 	 z-vol-a-l 	 zvol-a-l
zvolena 	 z-vol-en-a 	 zvolen-a
zvoleny 	 z-vol-en-y 	 zvolen-y
zvolnit 	 z-vol-n-i-t 	 zvol-n-i-t
zvroucnit 	 z-vr-ou-c-n-i-t 	 zvrouc-n-i-t
zvrtnout 	 z-vrt-nou-t 	 zvrt-nou-t
zvyky 	 z-vyk-y 	 zvyk-y
zválcovat 	 z-válc-ova-t 	 zválc-ova-t
zvídavější 	 z-víd-a-v-ějš-í 	 zvíd-a-v-ějš-í
zvýhodnění 	 z-vý-hod-n-ěn-í 	 zvýhodněn-í
zvýhodňovat 	 z-vý-hod-ň-ova-t 	 z-výhod-ň-ovat
zvěčnit 	 z-věč-n-i-t 	 zvěč-n-it
zádech 	 zád-e-ch 	 zádech
zájemci 	 zá-jem-c-i 	 zá-jemc-i
základem 	 zá-klad-e-m 	 zá-klad-em
zákoníku 	 zá-kon-ík-u 	 zákon-ík-u
zármutku 	 zá-rmut-k-u 	 zá-rmutk-u
zástupce 	 zá-stup-c-e 	 zá-stupc-e
zástupci 	 zá-stup-c-i 	 zá-stupc-i
zástěrce 	 zá-stěr-c-e 	 zá-stěrc-e
zástěrka 	 zá-stěr-k-a 	 zástěrk-a
zátočiny 	 zá-toč-in-y 	 zátoč-in-y
závad 	 zá-vad 	 závad
závod 	 zá-vod 	 závod
závojnatkách 	 zá-voj-n-at-k-á-ch 	 zá-voj-natk-ách
zúžit 	 z-úž-i-t 	 zúž-i-t
zčásti 	 z-část-i 	 zčásti
zřasovat 	 z-řas-ova-t 	 zřas-ova-t
zřetelně 	 zř-e-teln-ě 	 zře-telně
zůstal 	 z-ů-sta-l 	 zůsta-l
zůstalo 	 zů-sta-l-o 	 zůsta-l-o
zůstanou 	 z-ů-sta-n-ou 	 zůsta-n-ou
úchvatná 	 ú-chvat-n-á 	 úchvat-n-á
úcta 	 ú-ct-a 	 úct-a
újezdě 	 ú-jezd-ě 	 újezd-ě
újmě 	 ú-jm-ě 	 újm-ě
úplný 	 ú-pln-ý 	 úpln-ý
úpravě 	 ú-prav-ě 	 úprav-ě
ústit 	 úst-i-t 	 ústi-t
útulný 	 ú-tul-n-ý 	 útul-n-ý
úvěrování 	 ú-věr-ová-n-í 	 úvěr-ová-n-í
úvěru 	 ú-věr-u 	 úvěr-u
úzká 	 úz-k-á 	 úzk-á
účasten 	 ú-čast-en 	 účasten
účelu 	 ú-čel-u 	 účel-u
účetních 	 ú-čet-n-ích 	 účet-n-ích
účinky 	 ú-čin-k-y 	 účin-k-y
účinnosti 	 ú-čin-n-ost-i 	 účin-n-osti
účinností 	 ú-čin-n-ost-í 	 účin-n-ost-í
účtu 	 ú-čt-u 	 účt-u
účty 	 ú-čt-y 	 účt-y
úžasem 	 ú-žas-e-m 	 ú-žas-em
čepice 	 čep-ic-e 	 čepice
čepici 	 čep-ic-i 	 čepic-i
černosrstý 	 čern-o-srst-ý 	 čern-osrst-ý
černým 	 čern-ý-m 	 čer-n-ým
černýšovice 	 čern-ýš-ov-ic-e 	 černýšovice
čerstvého 	 čerstv-ého 	 čerstvého
čerti 	 čert-i 	 čerti
českomalínský 	 česk-o-malín-sk-ý 	 čes-k-omalínsk-ý
českou 	 čes-k-ou 	 česk-ou
českého 	 čes-k-é-ho 	 česk-ého
českém 	 čes-k-ém 	 česk-ém
českým 	 čes-k-ým 	 česk-ým
češtiny 	 češ-t-in-y 	 češt-in-y
činorodé 	 čin-o-rod-é 	 činorod-é
čintamani 	 čintaman-i 	 čintamani
čistokrevnou 	 čist-o-krev-n-ou 	 čistokrevnou
článkem 	 člán-k-e-m 	 člán-k-em
čokoládou 	 čokolád-ou 	 čokoládou
čsfr 	 č-s-f-r 	 čsfr
čsn 	 č-s-n 	 čsn
čssr 	 č-s-s-r 	 čssr
čtvrtletně 	 čtvrt-let-n-ě 	 čtvrtlet-n-ě
čtvrtletí 	 čtvrt-let-í 	 čtvrtlet-í
čtěte 	 čt-ě-te 	 čtěte
čubička 	 čub-ič-k-a 	 čub-ičk-a
čubičku 	 čub-ič-k-u 	 čub-ičk-u
čuchnul 	 čuch-nu-l 	 čuch-nul
čvaňhat 	 čvaňh-a-t 	 čvaňhat
čzpi 	 č-z-p-i 	 čzp-i
částice 	 část-ic-e 	 část-ice
částka 	 část-k-a 	 částk-a
částku 	 část-k-u 	 částk-u
čímkoliv 	 č-í-m-koliv 	 čímkoliv
řepkového 	 řep-k-ov-ého 	 řep-k-ového
řezání 	 řez-á-n-í 	 řezá-n-í
říjet 	 říj-e-t 	 říje-t
řízen 	 říz-en 	 řízen
šel 	 še-l 	 šel
šem 	 š-em 	 šem
šeptnout 	 šept-nou-t 	 šept-nout
šestigólový 	 šest-i-gól-ov-ý 	 šestigólový
šifrovaných 	 šifr-ova-n-ý-ch 	 šifr-ova-n-ých
šimůnek 	 šimůn-ek 	 šimůnek
šitinův 	 šitin-ův 	 šitinův
školák 	 škol-ák 	 školák
škudlit 	 škud-l-i-t 	 škudl-i-t
škvrně 	 škvr-n-ě 	 škvrn-ě
šmejkal 	 šmejkal 	 šmejk-al
šohajky 	 šohaj-k-y 	 šohajk-y
špicovat 	 špic-ova-t 	 špic-ovat
špionáže 	 špion-áž-e 	 špionáže
špičatit 	 špič-at-i-t 	 špičat-i-t
šplouná 	 šplou-n-á 	 šploun-á
štít 	 štít 	 ští-t
šíblová 	 šíbl-ová 	 šíbl-ov-á
šťastná 	 šťast-n-á 	 šťastn-á
ťápnout 	 ťáp-nou-t 	 ťáp-nout
žehravost 	 žehr-a-v-ost 	 žehrav-ost
žejbrovat 	 žejbr-ova-t 	 žejbr-ovat
železná 	 želez-n-á 	 železn-á
železárnách 	 želez-árn-ách 	 železárn-ách
ženatý 	 žen-at-ý 	 ženat-ý
žernově 	 žernov-ě 	 žer-n-ově
žhavět 	 žh-av-ě-t 	 žhav-ě-t
živ 	 ži-v 	 živ
živelná 	 ži-v-el-n-á 	 živeln-á
živnostenského 	 ži-v-n-ost-ensk-ého 	 živ-nosten-ského
životními 	 ži-v-ot-n-í-m-i 	 živ-ot-n-ími
životě 	 ži-v-ot-ě 	 živ-ot-ě
žižkovák 	 žižkov-ák 	 žižk-ovák
žlábkovávající 	 žláb-k-ová-v-aj-íc-í 	 žláb-k-ová-v-aj-ící
župka 	 žup-k-a 	 župk-a
žádostmi 	 žád-ost-mi 	 žád-ostmi
žádoucí 	 žád-ou-c-í 	 žád-ouc-í
