absolventi 	 ab-solv-ent-i 	 absolvent-i
adami 	 adami 	 ad-ami
adaptabilní 	 adapt-abil-n-í 	 adapt-ab-il-n-í
adresátů 	 adres-át-ů 	 adresát-ů
agovávat 	 agov-á-v-a-t 	 agová-v-a-t
aktuálního 	 akt-uál-n-ího 	 akt-u-ál-n-ího
amerikanismem 	 amerik-an-ism-e-m 	 amerik-an-ism-em
amerikánská 	 amerik-án-sk-á 	 amerikán-sk-á
anatólii 	 anatól-i-i 	 ana-tóli-i
anthony 	 anthony 	 anthon-y
arcilotras 	 arci-lotr-as 	 arci-lotras
atamanem 	 ataman-e-m 	 ataman-em
automobilka 	 automobil-k-a 	 auto-mobil-k-a
avšak 	 a-však 	 avšak
babičku 	 bab-ič-k-u 	 bab-ičk-u
balený 	 bal-en-ý 	 balen-ý
balených 	 bal-en-ých 	 balen-ých
bania 	 bani-a 	 bania
bankovním 	 bank-ovn-ím 	 bank-ov-n-í-m
bekem 	 bekem 	 bek-em
benzylchorid 	 benz-yl-chor-id 	 benzyl-chorid
bezesných 	 beze-sn-ých 	 bezes-n-ých
bionaftu 	 bio-naft-u 	 bionaft-u
bionafty 	 bio-naft-y 	 bionaft-y
bláznivého 	 blázn-iv-ého 	 blázn-i-v-ého
bodiny 	 bod-in-y 	 bodin-y
bolení 	 bol-e-n-í 	 bol-en-í
božínku 	 bož-ín-k-u 	 božín-k-u
brožura 	 brožur-a 	 brožura
budoucnosti 	 bud-ou-c-n-ost-i 	 bud-ouc-n-ost-i
budoucím 	 bud-ouc-ím 	 budouc-í-m
budova 	 bud-ova 	 bud-ov-a
bulletinu 	 bulletin-u 	 bullet-in-u
bych 	 by-ch 	 bych
bytu 	 by-t-u 	 byt-u
bázlivá 	 bá-z-l-iv-á 	 báz-l-iv-á
běžně 	 běž-ně 	 běž-n-ě
celkovou 	 cel-k-ov-ou 	 celk-ov-ou
celková 	 cel-k-ov-á 	 celk-ov-á
celkové 	 cel-k-ov-é 	 celk-ov-é
celoživotní 	 cel-o-ži-v-ot-n-í 	 celo-ži-v-ot-n-í
cenovky 	 cen-ovk-y 	 cenov-k-y
cestující 	 cest-uj-í-c-í 	 cest-uj-íc-í
chcete 	 chc-e-te 	 chcete
chutnání 	 chut-n-á-n-í 	 chutn-á-n-í
chvílích 	 chvíl-í-ch 	 chvíl-ích
cigarety 	 cigar-et-y 	 cigaret-y
cizince 	 ciz-in-c-e 	 ciz-inc-e
courama 	 cour-ama 	 cour-am-a
ctihodnými 	 ct-i-hod-n-ý-m-i 	 ct-i-hod-n-ými
cácorka 	 các-or-k-a 	 cácor-k-a
cílem 	 cíl-e-m 	 cíl-em
daktyloskopie 	 daktylo-skopi-e 	 daktylo-skop-i-e
dali 	 d-a-l-i 	 da-l-i
daly 	 d-a-l-y 	 da-l-y
dané 	 d-a-n-é 	 dan-é
delikátnostem 	 delikát-n-ost-e-m 	 delikát-n-ost-em
demoralizovat 	 de-moral-iz-ova-t 	 demoral-iz-ova-t
devizové 	 deviz-ov-é 	 de-viz-ov-é
dezinfikovat 	 dez-infik-ova-t 	 dez-in-fik-ova-t
diavolo 	 diavolo 	 diavol-o
disciplíny 	 disciplín-y 	 dis-ciplín-y
distanční 	 dis-tanč-n-í 	 dist-a-nč-n-í
dlouhodobého 	 dlouh-o-dob-ého 	 dlouh-o-do-b-ého
dobrodiní 	 dobr-o-di-n-í 	 dob-rod-in-í
dobytí 	 do-by-tí 	 do-by-t-í
docentů 	 docent-ů 	 do-cent-ů
dokonalého 	 do-kon-a-l-é-ho 	 do-kon-a-l-ého
dozvíte 	 do-z-v-í-te 	 do-zv-í-te
drožkář 	 drožk-ář 	 drož-k-ář
druhém 	 druh-é-m 	 druh-ém
duchovně 	 duch-ov-n-ě 	 duch-ovn-ě
dveřích 	 dveř-í-ch 	 dveř-ích
dvojnásobek 	 dv-oj-ná-sob-ek 	 dvoj-ná-sob-ek
dvouměsíční 	 dv-ou-měsíč-n-í 	 dvo-u-měsíč-n-í
dvoustraně 	 dv-ou-stran-ě 	 dvoustran-ě
dávána 	 d-á-v-á-n-a 	 dá-v-á-n-a
dřevěný 	 dřev-ě-n-ý 	 dřev-ěn-ý
dřívějších 	 dřív-ějš-ích 	 dřív-ěj-š-ích
důkladněji 	 dů-klad-n-ěji 	 dů-klad-n-ěj-i
ekologické 	 eko-log-ick-é 	 eko-log-ic-k-é
ekologického 	 eko-log-ick-ého 	 eko-log-ic-k-ého
ekonomickou 	 eko-nom-ick-ou 	 eko-nom-ic-k-ou
empirických 	 empir-ic-k-ý-ch 	 empir-ic-k-ých
energie 	 energ-i-e 	 energie
epocha 	 epoch-a 	 e-poch-a
expansion 	 expansion 	 expans-ion
faktorů 	 fakt-or-ů 	 faktor-ů
fanoušků 	 fan-oušk-ů 	 fanouš-k-ů
farmaceutické 	 farmac-eut-ick-é 	 farmac-eut-ic-k-é
filozofické 	 filo-zof-ic-k-é 	 fil-o-zof-ic-k-é
finálním 	 fin-ál-n-ím 	 fin-ál-n-í-m
fluorově 	 fluor-ov-ě 	 fluor-ově
fondem 	 fondem 	 fond-em
fosforeskovat 	 fosfor-esk-ova-t 	 fosforesk-ova-t
francouzsky 	 franc-ouz-sk-y 	 francouzsk-y
francouzského 	 franc-ouz-sk-ého 	 francouz-sk-ého
fyzický 	 fyz-ic-k-ý 	 fyzic-k-ý
garance 	 garanc-e 	 garan-c-e
gastronomie 	 gastr-o-nom-i-e 	 gastro-nom-i-e
generál 	 gener-ál 	 generál
gestikulovat 	 gestik-ul-ova-t 	 gestikul-ova-t
graessnerii 	 graessnerii 	 graessneri-i
haló 	 haló 	 hal-ó
herní 	 her-n-í 	 hern-í
hladověli 	 hlad-ov-ě-l-i 	 hlad-ov-ěl-i
hmotného 	 hmot-n-é-ho 	 hmot-n-ého
hnedle 	 hned-le 	 hnedl-e
hnízdech 	 hnízd-e-ch 	 hnízd-ech
hochschule 	 hoch-schule 	 hochschule
hodnotím 	 hod-n-ot-í-m 	 hod-n-ot-ím
hodnotíte 	 hodn-ot-í-te 	 hod-n-ot-í-te
holandsku 	 holand-sk-u 	 holandsk-u
holiči 	 hol-i-č-i 	 hol-ič-i
holčičkou 	 hol-č-ič-k-ou 	 hol-č-ičk-ou
horálek 	 horálek 	 horál-ek
hra 	 hr-a 	 hra
hromková 	 hrom-k-ov-á 	 hromk-ov-á
hroznou 	 hrozn-ou 	 hroz-n-ou
hry 	 hr-y 	 hry
hudebníci 	 hud-eb-níc-i 	 hud-eb-n-íc-i
humbuk 	 humbuk 	 hum-buk
husími 	 hus-í-m-i 	 hus-ími
hvězdičky 	 hvězd-ič-k-y 	 hvězd-ičk-y
imigraci 	 i-migr-ac-i 	 imigr-ac-i
inaugurován 	 inaugur-ová-n 	 ina-ugur-ová-n
indikátorem 	 in-dik-át-or-em 	 indik-át-or-em
individuální 	 in-divid-u-ál-n-í 	 in-dividu-ál-n-í
inherovat 	 inher-ova-t 	 i-nher-ova-t
inovace 	 inov-ace 	 inov-ac-e
instrumentů 	 instru-ment-ů 	 instrument-ů
intuice 	 intuic-e 	 intui-c-e
invalidní 	 in-valid-n-í 	 invalid-n-í
inzerátech 	 inzer-át-e-ch 	 inzer-át-ech
ivančic 	 ivan-č-ic 	 ivančic
jablíčko 	 jablíč-k-o 	 jabl-íčk-o
jakoby 	 jak-o-by 	 jak-ob-y
jakého 	 jak-é-ho 	 jak-ého
jednak 	 jednak 	 jed-nak
jednatelem 	 jedn-a-tel-e-m 	 jedn-a-tel-em
jednomotorových 	 jedn-o-motor-ov-ých 	 jedn-o-m-otor-ov-ých
jednotlivina 	 jedn-ot-liv-in-a 	 jedn-ot-l-iv-in-a
jednotlivými 	 jedn-ot-liv-ými 	 jedn-ot-l-iv-ými
jedním 	 jedn-í-m 	 jedn-ím
jejích 	 je-j-í-ch 	 jej-ích
jimž 	 j-i-m-ž 	 j-im-ž
jindy 	 jin-d-y 	 jind-y
jmenují 	 jmen-u-j-í 	 jmen-uj-í
juránkův 	 jur-ánk-ův 	 jurán-k-ův
jídlo 	 jí-dl-o 	 jídl-o
kapacity 	 kapacit-y 	 kapa-cit-y
kapitální 	 kapitál-n-í 	 kapit-ál-n-í
kapli 	 kapl-i 	 kap-l-i
kardašovy 	 kardašov-y 	 kardaš-ov-y
kasernovat 	 kasern-ova-t 	 kaser-n-ova-t
kavalírem 	 kaval-ír-e-m 	 kaval-ír-em
každému 	 každ-é-mu 	 každ-ému
kdovíkdo 	 kd-o-v-í-kd-o 	 kdo-víkd-o
kdož 	 kdo-ž 	 kd-o-ž
klesly 	 kles-l-y 	 klesl-y
kliniky 	 klinik-y 	 klin-ik-y
klášterem 	 klášter-e-m 	 klášter-em
knížete 	 kníž-et-e 	 kníž-e-te
kocouří 	 koc-ouř-í 	 ko-couř-í
koho 	 k-o-ho 	 k-oho
kompetence 	 kompetenc-e 	 kompeten-c-e
kompetenci 	 kompet-enc-i 	 kompetenc-i
komu 	 k-o-mu 	 k-omu
konceptem 	 koncept-em 	 kon-cept-em
konkrétního 	 konkrét-n-ího 	 kon-krét-n-ího
konkrétnímu 	 kon-krét-n-í-mu 	 kon-krét-n-ímu
kontilití 	 konti-li-t-í 	 konti-lit-í
kontraindikace 	 kontra-in-dik-ac-e 	 kontraindik-ac-e
kontrolorů 	 kontrol-or-ů 	 kontrolor-ů
kontroloři 	 kontrol-oř-i 	 kontroloř-i
konviktem 	 kon-vikt-e-m 	 konvikt-em
kosmického 	 kosm-ic-k-é-ho 	 kosm-ick-ého
kostička 	 kost-ič-k-a 	 kost-ičk-a
koupací 	 koup-ac-í 	 koup-a-c-í
koňských 	 koň-sk-ý-ch 	 koň-sk-ých
krakově 	 krakov-ě 	 krak-ově
krumlesco 	 krumlesco 	 kruml-es-c-o
krumlova 	 krumlov-a 	 kruml-ov-a
krušanov 	 kruš-an-ov 	 kruš-anov
krádeže 	 krád-ež-e 	 krád-e-že
krásným 	 krás-n-ý-m 	 krás-n-ým
kterého 	 kter-é-ho 	 kter-ého
kunovice 	 kun-ovic-e 	 kunov-ic-e
kučeravět 	 kučer-av-ě-t 	 kučerav-ě-t
křivkami 	 křiv-k-a-m-i 	 křiv-k-ami
křídlem 	 kří-dl-e-m 	 křídl-em
lehkým 	 leh-k-ý-m 	 leh-k-ým
lesním 	 les-n-ím 	 les-n-í-m
letiště 	 let-išt-ě 	 let-i-št-ě
letošní 	 letoš-n-í 	 let-oš-n-í
lhostejnět 	 lhostej-n-ě-t 	 lh-o-stej-n-ě-t
lidem 	 lid-e-m 	 lid-em
lihem 	 lih-em 	 lihem
limit 	 limit 	 lim-i-t
loupežníkem 	 loup-ež-n-ík-e-m 	 loup-ež-n-ík-em
ložnicový 	 lož-nic-ov-ý 	 lož-n-ic-ov-ý
ltd 	 l-t-d 	 ltd
luděk 	 luděk 	 lud-ěk
lukách 	 luk-á-ch 	 luk-ách
lékařem 	 lék-ař-e-m 	 lék-ař-em
lékem 	 lék-e-m 	 lék-em
lékárnám 	 lék-ár-n-ám 	 lék-ár-n-á-m
maiden 	 maid-en 	 maiden
maličký 	 mal-ič-k-ý 	 mal-ičk-ý
malkovského 	 malkovsk-ého 	 malkov-sk-ého
mamlasovi 	 maml-as-ovi 	 mamlas-ovi
manager 	 manag-er 	 manager
manažerovi 	 manažer-ovi 	 manaž-er-ovi
manýrám 	 manýr-á-m 	 manýrám
mariánských 	 mari-án-sk-ých 	 marián-sk-ých
marrackův 	 marrack-ův 	 marrac-k-ův
materialisty 	 mater-i-al-ist-y 	 materi-al-ist-y
materiálové 	 materi-ál-ov-é 	 materiál-ov-é
materiálu 	 mater-i-ál-u 	 materi-ál-u
mepha 	 meph-a 	 mepha
metafyzických 	 meta-fyz-ic-k-ý-ch 	 meta-fyz-ic-k-ých
metodologicky 	 metodo-log-ic-k-y 	 metod-o-log-ick-y
mezitím 	 mezi-t-ím 	 mezit-ím
meziříčí 	 mezi-říč-í 	 meziříč-í
mečení 	 meč-e-n-í 	 meč-en-í
mikroorganismy 	 mikro-organ-ism-y 	 mikroorgan-ism-y
miliarda 	 miliard-a 	 mili-ard-a
milionů 	 mili-on-ů 	 milion-ů
milostpane 	 mil-ost-pan-e 	 mil-o-stpane
mimoškolními 	 mimo-škol-n-ími 	 mimoškol-n-ími
minerální 	 minerál-n-í 	 miner-ál-n-í
ministerstva 	 minister-stv-a 	 ministerstv-a
minulý 	 min-ul-ý 	 mi-nu-l-ý
mjasisčev 	 mjasisčev 	 mjas-isč-ev
mladého 	 mlad-é-ho 	 mlad-ého
mlýna 	 ml-ýn-a 	 mlýn-a
mnichově 	 mnichov-ě 	 mnich-ově
moderního 	 modern-í-ho 	 modern-ího
monopolu 	 mon-o-pol-u 	 monopol-u
motorlet 	 motor-let 	 motorl-e-t
motorletu 	 motor-let-u 	 motorlet-u
movis 	 movis 	 mo-vis
možnostech 	 možn-ost-ech 	 mož-n-ost-ech
mužského 	 muž-sk-é-ho 	 muž-sk-ého
mávne 	 máv-n-e 	 máv-ne
mésti 	 mést-i 	 més-ti
mých 	 m-ý-ch 	 m-ých
měli 	 mě-l-i 	 měl-i
měřítka 	 měř-í-tk-a 	 měřít-k-a
měřítku 	 měř-í-tk-u 	 měřít-k-u
nabitý 	 na-bi-t-ý 	 na-bit-ý
nadindividuálního 	 nad-in-divid-u-ál-n-í-ho 	 nad-in-divid-u-ál-n-ího
nadějemi 	 na-děj-e-m-i 	 na-děj-emi
nadřaděného 	 nad-řad-ěn-é-ho 	 nad-řad-ěn-ého
nadšení 	 na-dš-en-í 	 nad-š-en-í
nadšením 	 na-dš-en-í-m 	 nad-š-en-ím
najatí 	 na-j-a-t-í 	 na-j-at-í
namésti 	 na-mést-i 	 na-més-ti
nebrání 	 ne-brán-í 	 ne-br-á-n-í
nedávna 	 ne-dávn-a 	 ne-dáv-n-a
negativními 	 negat-iv-n-ími 	 neg-at-iv-n-ími
nejaktivnější 	 nej-akt-iv-n-ějš-í 	 ne-jakt-iv-n-ěj-š-í
nejcitlivějším 	 nej-cit-liv-ějš-ím 	 nej-cit-liv-ěj-š-ím
nejdivočejší 	 nej-div-oč-ej-š-í 	 nej-div-oč-ejš-í
nejkrásnějších 	 nej-krás-n-ěj-š-í-ch 	 nej-krás-n-ěj-š-ích
nejsladšího 	 nej-slad-š-í-ho 	 nej-slad-š-ího
nejvzdálenější 	 nej-vz-dál-e-n-ěj-š-í 	 nej-vz-dál-en-ějš-í
nejvzácnější 	 nej-vzácn-ějš-í 	 nej-vzác-n-ějš-í
nejzřetelněji 	 nej-zř-e-tel-n-ěji 	 nej-zř-e-teln-ěj-i
nejčastějších 	 nej-čast-ěj-š-í-ch 	 nej-čast-ěj-š-ích
nekompetentní 	 ne-kompet-ent-n-í 	 ne-kompetent-n-í
nekvete 	 ne-kvet-e 	 ne-kve-te
nelegální 	 ne-leg-ál-n-í 	 neleg-ál-n-í
nepotřebujete 	 ne-po-třeb-u-j-e-te 	 ne-po-třeb-uje-te
neprodejným 	 ne-pro-dej-n-ým 	 ne-pro-d-ej-n-ým
nepřesných 	 ne-přesn-ých 	 ne-přes-n-ých
nereálný 	 ne-reál-n-ý 	 nere-ál-n-ý
neumožňuje 	 ne-u-možň-uje 	 ne-u-mož-ň-uje
nezaměstnanosti 	 ne-za-měst-n-an-ost-i 	 ne-za-měst-n-a-n-ost-i
nezaoblená 	 ne-za-obl-en-á 	 ne-za-oblen-á
nezačínej 	 ne-za-č-ín-ej 	 ne-za-čín-ej
neznámého 	 ne-zn-á-m-é-ho 	 ne-zn-á-m-ého
neztratitelnost 	 ne-z-trat-i-tel-n-ost 	 ne-z-trat-i-teln-ost
nijetzscheovi 	 nijetzsche-ovi 	 nijetzscheovi
nitěných 	 nit-ěn-ý-ch 	 nit-ěn-ých
norem 	 norem 	 nor-em
nosem 	 nos-e-m 	 nos-em
nula 	 nul-a 	 nu-l-a
nuly 	 nul-y 	 nu-l-y
nykláku 	 nyklák-u 	 ny-klák-u
nábytek 	 ná-by-tek 	 ná-byt-ek
náramného 	 ná-ram-n-é-ho 	 ná-ram-n-ého
nás 	 n-á-s 	 nás
nějakém 	 ně-jak-é-m 	 ně-jak-ém
něm 	 n-ě-m 	 n-ěm
obal 	 o-bal 	 o-ba-l
obci 	 obc-i 	 ob-c-i
obcích 	 obc-ích 	 ob-c-ích
obepnout 	 obe-pn-ou-t 	 obe-p-nou-t
objektem 	 ob-jekt-e-m 	 ob-jekt-em
obor 	 o-bor 	 obor
obydlet 	 o-bydl-e-t 	 obydl-e-t
obzvlášť 	 ob-zvlášť 	 ob-z-vlášť
občanského 	 obč-an-sk-ého 	 občan-sk-ého
obživit 	 ob-živ-i-t 	 ob-ži-v-i-t
oceli 	 ocel-i 	 o-cel-i
ochotna 	 ochot-n-a 	 o-chot-n-a
odbelhávat 	 od-belh-á-v-a-t 	 od-be-lh-á-v-a-t
odbytové 	 od-by-t-ov-é 	 od-by-t-ové
odečte 	 ode-čt-e 	 od-eč-te
odečtení 	 ode-čt-en-í 	 od-ečt-en-í
odečtou 	 ode-čt-ou 	 od-ečt-ou
odmalička 	 od-mal-ičk-a 	 od-mal-ič-k-a
odmésti 	 od-mést-i 	 od-més-ti
odst 	 od-st 	 odst
ohořelému 	 o-hoř-e-l-é-mu 	 o-hoř-e-l-ému
okounět 	 okoun-ě-t 	 o-koun-ě-t
okozlit 	 o-koz-l-i-t 	 o-kozl-i-t
okresní 	 okres-n-í 	 o-kres-n-í
oktrojovat 	 oktroj-ova-t 	 o-ktroj-ova-t
olšanech 	 olšan-e-ch 	 olšan-ech
opačném 	 o-pač-n-é-m 	 o-pač-n-ém
oplésti 	 o-plést-i 	 o-plés-ti
opouští 	 o-pouš-t-í 	 o-poušt-í
opovažuješ 	 o-po-važ-u-j-e-š 	 o-po-važ-uje-š
oranžista 	 oranž-ist-a 	 oranžist-a
orchestrem 	 orchestr-e-m 	 orchestr-em
organismus 	 organismus 	 organ-ism-us
organizují 	 organ-iz-u-j-í 	 organ-iz-uj-í
orlik 	 orl-ik 	 orlik
osobu 	 o-sob-u 	 osob-u
ostatních 	 o-stat-n-í-ch 	 o-stat-n-ích
ostravské 	 ostrav-sk-é 	 os-trav-sk-é
ostravy 	 ostrav-y 	 os-trav-y
ostřit 	 ostř-i-t 	 o-stř-i-t
osudem 	 o-sud-e-m 	 o-sud-em
osvobození 	 o-svoboz-en-í 	 o-svoboz-e-n-í
osvědčovat 	 o-svědč-ova-t 	 o-s-věd-č-ova-t
osvědčují 	 o-s-věd-č-u-j-í 	 o-s-věd-č-uj-í
otevřena 	 ote-vř-en-a 	 ote-vř-e-n-a
oxfordského 	 oxford-sk-é-ho 	 oxford-sk-ého
ošukat 	 ošuk-a-t 	 o-šuk-a-t
pacientovi 	 pac-i-ent-ovi 	 pacient-ovi
padesátku 	 pade-sát-k-u 	 pa-desát-k-u
panenka 	 pan-en-k-a 	 panen-k-a
paničko 	 pan-ič-k-o 	 pan-ičk-o
pavlačí 	 pavlač-í 	 pa-vlač-í
pekárenských 	 pek-ár-en-sk-ých 	 pekáren-sk-ých
petynce 	 pety-n-c-e 	 petyn-c-e
pečivo 	 peč-iv-o 	 peč-i-v-o
pfeffermann 	 pfeffer-mann 	 pfeffermann
pilují 	 pil-u-j-í 	 pil-uj-í
pisklavě 	 pisk-l-av-ě 	 pisk-lav-ě
pitomej 	 pitom-ej 	 pitomej
plakáty 	 plakát-y 	 plak-át-y
planul 	 plan-u-l 	 pla-nu-l
plat 	 plat 	 pl-a-t
plačící 	 plač-í-c-í 	 plač-íc-í
pleteného 	 plet-en-é-ho 	 plet-en-ého
plodem 	 plod-e-m 	 plod-em
plukovník 	 pluk-ov-n-ík 	 pluk-ov-ník
podhrnout 	 pod-hrn-ou-t 	 pod-hr-nou-t
podnikám 	 pod-nik-á-m 	 pod-nik-ám
podobného 	 po-dob-n-é-ho 	 po-dob-n-ého
podvésti 	 pod-vést-i 	 pod-vés-ti
pohaněné 	 po-han-ě-n-é 	 po-han-ěn-é
pohnutlivé 	 po-h-nu-t-l-i-v-é 	 po-h-nu-t-l-iv-é
pohotovějším 	 po-hotov-ějš-ím 	 po-hotov-ěj-š-ím
politických 	 polit-ic-k-ý-ch 	 polit-ic-k-ých
polyvalence 	 poly-valenc-e 	 poly-valen-c-e
poměrem 	 po-měr-e-m 	 po-měr-em
poplatník 	 po-plat-ník 	 po-plat-n-ík
poplatníka 	 po-plat-ník-a 	 po-plat-n-ík-a
poplatníky 	 po-plat-ník-y 	 po-plat-n-ík-y
poproduktivní 	 po-pro-duk-t-iv-n-í 	 po-pro-dukt-iv-n-í
poptávky 	 po-pt-á-v-k-y 	 po-pt-áv-k-y
porculánu 	 porculán-u 	 po-rculán-u
porovnání 	 po-rovn-ání 	 po-rovn-á-n-í
porůsti 	 po-růst-i 	 po-růs-ti
posily 	 po-sil-y 	 pos-i-l-y
posluchače 	 po-sluch-a-č-e 	 po-sluch-ač-e
posluchačů 	 po-sluch-a-č-ů 	 po-sluch-ač-ů
pouhém 	 pouh-é-m 	 pouh-ém
povolaný 	 po-vol-an-ý 	 po-vol-a-n-ý
povyrůsti 	 po-vy-růst-i 	 po-vy-růs-ti
povzbudivé 	 po-vz-bud-i-v-é 	 po-vz-bud-iv-é
početí 	 po-č-e-t-í 	 po-čet-í
pošlete 	 po-šl-e-te 	 po-šlet-e
pragokoncertu 	 prag-o-koncert-u 	 prago-koncert-u
praktickým 	 prakt-ic-k-ý-m 	 prakt-ic-k-ým
praktikantům 	 prakt-ik-ant-ům 	 prakt-i-kant-ům
pravd 	 prav-d 	 pravd
prchavý 	 prch-a-v-ý 	 prch-av-ý
premií 	 prem-i-í 	 premi-í
prezidentů 	 prezid-ent-ů 	 prezident-ů
projednáním 	 pro-jed-n-án-ím 	 pro-jedn-á-n-ím
proklásti 	 pro-klást-i 	 pro-klás-ti
prokormidlovavší 	 pro-kormidl-ova-vš-í 	 pro-korm-i-dlova-vš-í
promnout 	 pro-mn-ou-t 	 pro-m-nou-t
propagace 	 propag-ac-e 	 pro-pag-ac-e
prostějovsko 	 prostějov-sk-o 	 prostěj-ov-sk-o
prostějově 	 prostějov-ě 	 prostěj-ov-ě
proto 	 pro-t-o 	 prot-o
provincií 	 provinc-i-í 	 pro-vinci-í
pročež 	 pro-č-e-ž 	 pro-č-ež
prstíčky 	 prst-íč-k-y 	 prst-íčk-y
právem 	 práv-e-m 	 práv-em
prázdné 	 prázdn-é 	 prázd-n-é
psacím 	 ps-a-c-í-m 	 ps-a-c-ím
psaním 	 ps-a-n-í-m 	 ps-a-n-ím
psychologistickou 	 psycho-log-ist-ic-k-ou 	 psych-o-log-ist-ic-k-ou
psům 	 ps-ů-m 	 ps-ům
ptejme 	 pt-ej-me 	 ptej-me
publicita 	 public-it-a 	 publicit-a
purple 	 purple 	 purpl-e
pusinka 	 pus-in-k-a 	 pusin-k-a
pučálka 	 pučálk-a 	 pučál-k-a
pzt 	 p-z-t 	 pzt
pánové 	 pán-ové 	 pán-ov-é
pápěrka 	 pá-pěr-k-a 	 pápěr-k-a
pódiem 	 pódi-em 	 pód-i-em
pódiu 	 pódi-u 	 pód-i-u
pódium 	 pódi-um 	 pód-i-um
pěkném 	 pěkn-é-m 	 pěkn-ém
pěst 	 pěst 	 pěs-t
pětistovkou 	 pět-i-st-ovk-ou 	 pět-ist-ov-k-ou
předcházejí 	 před-cház-e-j-í 	 před-cház-ej-í
předsedům 	 před-sed-ů-m 	 před-sed-ům
předstihujícím 	 před-stih-uj-í-c-í-m 	 před-stih-uj-íc-ím
přejímce 	 pře-j-í-m-c-e 	 pře-jím-c-e
přemýšlivější 	 pře-mýšl-iv-ějš-í 	 pře-mýšliv-ěj-š-í
přepnout 	 pře-pn-ou-t 	 pře-p-nou-t
připomenout 	 při-po-men-ou-t 	 při-po-me-nou-t
přisvědčit 	 při-svědč-i-t 	 při-svěd-č-i-t
přiznej 	 při-zn-e-j 	 při-zn-ej
přišinout 	 při-šin-ou-t 	 při-ši-nou-t
přiživit 	 při-živ-i-t 	 při-ži-v-i-t
přiživovat 	 při-živ-ova-t 	 při-ži-v-ova-t
přímém 	 přím-é-m 	 přím-ém
přítomném 	 pří-t-o-m-n-é-m 	 pří-t-om-n-ém
přítomnými 	 pří-t-o-m-n-ý-m-i 	 pří-t-o-m-n-ými
příštího 	 příšt-í-ho 	 příšt-ího
příštím 	 příšt-ím 	 příšt-í-m
pšenka 	 pšen-k-a 	 pš-enk-a
québec 	 québec 	 québ-ec
radomír 	 radomír 	 rad-om-ír
raději 	 rad-ěji 	 rad-ěj-i
rameni 	 ram-en-i 	 ramen-i
reklamace 	 reklam-ac-e 	 re-klam-ac-e
reklamu 	 reklam-u 	 re-klam-u
rider 	 rid-er 	 rider
rolling 	 roll-ing 	 rolling
rolničit 	 rol-n-ič-i-t 	 rol-nič-i-t
roxby 	 roxby 	 rox-b-y
rozchraptit 	 roz-chrap-t-i-t 	 roz-chrapt-i-t
rozdávat 	 roz-d-á-v-a-t 	 rozd-á-v-a-t
rozeskupit 	 roze-skup-i-t 	 roze-s-kup-i-t
rozhrnula 	 roz-hrn-u-l-a 	 roz-hr-nu-l-a
rozkošným 	 roz-koš-n-ý-m 	 roz-koš-n-ým
rozpočísti 	 roz-po-číst-i 	 roz-po-čís-ti
rozprodávat 	 roz-pro-d-á-v-a-t 	 roz-prod-á-v-a-t
rozumových 	 roz-um-ov-ý-ch 	 roz-um-ov-ých
rozvinovat 	 roz-vi-n-ova-t 	 roz-vin-ova-t
rupií 	 rupi-í 	 rup-i-í
rusové 	 rus-ové 	 rus-ov-é
rázem 	 ráz-e-m 	 ráz-em
různými 	 různ-ý-m-i 	 různ-ými
sametově 	 samet-ov-ě 	 samet-ově
samostatnější 	 sam-o-stat-n-ějš-í 	 sam-o-stat-n-ěj-š-í
schodech 	 s-chod-e-ch 	 s-chod-ech
scorpions 	 scorpion-s 	 scorpions
sebeničením 	 s-eb-e-ni-č-en-í-m 	 seb-e-nič-en-ím
sedláková 	 sedl-ák-ov-á 	 sed-l-ák-ov-á
sedmihradsku 	 sedmihradsk-u 	 sedm-i-hrad-sk-u
separátní 	 se-par-át-n-í 	 separ-át-n-í
sepnout 	 se-pn-ou-t 	 se-p-nou-t
seskupit 	 se-skup-i-t 	 se-s-kup-i-t
signalizovali 	 signal-iz-ova-l-i 	 sign-al-iz-ova-l-i
silence 	 silence 	 sil-en-c-e
sklapne 	 s-klap-n-e 	 s-klap-ne
skutečnosti 	 s-kut-eč-n-ost-i 	 skuteč-n-ost-i
skutečném 	 s-kut-eč-n-é-m 	 skuteč-n-ém
skáče 	 skáč-e 	 s-káč-e
skříní 	 skřín-í 	 s-křín-í
skřípět 	 skříp-ě-t 	 s-kříp-ě-t
skříňce 	 skříň-c-e 	 s-kříň-c-e
slovensko 	 sloven-sk-o 	 slov-en-sk-o
slovným 	 slov-n-ý-m 	 slov-n-ým
smetanový 	 smetan-ov-ý 	 s-metan-ov-ý
smrtelném 	 s-mr-tel-n-é-m 	 s-mr-teln-ém
smrtelnému 	 s-mr-tel-n-é-mu 	 s-mr-teln-ému
smyslových 	 s-mysl-ov-ý-ch 	 s-mysl-ov-ých
smésti 	 s-mést-i 	 s-més-ti
směl 	 smě-l 	 sm-ě-l
směrem 	 s-měr-e-m 	 s-měr-em
směšný 	 směš-n-ý 	 s-měš-n-ý
snahami 	 snah-a-m-i 	 snah-ami
sobě 	 s-ob-ě 	 sob-ě
solarmax 	 solar-max 	 solarmax
solidnost 	 solid-n-ost 	 s-olid-n-ost
solidní 	 solid-n-í 	 s-olid-n-í
solidních 	 solid-n-í-ch 	 solid-n-ích
sonduje 	 sond-uje 	 s-ond-uje
sotva 	 sotva 	 s-otv-a
souboj 	 sou-boj 	 souboj
souborů 	 sou-bor-ů 	 soubor-ů
soudním 	 soud-n-ím 	 soud-n-í-m
sousedního 	 sou-sed-n-í-ho 	 sou-sed-n-ího
soustava 	 sou-stav-a 	 soustav-a
soutěž 	 sou-těž 	 sou-t-ěž
specifickým 	 speci-fic-k-ý-m 	 speci-fic-k-ým
speciál 	 speci-ál 	 speciál
spekulantem 	 spek-ul-ant-e-m 	 spekul-ant-em
spojkami 	 s-poj-k-a-m-i 	 s-poj-k-ami
spokojíte 	 s-pokoj-í-te 	 s-po-koj-í-te
spolupůsobit 	 spol-u-působ-i-t 	 spolu-působ-i-t
sportovní 	 sport-ov-n-í 	 s-port-ov-n-í
stabilní 	 stabil-n-í 	 stab-il-n-í
stagnuje 	 stagn-uje 	 s-tagn-uje
stanovení 	 stan-ov-en-í 	 stanov-en-í
stanovit 	 stan-ov-i-t 	 stanov-i-t
starožitných 	 star-o-ži-t-n-ých 	 staro-žit-n-ých
starých 	 star-ý-ch 	 star-ých
stavení 	 sta-v-en-í 	 s-tav-en-í
staška 	 staš-k-a 	 s-taš-k-a
stejném 	 stej-n-é-m 	 stejn-ém
stipendium 	 stipendi-um 	 sti-pendi-um
stojaté 	 stoj-at-é 	 st-oj-a-t-é
stokorunovou 	 st-o-korun-ov-ou 	 sto-korun-ov-ou
století 	 st-o-let-í 	 stol-et-í
stones 	 stone-s 	 stones
stornovat 	 storn-ova-t 	 stor-n-ova-t
stovkou 	 st-ovk-ou 	 st-ov-k-ou
stovku 	 st-ovk-u 	 st-ov-k-u
strahov 	 strahov 	 s-trah-ov
strahova 	 strahov-a 	 s-trah-ov-a
strahově 	 strahov-ě 	 s-trah-ov-ě
strašnicích 	 strašnic-í-ch 	 straš-nic-ích
strnutí 	 s-trn-u-t-í 	 s-tr-nu-t-í
stránku 	 strán-k-u 	 s-trán-k-u
strčit 	 strč-i-t 	 s-trč-i-t
studijní 	 stud-ij-n-í 	 studij-n-í
studijních 	 stud-ij-n-ích 	 studij-n-ích
studiích 	 stud-i-í-ch 	 stud-i-ích
stál 	 stá-l 	 stál
stála 	 stá-l-a 	 stál-a
stěžovatel 	 stěž-ova-tel 	 s-těž-ova-tel
střechách 	 střech-á-ch 	 střech-ách
střelit 	 střel-i-t 	 s-třel-i-t
stříbrolesklého 	 stříbr-o-lesk-l-é-ho 	 stříbr-o-lesk-l-ého
superdobrý 	 super-dobr-ý 	 superdobr-ý
supernova 	 super-nova 	 super-nov-a
supraphon 	 supra-phon 	 supraphon
svalovou 	 sval-ov-ou 	 s-val-ov-ou
svát 	 s-vá-t 	 svá-t
svídnici 	 svídnic-i 	 svíd-nic-i
svědomím 	 s-věd-om-í-m 	 s-věd-om-ím
světelné 	 svět-el-n-é 	 svět-eln-é
světelných 	 svět-el-n-ých 	 svět-eln-ých
systémem 	 systém-e-m 	 systém-em
tajemství 	 taj-em-stv-í 	 taj-emstv-í
takzvaném 	 tak-zv-a-n-é-m 	 tak-zv-a-n-ém
také 	 také 	 tak-é
telat 	 tel-at 	 tel-a-t
telefonního 	 tele-fon-n-í-ho 	 tele-fon-n-ího
televize 	 televize 	 telev-iz-e
temporalizovatelný 	 tempor-al-izova-teln-ý 	 tempor-al-izova-telný
tendenci 	 tend-enc-i 	 tendenc-i
tenounkým 	 ten-oun-k-ý-m 	 ten-ounk-ým
tesklivých 	 tesk-l-iv-ý-ch 	 tesk-liv-ých
tetička 	 tet-ič-k-a 	 tet-ičk-a
textil 	 textil 	 text-i-l
thajska 	 thaj-sk-a 	 thajsk-a
theodicée 	 theodicée 	 theodic-ée
tikem 	 tik-e-m 	 tik-em
tkalcovnictví 	 tka-lc-ovnic-tv-í 	 tk-a-l-c-ov-nic-tv-í
tlapkách 	 tlap-k-á-ch 	 tlap-k-ách
tomáš 	 tomáš 	 t-om-á-š
totožný 	 totožn-ý 	 t-o-tož-n-ý
treperendo 	 treper-end-o 	 treperend-o
trní 	 trn-í 	 tr-n-í
tropickém 	 trop-ick-ém 	 trop-ic-k-ém
trpělivě 	 trp-ě-l-iv-ě 	 trp-ě-liv-ě
tržním 	 trž-n-ím 	 trž-n-í-m
turbovrtulových 	 turbo-vrt-ul-ov-ých 	 turbo-vrtul-ov-ých
turné 	 turné 	 tur-n-é
tužeb 	 tuž-eb 	 tužeb
tvrzeními 	 tvrz-en-í-m-i 	 tvrz-en-ími
tzv 	 t-z-v 	 tzv
téhož 	 t-é-ho-ž 	 t-ého-ž
tématu 	 tém-at-u 	 témat-u
tímto 	 t-í-m-t-o 	 t-ím-to
týdeníku 	 týden-ík-u 	 týd-en-ík-u
těhotenství 	 těhoten-ství 	 těh-oten-stv-í
těmi 	 t-ě-m-i 	 t-ěmi
třemi 	 tř-e-m-i 	 tř-emi
třesoucí 	 třes-ou-c-í 	 třes-ouc-í
třetím 	 tř-e-t-í-m 	 tř-et-í-m
ukazuju 	 u-kaz-u-j-u 	 u-kaz-uj-u
ukrutným 	 u-krut-n-ý-m 	 u-krut-n-ým
ulici 	 ul-ic-i 	 ulic-i
uloženými 	 u-lož-en-ý-m-i 	 u-lož-en-ými
umožnilo 	 u-možn-i-l-o 	 u-mož-n-i-l-o
umožnily 	 u-možn-i-l-y 	 u-mož-n-i-l-y
uměle 	 u-m-ě-l-e 	 um-ě-l-e
umělostech 	 u-m-ě-l-ost-e-ch 	 umě-l-ost-ech
unikát 	 unik-át 	 un-ik-á-t
univerzitního 	 uni-verz-it-n-ího 	 univerz-it-n-ího
urgenci 	 urg-enc-i 	 u-rgenc-i
určitě 	 urč-it-ě 	 u-rč-it-ě
usa 	 u-s-a 	 us-a
usd 	 u-s-d 	 u-sd
uskutečnily 	 u-s-kut-eč-n-i-l-y 	 u-skuteč-n-i-l-y
ustrnule 	 u-s-trn-u-l-e 	 u-s-tr-nu-l-e
usvědčit 	 u-svědč-i-t 	 u-svěd-č-i-t
uzpůsobit 	 u-z-působ-i-t 	 u-z-pů-sob-i-t
uším 	 uš-ím 	 uš-í-m
užitečné 	 u-žit-eč-n-é 	 u-ži-t-eč-n-é
uživit 	 u-živ-i-t 	 u-ži-v-i-t
vanka 	 van-k-a 	 vank-a
velkého 	 vel-k-é-ho 	 vel-k-ého
velvyslanectví 	 vel-vy-sl-a-n-ec-tv-í 	 velvy-sla-nec-tv-í
ventures 	 venture-s 	 ventures
vesnici 	 ves-nic-i 	 ves-n-ic-i
vespolek 	 ve-s-pol-ek 	 vespol-ek
vezmeš 	 vez-m-e-š 	 vez-meš
večera 	 večer-a 	 večera
veřejně 	 veř-ej-n-ě 	 veřej-n-ě
veškerým 	 veš-k-er-ý-m 	 veš-k-er-ým
vinohradského 	 vinohrad-sk-é-ho 	 vinohrad-sk-ého
virile 	 virile 	 viril-e
vlastního 	 vlast-n-í-ho 	 vlast-n-ího
vnitřnostech 	 v-nitř-n-ost-e-ch 	 v-nitř-n-ost-ech
vodolově 	 vodolov-ě 	 vodol-ov-ě
vraštět 	 vraš-t-ě-t 	 vrašt-ě-t
vrtulníky 	 vrt-ul-ník-y 	 vrt-ul-n-ík-y
vrátnice 	 vrát-nic-e 	 vrát-n-ic-e
vstupenek 	 vs-tup-en-ek 	 v-stup-en-ek
vstupenka 	 v-stup-enk-a 	 v-stup-en-k-a
vstupenku 	 v-stup-enk-u 	 v-stup-en-k-u
vstupenky 	 vstup-enk-y 	 v-stup-en-k-y
vynaložením 	 vy-na-lož-en-í-m 	 vy-na-lož-en-ím
vyplaněný 	 vy-plan-ě-n-ý 	 vy-plan-ěn-ý
vypočísti 	 vy-po-číst-i 	 vy-po-čís-ti
vysokoškolské 	 vys-ok-o-škol-sk-é 	 vys-oko-škol-sk-é
vysokoškolský 	 vys-ok-o-škol-sk-ý 	 vys-oko-škol-sk-ý
vyspinkat 	 vy-sp-ink-a-t 	 vy-spink-a-t
vyspělým 	 vy-spě-l-ým 	 vy-spěl-ým
vysílací 	 vy-síl-a-c-í 	 vy-síl-ac-í
vyčísti 	 vy-číst-i 	 vy-čís-ti
vyřinout 	 vy-řin-ou-t 	 vy-ři-nou-t
vzdělání 	 vz-děl-án-í 	 vz-děl-á-n-í
válka 	 válk-a 	 vál-k-a
vás 	 v-á-s 	 v-ás
vítkovice 	 vít-k-ov-ic-e 	 vítk-ov-ic-e
vítkovického 	 vítk-ovic-k-ého 	 vít-k-ov-ic-k-ého
vítkovickém 	 vítk-ovic-k-ém 	 vít-k-ov-ic-k-ém
vítězství 	 vítěz-ství 	 vítěz-stv-í
výhodnější 	 vý-hod-n-ějš-í 	 vý-hod-n-ěj-š-í
výsostným 	 výs-ost-n-ý-m 	 výs-ost-n-ým
výčitek 	 vý-čit-e-k 	 vý-čit-ek
vševědova 	 vševěd-ov-a 	 vš-e-věd-ov-a
vůnička 	 vůn-ič-k-a 	 vůn-ičk-a
westermannem 	 westermann-e-m 	 westerman-n-em
whitney 	 whitney 	 whit-ne-y
yse 	 y-s-e 	 ys-e
zafilosofovat 	 za-filo-sof-ova-t 	 za-fil-o-sof-ova-t
zahozených 	 za-hoz-en-ý-ch 	 za-hoz-en-ých
zahynul 	 za-hyn-u-l 	 za-hy-nu-l
zakusitelno 	 za-kus-i-tel-n-o 	 za-kus-i-teln-o
zaměstnancům 	 za-měst-n-an-c-ům 	 za-měst-n-a-n-c-ům
zanadávat 	 za-na-d-á-v-a-t 	 za-nad-á-v-a-t
zapomnění 	 za-po-mn-ě-n-í 	 za-po-mn-ěn-í
zapomínat 	 za-pomín-a-t 	 za-po-mín-a-t
započísti 	 za-po-číst-i 	 za-po-čís-ti
zaprodávat 	 za-pro-d-á-v-a-t 	 za-prod-á-v-a-t
zareagovat 	 za-re-ag-ova-t 	 za-reag-ova-t
zasahují 	 za-sah-u-j-í 	 za-sah-uj-í
zasklívaně 	 za-skl-í-v-a-n-ě 	 za-sklí-v-a-n-ě
zaslíbeni 	 za-s-líb-en-i 	 za-slíb-en-i
zasmyčkování 	 za-smyč-k-ová-n-í 	 za-s-myč-k-ová-n-í
zatvrzují 	 za-tvrz-u-j-í 	 za-tvrz-uj-í
zaujatý 	 z-au-j-a-t-ý 	 za-u-j-a-t-ý
zaujmouti 	 zau-jm-ou-ti 	 za-u-j-mou-ti
zdeničky 	 zden-ič-k-y 	 zden-ičk-y
zdeněk 	 zdeněk 	 zd-en-ěk
zemím 	 zem-ím 	 zem-í-m
zinventovat 	 z-invent-ova-t 	 z-in-vent-ova-t
zločinem 	 zl-o-čin-e-m 	 zl-o-čin-em
zmoralizování 	 z-moral-iz-ová-n-í 	 z-moral-izová-n-í
změněném 	 z-měn-ěn-é-m 	 z-měn-ěn-ém
znovuoživenost 	 z-nov-u-o-živ-en-ost 	 z-nov-u-o-ži-v-en-ost
znásobovaný 	 z-násob-ova-n-ý 	 z-ná-sob-ova-n-ý
zorganizovaný 	 z-organ-iz-ova-n-ý 	 z-organ-izova-n-ý
zprostředkovatelské 	 z-pro-střed-k-ova-tel-sk-é 	 z-pro-střed-k-ova-telské
zprostředkuje 	 z-pro-střed-k-uje 	 z-pro-středk-uje
zpět 	 zpět 	 zpě-t
zpěvačka 	 z-pě-v-a-č-k-a 	 z-pě-v-a-čk-a
zpěčovat 	 zpěč-ova-t 	 z-pěč-ova-t
zrakový 	 zrak-ov-ý 	 z-rak-ov-ý
ztotožnit 	 z-to-tož-n-i-t 	 z-t-o-tož-n-i-t
zveřejněné 	 z-veřej-n-ě-n-é 	 z-veřej-n-ěn-é
zveřejnění 	 z-veřej-n-ě-n-í 	 z-veřej-n-ěn-í
zvláště 	 zvláště 	 zvlášt-ě
zvídavější 	 z-víd-a-v-ějš-í 	 z-víd-a-v-ěj-š-í
zádech 	 zád-e-ch 	 zád-ech
základem 	 zá-klad-e-m 	 zá-klad-em
závojnatkách 	 zá-voj-n-at-k-á-ch 	 zá-voj-n-at-k-ách
zůstalo 	 zů-sta-l-o 	 z-ů-sta-l-o
úspěšnější 	 ú-spěš-n-ějš-í 	 ú-spěš-n-ěj-š-í
útrobách 	 útrob-ách 	 ú-trob-ách
úzká 	 úz-k-á 	 ú-zk-á
úžasem 	 ú-žas-e-m 	 ú-žas-em
černým 	 čern-ý-m 	 čern-ým
českomalínský 	 česk-o-malín-sk-ý 	 čes-k-o-malín-sk-ý
českého 	 čes-k-é-ho 	 čes-k-ého
čich 	 čich 	 č-ich
článkem 	 člán-k-e-m 	 člán-k-em
čokoládou 	 čokolád-ou 	 čo-kolád-ou
čsfr 	 č-s-f-r 	 čsfr
čsn 	 č-s-n 	 čsn
čssr 	 č-s-s-r 	 čssr
čtvrtletního 	 čtvrt-let-n-ího 	 čtvrt-l-et-n-ího
čtvrtletně 	 čtvrt-let-n-ě 	 čtvrt-l-et-n-ě
čtvrtletí 	 čtvrt-let-í 	 čtvrt-l-et-í
čubička 	 čub-ič-k-a 	 čub-ičk-a
čubičku 	 čub-ič-k-u 	 čub-ičk-u
čzpi 	 č-z-p-i 	 čzp-i
šifrovaných 	 šifr-ova-n-ý-ch 	 šifr-ova-n-ých
škudlit 	 škud-l-i-t 	 škudl-i-t
škádlit 	 škádl-i-t 	 škád-l-i-t
šmejkal 	 šmejkal 	 šmejk-a-l
šprýmovat 	 šprým-ova-t 	 š-prým-ova-t
štít 	 štít 	 št-í-t
šumperka 	 šumperk-a 	 šumper-k-a
švýcarské 	 švýcar-sk-é 	 švý-car-sk-é
šíblová 	 šíbl-ová 	 šíbl-ov-á
žaludek 	 žaludek 	 žalud-ek
žehravost 	 žehr-a-v-ost 	 že-hrav-ost
železárnách 	 želez-árn-ách 	 želez-ár-n-ách
žernově 	 žernov-ě 	 žern-ov-ě
živnostenského 	 ži-v-n-ost-ensk-ého 	 ži-v-n-ost-en-sk-ého
životními 	 ži-v-ot-n-í-m-i 	 ži-v-ot-n-ími
žádoucí 	 žád-ou-c-í 	 žád-ouc-í
