TRYING TO APPLY RULE N-ista --> N-ismus	%OBRATIT
  abolicionista --> abolicionismus
  absolutista --> absolutismus
  aktivista --> aktivismus
  altruista --> altruismus
  animista --> animismus
  antikomunista --> antikomunismus
  ateista --> ateismus
  autista --> autismus
  automobilista --> automobilismus
  baptista --> baptismus
  buddhista --> buddhismus
  dadaista --> dadaismus
  darwinista --> darwinismus
  defétista --> defétismus
  deista --> deismus
  determinista --> determinismus
  egoista --> egoismus
  evolucionista --> evolucionismus
  exhibicionista --> exhibicionismus
  expresionista --> expresionismus
  extremista --> extremismus
  extrémista --> extrémismus
  fašista --> fašismus
  feminista --> feminismus
  fetišista --> fetišismus
  futurista --> futurismus
  hinduista --> hinduismus
  humanista --> humanismus
  iluzionista --> iluzionismus
  impresionista --> impresionismus
  izolacionista --> izolacionismus
  judaista --> judaismus
  kariérista --> kariérismus
  kolektivista --> kolektivismus
  kolorista --> kolorismus
  komunista --> komunismus
  konformista --> konformismus
  lobbista --> lobbismus
  manýrista --> manýrismus
  marxista --> marxismus
  masochista --> masochismus
  merkantilista --> merkantilismus
  militarista --> militarismus
  modernista --> modernismus
  monetarista --> monetarismus
  monoteista --> monoteismus
  nacista --> nacismus
  negativista --> negativismus
  neofašista --> neofašismus
  neonacista --> neonacismus
  nihilista --> nihilismus
  nudista --> nudismus
  okultista --> okultismus
  oportunista --> oportunismus
  optimista --> optimismus
  panteista --> panteismus
  parašutista --> parašutismus
  perfekcionista --> perfekcionismus
  pesimista --> pesimismus
  polyteista --> polyteismus
  populista --> populismus
  postmodernista --> postmodernismus
  pozitivista --> pozitivismus
  protekcionista --> protekcionismus
  purista --> purismus
  rasista --> rasismus
  reformista --> reformismus
  relativista --> relativismus
  revizionista --> revizionismus
  sadista --> sadismus
  separatista --> separatismus
  solipsista --> solipsismus
  spiritista --> spiritismus
  taoista --> taoismus
  terorista --> terorismus
  urbanista --> urbanismus
  utilitarista --> utilitarismus
  utrakvista --> utrakvismus
  šovinista --> šovinismus
  žurnalista --> žurnalismus
TRYING TO APPLY RULE N-ik --> N-ika	%OBRATIT
  analytik --> analytika
  aritmetik --> aritmetika
  astrofyzik --> astrofyzika
  aviatik --> aviatika
  avionik --> avionika
  balistik --> balistika
  biofyzik --> biofyzika
  biotronik --> biotronika
  botanik --> botanika
  diagnostik --> diagnostika
  didaktik --> didaktika
  dietetik --> dietetika
  dogmatik --> dogmatika
  dramatik --> dramatika
  elektroakustik --> elektroakustika
  elektronik --> elektronika
  elektrotechnik --> elektrotechnika
  energetik --> energetika
  erotik --> erotika
  estetik --> estetika
  etik --> etika
  farmaceutik --> farmaceutika
  fyzik --> fyzika
  genetik --> genetika
  geofyzik --> geofyzika
  geopolitik --> geopolitika
  grafik --> grafika
  gramatik --> gramatika
  heraldik --> heraldika
  informatik --> informatika
  keramik --> keramika
  klasik --> klasika
  kosmetik --> kosmetika
  kritik --> kritika
  kybernetik --> kybernetika
  logik --> logika
  logistik --> logistika
  lyrik --> lyrika
  magik --> magika
  matematik --> matematika
  mechanik --> mechanika
  metafyzik --> metafyzika
  metodik --> metodika
  mimik --> mimika
  mystik --> mystika
  optik --> optika
  plastik --> plastika
  polemik --> polemika
  politik --> politika
  pragmatik --> pragmatika
  prognostik --> prognostika
  protetik --> protetika
  psychotechnik --> psychotechnika
  psychotronik --> psychotronika
  pyrotechnik --> pyrotechnika
  radiotechnik --> radiotechnika
  romantik --> romantika
  rétorik --> rétorika
  scholastik --> scholastika
  statistik --> statistika
  systematik --> systematika
  taktik --> taktika
  technik --> technika
  videotechnik --> videotechnika
  zootechnik --> zootechnika

TRYING TO APPLY RULE N-log --> N-logie	%OBRATIT
  alergolog --> alergologie
  anesteziolog --> anesteziologie
  antropolog --> antropologie
  archeolog --> archeologie
  astrolog --> astrologie
  bakteriolog --> bakteriologie
  biolog --> biologie
  biotechnolog --> biotechnologie
  cytolog --> cytologie
  dendrolog --> dendrologie
  dermatolog --> dermatologie
  diabetolog --> diabetologie
  dietolog --> dietologie
  egyptolog --> egyptologie
  ekolog --> ekologie
  embryolog --> embryologie
  endokrinolog --> endokrinologie
  entomolog --> entomologie
  epidemiolog --> epidemiologie
  epistemolog --> epistemologie
  etnolog --> etnologie
  etolog --> etologie
  etymolog --> etymologie
  farmakolog --> farmakologie
  filolog --> filologie
  frenolog --> frenologie
  futurolog --> futurologie
  fyziolog --> fyziologie
  gastroenterolog --> gastroenterologie
  genealog --> genealogie
  geolog --> geologie
  gerontolog --> gerontologie
  glaciolog --> glaciologie
  grafolog --> grafologie
  gynekolog --> gynekologie
  hematolog --> hematologie
  hepatolog --> hepatologie
  herpetolog --> herpetologie
  histolog --> histologie
  homolog --> homologie
  hydrogeolog --> hydrogeologie
  ichtyolog --> ichtyologie
  ideolog --> ideologie
  imunolog --> imunologie
  japanolog --> japanologie
  kardiolog --> kardiologie
  klimatolog --> klimatologie
  komeniolog --> komeniologie
  kosmolog --> kosmologie
  kriminolog --> kriminologie
  kryptolog --> kryptologie
  kulturolog --> kulturologie
  kynolog --> kynologie
  meteorolog --> meteorologie
  metodolog --> metodologie
  metrolog --> metrologie
  mikrobiolog --> mikrobiologie
  mineralog --> mineralogie
  muzikolog --> muzikologie
  mykolog --> mykologie
  mytolog --> mytologie
  nefrolog --> nefrologie
  neurobiolog --> neurobiologie
  neurofyziolog --> neurofyziologie
  neurolog --> neurologie
  neuropatolog --> neuropatologie
  neuropsycholog --> neuropsychologie
  neuroradiolog --> neuroradiologie
  numerolog --> numerologie
  oceánolog --> oceánologie
  oftalmolog --> oftalmologie
  onkolog --> onkologie
  ornitolog --> ornitologie
  otorinolaryngolog --> otorinolaryngologie
  paleoantropolog --> paleoantropologie
  paleontolog --> paleontologie
  parapsycholog --> parapsychologie
  parazitolog --> parazitologie
  patolog --> patologie
  penolog --> penologie
  planetolog --> planetologie
  politolog --> politologie
  pomolog --> pomologie
  psycholog --> psychologie
  radiobiolog --> radiobiologie
  radiolog --> radiologie
  revmatolog --> revmatologie
  scientolog --> scientologie
  seismolog --> seismologie
  sexuolog --> sexuologie
  sinolog --> sinologie
  sociolog --> sociologie
  speleolog --> speleologie
  stomatolog --> stomatologie
  sérolog --> sérologie
  technolog --> technologie
  teolog --> teologie
  terminolog --> terminologie
  toxikolog --> toxikologie
  transplantolog --> transplantologie
  traumatolog --> traumatologie
  typolog --> typologie
  ufolog --> ufologie
  urolog --> urologie
  virolog --> virologie
  vulkanolog --> vulkanologie
  zoolog --> zoologie

TRYING TO APPLY RULE N-nom --> N-nomie	%OBRATIT
  agronom --> agronomie
  astronom --> astronomie
  ekonom --> ekonomie
  gastronom --> gastronomie
  makroekonom --> makroekonomie
  radioastronom --> radioastronomie

TRYING TO APPLY RULE N-graf --> N-grafie	%OBRATIT
  choreograf --> choreografie
  chromatograf --> chromatografie
  chronograf --> chronografie
  demograf --> demografie
  echokardiograf --> echokardiografie
  elektroencefalograf --> elektroencefalografie
  elektrokardiograf --> elektrokardiografie
  epigraf --> epigrafie
  etnograf --> etnografie
  fotograf --> fotografie
  geograf --> geografie
  holograf --> holografie
  hydrograf --> hydrografie
  kaligraf --> kaligrafie
  kartograf --> kartografie
  kinematograf --> kinematografie
  kosmograf --> kosmografie
  kryptograf --> kryptografie
  krystalograf --> krystalografie
  lexikograf --> lexikografie
  litograf --> litografie
  mamograf --> mamografie
  oceánograf --> oceánografie
  polygraf --> polygrafie
  pornograf --> pornografie
  scénograf --> scénografie
  sonograf --> sonografie
  telegraf --> telegrafie
  tomograf --> tomografie
  topograf --> topografie
  typograf --> typografie

TRYING TO APPLY RULE A-ný --> N-a %obrátit
  adresný --> adresa
  bylinný --> bylina
  bídný --> bída
  bílkovinný --> bílkovina
  cestný --> cesta
  chmurný --> chmura
  darebný --> dareba
  drahný --> draha
  dřevinný --> dřevina
  důvěrný --> důvěra
  gramotný --> gramota
  hmotný --> hmota
  hnilobný --> hniloba
  hrůzný --> hrůza
  jazykovědný --> jazykověda
  jiskrný --> jiskra
  jízdný --> jízda
  kapalinný --> kapalina
  klopotný --> klopota
  krutovládný --> krutovláda
  krásný --> krása
  květenný --> květena
  křovinný --> křovina
  ledvinný --> ledvina
  mikrovlnný --> mikrovlna
  mizerný --> mizera
  mrtvolný --> mrtvola
  mrákotný --> mrákota
  mírný --> míra
  nevýhodný --> nevýhoda
  nevěrný --> nevěra
  neúrodný --> neúroda
  nečistotný --> nečistota
  nicotný --> nicota
  ničemný --> ničema
  noblesný --> noblesa
  nádherný --> nádhera
  náhodný --> náhoda
  nápodobný --> nápodoba
  nápovědný --> nápověda
  nápravný --> náprava
  obdobný --> obdoba
  obranný --> obrana
  obžalobný --> obžaloba
  ochotný --> ochota
  ochranný --> ochrana
  odvetný --> odveta
  okrasný --> okrasa
  oporný --> opora
  ostudný --> ostuda
  otravný --> otrava
  pastvinný --> pastvina
  pochvalný --> pochvala
  podstatný --> podstata
  pokorný --> pokora
  potvorný --> potvora
  potřebný --> potřeba
  převýchovný --> převýchova
  příhodný --> příhoda
  přímluvný --> přímluva
  přípravný --> příprava
  přírodovědný --> přírodověda
  příšerný --> příšera
  rakovinný --> rakovina
  rašelinný --> rašelina
  robotný --> robota
  ropný --> ropa
  rovinný --> rovina
  rozpěrný --> rozpěra
  rybný --> ryba
  samosprávný --> samospráva
  samotný --> samota
  samovládný --> samovláda
  sebeobranný --> sebeobrana
  sebezáchovný --> sebezáchova
  sebezáchranný --> sebezáchrana
  sebezáhubný --> sebezáhuba
  slatinný --> slatina
  slzný --> slza
  sodný --> soda
  soustavný --> soustava
  spoluvinný --> spoluvina
  stravný --> strava
  strunný --> struna
  stvůrný --> stvůra
  superhvězdný --> superhvězda
  svobodný --> svoboda
  světovládný --> světovláda
  travinný --> travina
  tělovýchovný --> tělovýchova
  vlastivědný --> vlastivěda
  vrbný --> vrba
  výchovný --> výchova
  výhodný --> výhoda
  výhradný --> výhrada
  výmluvný --> výmluva
  výměnný --> výměna
  výměrný --> výměra
  výpravný --> výprava
  výsadný --> výsada
  výstavný --> výstava
  výzvědný --> výzvěda
  výšinný --> výšina
  výživný --> výživa
  zdravovědný --> zdravověda
  zhoubný --> zhouba
  zimný --> zima
  zkázný --> zkáza
  zrůdný --> zrůda
  zábavný --> zábava
  zábranný --> zábrana
  záchranný --> záchrana
  záhadný --> záhada
  záhubný --> záhuba
  zálibný --> záliba
  záměnný --> záměna
  zástavný --> zástava
  závadný --> závada
  úhonný --> úhona
  úlevný --> úleva
  úměrný --> úměra
  únavný --> únava
  úplatný --> úplata
  úpravný --> úprava
  úrodný --> úroda
  úschovný --> úschova
  úsporný --> úspora
  ústavný --> ústava
  čarokrásný --> čarokrása
  četný --> četa
  řepný --> řepa
  šeredný --> šereda
  žalobný --> žaloba

TRYING TO APPLY RULE N-alita --> A-ální %obrátit
  abnormalita --> abnormální
  aktualita --> aktuální
  animalita --> animální
  asexualita --> asexuální
  atonalita --> atonální
  banalita --> banální
  bestialita --> bestiální
  bisexualita --> bisexuální
  brutalita --> brutální
  centralita --> centrální
  chiralita --> chirální
  dualita --> duální
  emocionalita --> emocionální
  eventualita --> eventuální
  exteritorialita --> exteritoriální
  finalita --> finální
  formalita --> formální
  funkcionalita --> funkcionální
  generalita --> generální
  genialita --> geniální
  heterosexualita --> heterosexuální
  homosexualita --> homosexuální
  ilegalita --> ilegální
  individualita --> individuální
  intelektualita --> intelektuální
  intermodalita --> intermodální
  iracionalita --> iracionální
  irealita --> ireální
  kardinalita --> kardinální
  kauzalita --> kauzální
  kolegialita --> kolegiální
  kontinentalita --> kontinentální
  kriminalita --> kriminální
  lateralita --> laterální
  legalita --> legální
  letalita --> letální
  loajalita --> loajální
  lokalita --> lokální
  maximalita --> maximální
  mentalita --> mentální
  modalita --> modální
  monumentalita --> monumentální
  mortalita --> mortální
  moralita --> morální
  multidimenzionalita --> multidimenzionální
  multikulturalita --> multikulturální
  multimedialita --> multimediální
  multimodalita --> multimodální
  municipalita --> municipální
  natalita --> natální
  neloajalita --> neloajální
  neprofesionalita --> neprofesionální
  neutralita --> neutrální
  normalita --> normální
  oficialita --> oficiální
  originalita --> originální
  pluralita --> plurální
  potencialita --> potenciální
  profesionalita --> profesionální
  proporcionalita --> proporcionální
  racionalita --> racionální
  regionalita --> regionální
  sentimentalita --> sentimentální
  sexualita --> sexuální
  socialita --> sociální
  specialita --> speciální
  spiritualita --> spirituální
  teatralita --> teatrální
  teritorialita --> teritoriální
  tonalita --> tonální
  totalita --> totální
  transsexualita --> transsexuální
  trivialita --> triviální
  vertikalita --> vertikální
  virtualita --> virtuální
  vitalita --> vitální
  žovialita --> žoviální
TRYING TO APPLY RULE N-anita --> A-ánní %obrátit
  humanita --> humánní
TRYING TO APPLY RULE N-ozita --> A-ózní %obrátit
  kuriozita --> kuriózní
  nervozita --> nervózní
  religiozita --> religiózní
  virtuozita --> virtuózní
  viskozita --> viskózní
TRYING TO APPLY RULE N-ie --> A-ní  %obrátit
  anizotropie --> anizotropní
  anomálie --> anomální
  autarkie --> autarkní
  autonomie --> autonomní
  auxotrofie --> auxotrofní
  bižuterie --> bižuterní
  buržoazie --> buržoazní
  cereálie --> cereální
  dystrofie --> dystrofní
  eozinofilie --> eozinofilní
  fekálie --> fekální
  fosilie --> fosilní
  galanterie --> galanterní
  genitálie --> genitální
  hegemonie --> hegemonní
  homofonie --> homofonní
  homologie --> homologní
  homonymie --> homonymní
  hydrofobie --> hydrofobní
  izomerie --> izomerní
  kafilérie --> kafilérní
  kakofonie --> kakofonní
  klaustrofobie --> klaustrofobní
  marginálie --> marginální
  minerálie --> minerální
  monofonie --> monofonní
  monogamie --> monogamní
  naturálie --> naturální
  nekrofilie --> nekrofilní
  ortodoxie --> ortodoxní
  pedofilie --> pedofilní
  periferie --> periferní
  polychromie --> polychromní
  polyfonie --> polyfonní
  polygamie --> polygamní
  polymorfie --> polymorfní
  polyploidie --> polyploidní
  pruderie --> pruderní
  prudérie --> prudérní
  radiofonie --> radiofonní
  radiotelefonie --> radiotelefonní
  radiotelegrafie --> radiotelegrafní
  schizofrenie --> schizofrenní
  stereotypie --> stereotypní
  synchronie --> synchronní
  synonymie --> synonymní
  telefonie --> telefonní
  telegrafie --> telegrafní
  textilie --> textilní
  tixotropie --> tixotropní
  xenofobie --> xenofobní


