### Number of DeriNets roots with parents in SSJC (in this file): 5402 ###

metrie_N	batymetr_None; barometr_None; planimetr_None; chronometr_None
francký_A	franský_None; Franky_None; Frank_None
málo_D	namále_None; malý_None; pramalý_None
plínečka_N	plena_None; plínka_None; plína_None
pírečko_N	pérečko_None; pírko_None; péro_None
málo_N	namále_None; malý_None; pramalý_None
jetýlek_N	jetelíček_None; jetel_None
kozlíček_N	kozlík_None; kozel_None
meliorativní_A	meliorativum_None; meliorace_None
větřínek_N	vítr_None; větřík_None
daleko_N	dále_None; daleký_None
slizovitý_A	slizový_None; sliznatý_None
skřínka_N	skříňka_None; skříň_None
vkrátce_D	nakrátko_None; vkrátku_None
řepniště_N	řepnisko_None; řepiště_None
pomalu_D	pomálu_None; pomalý_None
Tyrolan_N	Tyrolák_None; Tyrolsko_None
mates_N	Mates_None; matjes_None
vlákenko_N	vlákno_None; vlákénko_None
Zuzička_N	zuzka_None; Zuza_None
rumoviště_N	rumiště_None; rumovisko_None
slítnout_V	sletět_None; slétnout_None
věcnatý_A	věcní_None; věcný_None
urbariální_A	urbární_None; urbář_None
trošilinku_D	trošku_None; troška_None
řevniště_N	říjiště_None; řevnice_None
plsťovitý_A	plstnatý_None; plsťový_None
špalíček_N	špalek_None; špalík_None
trošičku_D	trošku_None; troška_None
plamének_N	plamínek_None; plamen_None
Tomíšek_N	Tomiš_None; Tomek_None
styčný_A	zprostředkování_None; styk_None
broučínek_N	brouk_None; brouček_None
měsíční_A	měsíc_None; měsíčný_None
Jeníček_N	Jenda_None; Jan_None
záchůdek_N	záchodek_None; záchod_None
záhůnek_N	záhon_None; záhonek_None
zvláště_D	schválně_None; zvlášť_None
jakžtakž_D	jakž_None; taktak_None
obzvláště_D	obzvláštní_None; obzvlášť_None
strožok_N	štrozok_None; štrúzok_None
hrabičky_N	hrabička_None; hrábě_None
komisárek_N	komisař_None; komisar_None
prstének_N	prstýnek_None; prsten_None
různo_N	různě_None; různý_None
podkověnka_N	podkova_None; podkovička_None
zrichtovat_V	rychtovat_None; zrychtovat_None
pára_N	pár_None; odpar_None
výčepní_N	čepování_None; výčep_None
mužický_A	pidimužík_None; mužik_None
tichounko_D	tichounký_None; ticho_None
morný_A	hladomor_None; morní_None
skopové_N	skopová_None; skopový_None
americký_A	Iberoamerika_None; Amerika_None
drobítek_N	drobínek_None; drobet_None
douška_N	duše_None; doušek_None
výhrožný_A	výhružný_None; výhrozný_None
poklůpek_N	poklop_None; poklopec_None
větrno_D	větrný_None; větrnost_None
trojánský_A	trojanský_None; Trója_None
propásnout_V	propást_None; pásnout_None
šňůrčička_N	šňůra_None; šňůrka_None
kasovní_A	kasa_None; kasový_None
záhumenice_N	záhumení_None; záhumní_None
hladce_D	hladký_None; hladko_None
zádrhlina_N	zádrhel_None; zádrh_None
zádička_N	záda_None; zádíčka_None
kursovní_A	kursový_None; kurs_None
drobínek_N	drobek_None; drobítek_None
honorární_A	honor_None; honorář_None
známčička_N	známečka_None; známka_None
sukýnečka_N	sukýnka_None; sukně_None
záloženský_A	záložní_None; záložna_None
Andula_N	Anda_None; Anna_None
Jeník_N	Jenda_None; Jan_None
šatečky_N	šatičky_None; šaty_None
poklopeček_N	poklop_None; poklopec_None
uzdečka_N	uzda_None; uzdička_None
vrboviště_N	vrbiště_None; vrbovisko_None
zrnéčkovitý_A	zrnečkovitý_None; zrníčkovitý_None
prázdno_N	naprázdno_None; prázdný_None
kamének_N	kamínek_None; kámen_None
snůpek_N	snopek_None; snop_None
vršík_N	vrch_None; vršek_None
katastrofální_A	katastrofický_None; katastrofa_None
vesňan_N	vesničan_None; vesní_None
příslovečný_A	příslovce_None; přísloví_None
stopička_N	stopa_None; stopka_None
pískovna_N	písečník_None; pískoviště_None
klenební_A	klenebný_None; klenbový_None
volík_N	volek_None; vůl_None
trošinečku_D	trošku_None; troška_None
řemeslíčko_N	řemesílko_None; řemeslo_None
ohříváček_N	ohřívadlo_None; ohřívač_None
Pražan_N	Pražák_None; Praha_None
paduánský_A	Padova_None; Padua_None
čekana_N	čakan_None; čekan_None
halouzka_N	haluzka_None; haluz_None
blízko_N	nablízko_None; blízký_None
šlechtíček_N	šlechtična_None; šlechtic_None
měrný_A	elektroměr_None; vodoměr_None
zastupitelkyně_N	zastupitel_None; zástupce_None
blatný_A	blata_None; bláto_None
dírečka_N	dírka_None; díra_None
zadrhlina_N	zádrhel_None; zádrh_None
dál_N	daleko_None; zdáli_None
ramazán_N	ramadan_None; ramadán_None
zájmiček_N	zájmíček_None; zájem_None
slunečko_N	slunéčko_None; slunce_None
šlechtička_N	šlechtična_None; šlechtic_None
jablonský_A	Jablonná_None; Jablonné_None
jamčička_N	jamka_None; jáma_None
hůlečka_N	hůlčička_None; hůl_None
žalmovní_A	žalmový_None; žalm_None
podrůstek_N	podrost_None; podrostek_None
moudře_D	moudrý_None; velemoudrý_None
Lotinka_N	Loti_None; Lota_None
kraječek_N	krajíček_None; kraj_None
okenička_N	okenice_None; okénečko_None
korální_A	korál_None; korálový_None
tah_N	zatáhnout_None; průtah_None
malinko_D	malinký_None; maličko_None
Janíček_N	Jan_None; Janík_None
Viktorie_N	Viktorka_None; Viktor_None
ouřada_N	úřada_None; úřad_None
roztěrač_N	roztírací_None; roztírač_None
krapítek_N	krapet_None; krapínek_None
onehda_D	onehdy_None; onehdá_None
hrudný_A	hrouda_None; hruď_None
zmršček_N	zmrštěk_None; zmrsk_None
keřovitý_A	keřnatý_None; křovitý_None
pastviště_N	pastvisko_None; pastva_None
vřetýnko_N	vřeteno_None; vřeténko_None
poseděníčko_N	posedění_None; posezení_None
zrnéčko_N	zrno_None; zrnečko_None
teplounko_N	teplo_None; teploučký_None
proužka_N	prouha_None; proužek_None
rumní_A	rumištní_None; rumiště_None
holička_N	holič_None; hůl_None
psát_V	písař_None; rychlopis_None
syreček_N	sýr_None; sýrec_None
světlo_D	průsvit_None; prosvítat_None
Maročan_N	Maroko_None; marocký_None
maličko_N	malinký_None; malinko_None
kopička_N	kopa_None; kopice_None
lemoun_N	lemon_None; limon_None
kvadratický_A	kvadrát_None; kvadrátní_None
Vilma_N	Vilím_None; Vilém_None
vrátečka_N	vrata_None; vrátka_None
olympický_A	Olymp_None; olympijský_None
řemének_N	řemínek_None; řemen_None
zlatinký_A	zlatičký_None; zlaťoučký_None
dobře_D	dobrý_None; zadobře_None
šesták_N	šesterák_None; šesťák_None
ptáčínek_N	pták_None; ptáček_None
rádijko_N	rádlo_None; rádio_None
kamíneček_N	kamínek_None; kámen_None
páteříček_N	páteř_None; páter_None
krčíček_N	krček_None; krk_None
strůmek_N	stromek_None; strom_None
ústrojitý_A	ústrojný_None; ústrojní_None
křamp_N	křám_None; křáp_None
vrstevný_A	vrstevní_None; vrstva_None
nadání_N	nadat_None; nadít_None
smrtička_N	smrtka_None; Smrtka_None
maličkatý_A	malý_None; malinkatý_None
sokolovský_A	Sokolovo_None; Sokolov_None
malinko_N	malinký_None; maličko_None
synthetický_A	syntetický_None; syntéza_None
kam_D	kampak_None; kámen_None
divoko_D	divoký_None; divoce_None
učitelkyně_N	učitel_None; učitelka_None
špiclík_N	špicl_None; špic_None
Jarda_N	Jarča_None; Jára_None
měsíčný_A	měsíc_None; měsíční_None
rabí_N	rabi_None; rabín_None
vějička_N	věječka_None; vějice_None
bidélko_N	bidlo_None; bidýlko_None
Šalamoun_N	Šalomoun_None; šalamoun_None
žemnička_N	žemle_None; žemně_None
znaménko_N	znamení_None; znamínko_None
Sasko_N	Sas_None; saský_None
zesprosťačet_V	zesprosťačit_None; zesprostnout_None
řiďoučce_D	řiďounký_None
úštipek_N	úštěpek_None
ovální_A	oválný_None
dunajský_A	Dunaj_None
futurální_A	futurum_None
zákolesník_N	zákolník_None
magazín_N	magacín_None
presumptivní_A	presumpce_None
vědýrko_N	vědro_None
orezivělý_A	orezavělý_None
positivní_A	pozitiv_None
záslužička_N	zásluha_None
územní_A	území_None
křemeňák_N	křemenáč_None
Hradecko_N	hradec_None
vyhajínkovat_V	vyhajat_None
tudy_D	tady_None
kapelní_A	kapela_None
jekot_N	jek_None
mol_N	namol_None
brejličky_N	brýle_None
vřesknout_V	vřískat_None
uzlovatý_A	uzlovitý_None
mělko_N	mělký_None
kamarádíček_N	kamarád_None
přepečlivý_A	pečlivý_None
podmětný_A	podmět_None
Anda_N	Anna_None
vyslaneček_N	vyslanec_None
heroický_A	héros_None
vposléze_D	vposléz_None
Žofina_N	Žofka_None
soukárna_N	sukárna_None
tranzit_N	transit_None
přehluboko_N	přehluboký_None
parátní_A	separát_None
koncesní_A	koncese_None
manžílek_N	manžel_None
subtropický_A	subtropy_None
přesnadno_D	přesnadný_None
belgičan_N	Belgičan_None
šteftík_N	šteft_None
Lotka_N	Lota_None
tábor_N	Tábor_None
synodální_A	synoda_None
křepce_D	křepký_None
ušajdat_V	ušmajdat_None
vybíjaný_A	vybíjený_None
právnička_N	právník_None
vysokanánský_A	vysokánský_None
nova_N	novum_None
Tunisan_N	Tunis_None
vdoveček_N	vdovec_None
výstelka_N	vystýlka_None
albíčko_N	album_None
říman_N	Říman_None
lovný_A	lov_None
žid_N	Žid_None
pompézní_A	pompa_None
Lidmila_N	Ludmila_None
kazisvětství_N	kazisvět_None
natrpklý_A	zatrpklý_None
teďka_D	teďky_None
Bohumír_N	Bohouš_None
zlostička_N	zlost_None
šéfovský_A	šéf_None
páteční_A	pátek_None
činoherní_A	činohra_None
ovčička_N	ovečka_None
uzené_N	uzený_None
majordom_N	majordomus_None
zatemněnec_N	zatemnělec_None
pero_N	péro_None
Horatius_N	Horác_None
odchovanka_N	odchovanec_None
potahmo_D	potažmo_None
přemnohý_A	mnohý_None
záhvozda_N	záhvozd_None
dožera_N	dožer_None
špulička_N	špulka_None
prubírovat_V	prubovat_None
přírost_N	přírůstek_None
parafín_N	parafin_None
raníčko_N	ráno_None
Mirko_N	Mírek_None
předaleký_A	daleký_None
svíčkář_N	svíčkař_None
zářivo_N	zářivý_None
úklidný_A	úklid_None
masojídek_N	masojed_None
amoniakální_A	amoniak_None
lezní_A	lezný_None
perkusní_A	perkuse_None
zadumaneček_N	zadumanec_None
vaznička_N	vaznice_None
zadarmo_D	zdarma_None
kostižerný_A	kostižer_None
koncertantní_A	koncert_None
křemenáček_N	křemenáč_None
přesmutný_A	smutný_None
prognostika_N	pranostika_None
přepodivný_A	podivný_None
vítáníčko_N	vítání_None
směnečný_A	směnka_None
žilobitný_A	žilobití_None
arteriální_A	artérie_None
Adámek_N	Adam_None
strašno_D	strašný_None
pokrevný_A	pokrevní_None
výměnice_N	výměník_None
Helča_N	Hela_None
peleton_N	peloton_None
vrátní_A	vrátný_None
kontovní_A	konto_None
ďubinka_N	ďubka_None
rýhovatý_A	rýhovitý_None
Prusko_N	Prus_None
lechtivý_A	lechtat_None
jizlivý_A	jízlivý_None
ježíšek_N	Ježíšek_None
úkonný_A	úkon_None
štemplík_N	štempl_None
Magdička_N	Magda_None
nazpátky_D	nazpět_None
jedličí_N	jedlina_None
šejch_N	šejk_None
puntíkatý_A	puntíkovaný_None
Slávek_N	Sláva_None
skromnince_D	skromňoučký_None
letohrádek_N	letohrad_None
začmudlý_A	začoudlý_None
pláštíček_N	plášť_None
procentuální_A	percentuální_None
habří_A	habroví_None
neviňoučce_D	neviňoučký_None
uškrouhnout_V	uškrouknout_None
zákonický_A	zákoník_None
vyživeníčko_N	vyživení_None
uhel_N	uhelnatý_None
psavý_A	psát_None
Michaela_N	Michael_None
vrstevní_A	vrstevný_None
vyšklebačný_A	vyšklíbačný_None
neofašistický_A	neofašismus_None
udržitel_N	udržovatel_None
miloučko_D	milounký_None
kresebný_A	kresba_None
protein_N	proteid_None
přeochotný_A	ochotný_None
žehlovna_N	žehlit_None
košilinka_N	košile_None
žihadélko_N	žihadlo_None
břicháček_N	břicháč_None
Janko_N	Janek_None
zchytrat_V	zchytřet_None
délský_A	Délos_None
lázeňský_A	lázně_None
šestiliberní_A	šestiliberka_None
přesnadný_A	snadný_None
baňčička_N	baňka_None
vřetánek_N	vřetánko_None
muhar_N	mohár_None
mlsout_N	mlsoun_None
pětka_N	pět_None
šestiměrný_A	šestiměr_None
vlákýnko_N	vlákno_None
broček_N	brok_None
voroplavební_A	voroplavba_None
učitýlek_N	učitel_None
serafín_N	seraf_None
čivní_A	čivný_None
fornýr_N	furnýr_None
prolom_N	průlom_None
karabáček_N	karabáč_None
hodinky_N	hodiny_None
jateční_A	jatečný_None
hravý_A	hrát_None
plácek_N	plac_None
řízkovnička_N	řízkovnice_None
skulpturální_A	skulptura_None
zvukoměrný_A	zvukoměr_None
příkře_D	příkrý_None
účetní_N	účet_None
mokře_D	mokrý_None
kožich_N	kožešina_None
prdnout_V	prdět_None
křám_N	křáp_None
velebno_D	velebný_None
řevnice_N	říjnice_None
Turkyně_N	Turek_None
Toskánec_N	Toskánsko_None
vojnička_N	vojna_None
štědře_D	štědrý_None
šakálek_N	šakal_None
platnýř_N	platnéř_None
mechanika_N	automechanik_None
intuitivní_A	intuice_None
zarochnout_V	zarohnout_None
zůstavek_N	zůstatek_None
divže_D	div_None
vepřové_N	vepřový_None
přízemek_N	přízemí_None
plytce_D	plytký_None
Moravěnka_N	Morava_None
pochybnůstka_N	pochybnost_None
chanson_N	šanson_None
akrobacie_N	akrobat_None
vozební_A	vozba_None
kluzce_D	kluzký_None
schůdek_N	schod_None
znovy_D	znova_None
vpodvečer_D	podvečer_None
oukrop_N	úkrop_None
výhledeček_N	výhled_None
cimprlich_A	cimfrlich_None
velce_D	velký_None
učebný_A	učební_None
helvít_N	helvet_None
přetěžký_A	těžký_None
hrdelný_A	hrdelní_None
trudno_D	trudný_None
chlejstat_V	chlístat_None
vejpůli_D	vejpůl_None
bagatelní_A	bagatela_None
prográmek_N	program_None
sluneční_A	slunce_None
předaleko_D	předaleký_None
vynálezčivý_A	vynalézavý_None
hajní_A	háj_None
tisící_A	tisíc_None
předobře_D	předobrý_None
žudérko_N	žudro_None
kalciový_A	kalcium_None
otcovražda_N	otcovrah_None
baryton_N	basbaryton_None
prvorozenectví_N	prvorozenec_None
nůsek_N	nos_None
gremiální_A	grémium_None
pětinka_N	pět_None
štipeček_N	štipec_None
hole_N	holý_None
výzdiva_N	vyzdívka_None
zezulka_N	žežulka_None
azbest_N	asbest_None
deduktivní_A	dedukce_None
smuteční_A	smutek_None
živočichopisný_A	živočichopis_None
vzkázka_N	vzkazka_None
dmuchadlo_N	dmychadlo_None
nudno_D	nudný_None
Karkulka_N	karkulka_None
bohačka_N	boháč_None
valvulární_A	valvula_None
mrznout_V	přimrznout_None
zdrojný_A	zdroj_None
žitný_A	žito_None
dobytčátko_N	dobytče_None
fyzikální_A	fysikální_None
Ukrajinec_N	Ukrajina_None
kapičku_D	kapku_None
krůvek_N	krov_None
Moskvan_N	Moskva_None
vadrle_N	vádrle_None
vdávačka_N	vdávalka_None
ethylether_N	etyléter_None
přichomejtnout_V	přichomýtnout_None
uvozdřený_A	uvozhřený_None
výstřel_N	výstřelek_None
anexní_A	anexe_None
Otakar_N	Otokar_None
syringa_N	syrinx_None
celestin_A	Celestin_None
ústrojní_A	ústrojný_None
rabi_N	rabín_None
rezavý_A	rezivý_None
heslíčko_N	heslo_None
spíž_N	špíž_None
smradit_V	smradlavý_None
ajznpoňák_N	ajznboňák_None
Aurora_N	aurora_None
kraťoučko_D	kraťounký_None
pankreatický_A	pankreas_None
pusto_D	pustý_None
ponuře_D	ponurý_None
luciper_N	Lucifer_None
skrýše_N	skrýš_None
modální_A	modus_None
procentíčko_N	procento_None
otcovražedný_A	otcovrah_None
Kristýna_N	Kristina_None
prosný_A	proso_None
houfeček_N	houf_None
ztamtad_D	ztamtud_None
šavlenka_N	šavle_None
prostředí_N	tajnost_None
prakticírovat_V	praktikovat_None
inventární_A	inventář_None
škvrňátko_N	škvrně_None
žebrovatý_A	žebrovitý_None
přímluvčí_N	přímluvce_None
empir_N	empír_None
vyskeřit_V	vyškeřit_None
durativní_A	durativum_None
paradoxon_N	paradox_None
valášek_N	valach_None
Zdenička_N	Zdeňka_None
dyzentérie_N	dysenterie_None
jagellovský_A	jagellonský_None
vašnůstka_N	vašnosta_None
lhotský_A	Lhota_None
teplo_D	teplý_None
lesný_A	lesní_None
chocholačka_N	chocholáč_None
Barunka_N	Bára_None
vypětí_N	vypnout_None
boční_A	bočný_None
otépka_N	otýpka_None
rozoumek_N	rozum_None
výparoměrný_A	výparoměr_None
čajní_A	čajný_None
rozžínat_V	rozžíhat_None
slabounce_D	slaboučký_None
kulaťoučce_D	kulaťounký_None
širo_D	širý_None
šupka_N	slupka_None
plavečky_N	plavky_None
veslíčko_N	veslo_None
tenoučce_D	tenoučký_None
geneze_N	genese_None
Horňák_N	horňák_None
welterový_A	velterový_None
jedvaže_D	jedva_None
sklínka_N	sklenice_None
glagolice_N	hlaholice_None
mazaneček_N	mazanec_None
sobeček_N	sobec_None
chaldejský_A	Chaldea_None
bochánek_N	bochan_None
zavýučný_A	zavýuční_None
pakfong_N	pakfon_None
brlenka_N	brlina_None
pánbíček_N	pánbůh_None
žvástat_V	žvastat_None
Voršila_N	Uršula_None
Jano_N	Jan_None
vyšťuchovat_V	vyšťouchat_None
sršní_A	sršeň_None
soumračno_N	soumračný_None
podpatek_N	opatek_None
poema_N	poéma_None
gemma_N	gema_None
zakabonělý_A	zakaboněný_None
čísélko_N	číslo_None
perný_A	pernatý_None
višňovička_N	višňovka_None
tvrďas_N	tvrďák_None
anaerobní_A	anaerob_None
trandat_V	trajdat_None
věrozvěstný_A	věrozvěst_None
zlatečka_N	zlatka_None
Janovan_N	Janov_None
příjemno_D	příjemný_None
řinčet_V	drčet_None
zřivý_A	zřít_None
lucifer_N	Lucifer_None
látečka_N	látka_None
šmáknout_V	šmakat_None
tenounce_D	tenoučký_None
Alsasan_N	Alsasko_None
zátišíčko_N	zátiší_None
zápasní_A	zápasivý_None
účeloslovný_A	účelosloví_None
klíšťátko_N	klíště_None
slejvat_V	slévat_None
bukvička_N	bukvice_None
zpyšnět_V	zpýchnout_None
Vlastislav_N	Vlasta_None
profylakční_A	profylaxe_None
štípek_N	štěp_None
kutikulární_A	kutikula_None
jilský_A	Jiljí_None
šilhat_V	pošilhávat_None
hrádek_N	hrad_None
horkovzdušný_A	horký_None
meningeální_A	meninga_None
kratince_D	kratinký_None
kyrilice_N	cyrilice_None
sideróza_N	siderosa_None
slunečný_A	slunce_None
zárazný_A	záraz_None
bystrozraký_A	bystrozrak_None
přemoudře_D	přemoudrý_None
zásobní_A	zásoba_None
Čerkeska_N	Čerkes_None
vzpouřička_N	vzpoura_None
úzko_N	úzký_None
skrupulózní_A	skrupule_None
vyhledavatel_N	vyhledávatel_None
povětšinou_D	povětšině_None
tvarůžek_N	tvaroh_None
teďky_D	teď_None
Turkménie_N	Turkmen_None
pitomůstka_N	pitomost_None
vichřivo_D	vichřivý_None
tremp_N	tramp_None
trávníček_N	trávník_None
kationt_N	kation_None
Trapezunt_N	Trabzon_None
pávík_N	páv_None
úložní_A	úložný_None
kolínský_A	Kolín_None
mozolovitý_A	mozolnatý_None
pulírovat_V	polírovat_None
chrysantéma_N	chryzantéma_None
pokládek_N	poklad_None
bohovědec_N	bohověda_None
lásečka_N	láska_None
žingle_N	žengle_None
vltavan_N	Vltavan_None
zase_D	zas_None
předlouhý_A	dlouhý_None
upínač_N	rychloupínací_None
zobecnět_V	zpovšechnět_None
husto_N	hustý_None
hřbitůvek_N	hřbitov_None
záhrobní_A	záhrobí_None
nákupce_N	nákupčí_None
půlměsíční_A	půlměsíc_None
jarmareční_A	jarmark_None
zelný_A	zelí_None
Oto_N	Ota_None
ohmat_N	pohmat_None
berní_A	berně_None
stíneček_N	stín_None
stárkyně_N	stárek_None
Petra_N	Petr_None
výtržka_N	výtržek_None
Mefistofeles_N	Mefisto_None
kastrůlek_N	kastrol_None
prkýnečko_N	prkýnko_None
Bretonec_N	Bretagne_None
Jaromíra_N	Jaromír_None
strofický_A	strofa_None
objektivistický_A	objektivista_None
dřípatý_A	dřípený_None
stanoviště_N	hlediště_None
mníšek_N	mnich_None
černozemný_A	černozem_None
terasa_N	taras_None
řasný_A	řasa_None
spáleninka_N	spálenina_None
navždycky_D	navždy_None
šohaj_N	šuhaj_None
experimentální_A	experiment_None
kadaverózní_A	kadaverosní_None
bocháneček_N	bochánek_None
bahnička_N	bahnice_None
šus_N	šús_None
střížek_N	stříž_None
Trójan_N	Trója_None
listíčko_N	listí_None
nadreálný_A	nadreální_None
triviální_A	trivium_None
jednolampovka_N	jednolampový_None
obezřetný_A	obezřelý_None
zápisný_A	zápisní_None
masařka_N	masař_None
prorokyně_N	prorok_None
čásek_N	čas_None
liliputánství_N	liliputánský_None
Jindřiška_N	Jindřich_None
Pepča_N	Pepa_None
výprosný_A	výpros_None
tritón_N	Tritón_None
pouštní_A	poušť_None
ideálný_A	ideální_None
zrnovačka_N	zrnovák_None
desetitisící_A	desetitisíce_None
šrotýř_N	šrot_None
pocestný_N	pocestní_None
klid_N	poklid_None
úřadník_N	úředník_None
platejs_N	platýs_None
beztvárný_A	beztvarý_None
lávka_N	lavice_None
široko_N	široký_None
přísunný_A	přísun_None
otrokyně_N	otrok_None
zoftíček_N	zoft_None
kužílek_N	kužel_None
Waltrovka_N	waltrovka_None
valutární_A	valuta_None
zlatohávý_A	zlatoháv_None
Horvat_N	Charvát_None
hádek_N	had_None
převysoko_D	převysoký_None
jupička_N	jupka_None
zpoly_D	zpola_None
krásňoučký_A	krásňounký_None
přehořký_A	hořký_None
manierismus_N	manýrismus_None
šťouchaneček_N	šťuchanec_None
neandertálec_N	Neandertal_None
zasilatelský_A	zasílatel_None
Otokar_N	Otakar_None
Bukovina_N	bukovina_None
hadýrek_N	hadr_None
štrúzok_N	štrozok_None
sávský_A	Sáva_None
Rózička_N	Rozina_None
črtička_N	črta_None
vychlejstnout_V	vychlístnout_None
Junona_N	Juno_None
inflexní_A	inflexe_None
konzistorní_A	konsistoř_None
sněžný_A	sníh_None
kašlíček_N	kašel_None
bydleníčko_N	bydlení_None
šufánek_N	šufan_None
peršan_N	Peršan_None
výprosa_N	výpros_None
smrticí_A	usmrcení_None
vykukovat_V	vykouknout_None
třída_N	střída_None
kožišina_N	kožešina_None
zástupek_N	zástup_None
kostelnička_N	kostelnice_None
ztělesněnec_N	ztělesnitel_None
transylvánský_A	Transylvánie_None
parazitární_A	parasitární_None
harmonička_N	harmonika_None
štědrovka_N	štědrovnice_None
zhrblý_A	zhrbatělý_None
ďoubal_N	ďouba_None
kanada_N	Kanada_None
afrikán_N	Afrikán_None
čubinka_N	čuba_None
všivajzna_N	všivárna_None
skýz_N	škýz_None
troubera_N	trumbera_None
prášek_N	prach_None
exantematický_A	exantém_None
zřítelnička_N	zřítelnice_None
žebračkyně_N	žebračka_None
evolucionistický_A	evolucionista_None
oblačno_N	oblačný_None
zvláštnůstka_N	zvláštnost_None
ulejvanda_N	ulejvárna_None
Záhřeban_N	Záhřeb_None
těžce_D	těžký_None
uzílek_N	uzel_None
šeredno_D	šeredný_None
zonální_A	zóna_None
kamp_N	camp_None
dispenzní_A	dispens_None
klot_N	glot_None
chlív_N	chlév_None
sršáň_N	sršán_None
vřetenatý_A	vřetenovitý_None
jízek_N	jez_None
mula_N	mul_None
farizeus_N	farizej_None
boulevard_N	bulvár_None
kompresní_A	komprese_None
štuka_N	štuk_None
mysterijní_A	mystérium_None
slovný_A	slovní_None
stélé_N	stéla_None
volňoučce_D	volňounký_None
tenoulince_D	tenoučký_None
Katinka_N	Katy_None
slovakistika_N	slovenistika_None
obcházka_N	obchůzka_None
sanitárka_N	sanitář_None
žendarm_N	žandarm_None
upláknout_V	upláchnout_None
neboze_D	nebohý_None
galilejský_A	Galilea_None
zpravodavce_N	zpravodaj_None
honební_A	honba_None
prostřih_N	průstřih_None
všudybylý_A	všudybyl_None
Jehova_N	Jahve_None
choutka_N	chuť_None
šalamoun_N	Šalomoun_None
vyzývačný_A	vyzývavý_None
přetěžko_D	přetěžký_None
Zástrkov_N	Zastrkov_None
bledničkovitý_A	bledničkový_None
družstevní_A	družstvo_None
červenomodře_D	červenomodrý_None
prosvit_N	průsvit_None
Ještědsko_N	Ještěd_None
modročerno_N	modročerný_None
ozembouch_N	vozembouch_None
kubánský_A	Kuba_None
včírek_N	včerejšek_None
chuchelský_A	Chuchle_None
špatnůstka_N	špatnost_None
Emanuel_N	Ema_None
vaječný_A	vejce_None
zlatoskvoucí_A	zlatoskvělý_None
rozkvět_N	výkvět_None
rekyně_N	rek_None
výučný_A	výuční_None
komisar_N	komisař_None
bandůrek_N	bandor_None
červí_A	červ_None
zpovzdálí_D	zpozdáli_None
volnoběžka_N	volnoběh_None
vinout_V	zavinout_None
reakčník_N	reakcionář_None
gotajský_A	Gotha_None
pupilární_A	pupila_None
dolézavý_A	dolízavý_None
včil_D	včíl_None
kantonální_A	kanton_None
kališní_A	kalich_None
konstruktivistický_A	konstruktivista_None
výškopisný_A	výškopis_None
rekognoskativní_A	rekognoskace_None
filumenistický_A	filumenista_None
terminoložka_N	terminolog_None
obolus_N	obol_None
Vojtěška_N	Vojtěch_None
odiv_N	obdiv_None
mdlo_D	mdlý_None
Uzbekistán_N	Uzbek_None
čucha_N	čúcha_None
nedělní_A	neděle_None
přídní_A	příďový_None
miocenní_A	miocén_None
Vašík_N	Vašek_None
ostatky_N	ostatek_None
sumerský_A	Sumer_None
Anastázie_N	Stáza_None
čistítko_N	čistidlo_None
Athéňan_N	Atény_None
Kréťan_N	Kréta_None
podvůdek_N	podvod_None
rumeček_N	rum_None
ledaskam_D	ledakam_None
Bavořan_N	Bavorsko_None
rabbi_N	rabín_None
žárovčička_N	žárovka_None
telemarský_A	telemark_None
rorýsí_A	rorýs_None
mravenčí_A	mravenec_None
žežhulinka_N	žežulka_None
usedlůstka_N	usedlost_None
saniterák_N	saniťák_None
zápolní_A	zápolí_None
vykeťasovat_V	vykeťasit_None
křižáček_N	křižák_None
zvyklůstka_N	zvyklost_None
Tripolsko_N	Tripolis_None
koverkotový_A	kovrkot_None
konévka_N	konev_None
jógí_N	jogín_None
Durynsko_N	Durynk_None
šiplavý_A	šeplavý_None
odstavný_A	odstavování_None
nocturno_N	nokturno_None
veselohříčka_N	veselohra_None
zdáníčko_D	zdání_None
průstup_N	prostup_None
naživu_D	živý_None
Est_N	Estonec_None
responsoriální_A	responsorium_None
hřebílko_N	hřbílko_None
Libyjec_N	Libye_None
žrádýlko_N	žrádlo_None
glot_N	klot_None
karlistický_A	karlista_None
vřeskot_N	vřískot_None
zajíškovat_V	zajíšit_None
šlechtična_N	šlechtic_None
zádveřní_A	zádveří_None
půdorysna_N	půdorys_None
podezřivý_A	podezřívavý_None
pomůcka_N	pomoc_None
programatický_A	program_None
Davídek_N	David_None
Gall_N	Gal_None
pachtéř_N	pachtýř_None
safesový_N	safe_None
janek_N	Janek_None
vydrovina_N	vydřina_None
narcis_N	Narcis_None
útají_N	útaj_None
dalece_D	daleký_None
semka_D	sem_None
provždycky_D	provždy_None
zelenomodře_D	zelenomodrý_None
oušlapek_N	ošlapek_None
potomkyně_N	potomek_None
akordní_A	akord_None
držební_A	držba_None
Žižkovák_N	Žižkov_None
známečka_N	známka_None
artéský_A	Artois_None
přednostenský_A	přednosta_None
japonka_N	Japonka_None
vyšklebavý_A	výšklebný_None
rozchodný_A	rozchod_None
Vojtíšek_N	Vojtěch_None
vizuální_A	visuální_None
vařeka_N	vařečka_None
plastikace_N	plastifikace_None
blouznílek_N	blouznil_None
Pavla_N	Pavel_None
ogárek_N	ogar_None
veltruský_A	Veltrusy_None
chlebodárný_A	chlebodárce_None
pštrosí_A	pštros_None
Roentgen_N	rentgen_None
čisťounce_D	čisťounký_None
protokolární_A	protokol_None
Němce_N	Němec_None
židověnka_N	Žid_None
kovářík_N	kovář_None
pajdák_N	pajda_None
orangutánek_N	orangutan_None
obskurantní_A	obskurant_None
cyklický_A	cyklus_None
dělobuch_N	dělbuch_None
bianko_A	bianco_None
tarantule_N	tarantela_None
mýtský_A	mýto_None
Semafor_N	semafor_None
závdanek_N	závdavek_None
květníček_N	květník_None
tajemnůstkář_N	tajnůstkář_None
zemčátko_N	zemče_None
uvážlivý_A	uvážený_None
zvnitra_D	zvnitřka_None
vydřina_N	vydrovina_None
cechovna_N	cáchovna_None
přeskvostný_A	skvostný_None
skřítek_N	skřet_None
koprofagie_N	koprofág_None
kmotřeneček_N	kmotřenec_None
adjektivní_A	adjektivum_None
ochomejtat_V	ochomýtat_None
smrt_N	smrtonoš_None
zrcadelný_A	zrcadelní_None
stanova_N	stanovy_None
okcipitální_A	okcidentální_None
umyvadýlko_N	umyvadlo_None
fénický_A	Fénicie_None
půhonný_A	půhon_None
vydrezovat_V	vydrezírovat_None
groteskno_N	groteskní_None
veseloherník_N	veselohra_None
madráský_A	Madrás_None
mělce_D	mělký_None
pijačka_N	piják_None
celestýn_N	Celestin_None
vážní_A	vážný_None
vojevoda_N	vojvoda_None
jachetní_A	jachta_None
dramaturgyně_N	dramaturg_None
útržkovitý_A	útržkový_None
filátko_N	filé_None
libidinózní_A	libido_None
povznešený_A	povznesený_None
křík_N	keř_None
nosítka_N	nosítko_None
kariérnictví_N	kariérník_None
čepovní_A	čep_None
normanský_A	Norman_None
vejměničný_A	výměnický_None
světlounce_D	světlounký_None
zataženo_D	zatažený_None
zabylstvo_N	zabylství_None
zádečka_N	záda_None
rachitida_N	rachitis_None
událostička_N	událost_None
zobánek_N	zoban_None
trusek_N	trus_None
kulíšek_N	kulich_None
lichevní_A	lichva_None
zálibůstka_N	záliba_None
chmelnička_N	chmelnice_None
okuláry_N	okulár_None
žandarmeristický_A	žandarmerie_None
Kujebák_N	Kujeba_None
Valašsko_N	Valach_None
ukrutanánský_A	ukrutánský_None
Rakušák_N	Rakousko_None
řádek_N	řad_None
hloupoučce_D	hloupounký_None
vychovanka_N	vychovanec_None
mrazno_D	mrazný_None
rozsoška_N	rozsocha_None
skóre_N	skór_None
prokop_N	průkop_None
budget_N	budžet_None
vlašťověnka_N	vlaštovka_None
vampora_N	vampola_None
vědárko_N	vědro_None
egalizace_N	egalisace_None
vyslipovat_V	vyslípat_None
jemňoučce_D	jemňounký_None
Zdenčička_N	Zdeňka_None
skelný_A	sklo_None
podkovička_N	podkova_None
žblabunit_V	žblabonit_None
Přemyslovna_N	Přemyslovec_None
vblízku_D	vblízce_None
Arménie_N	Armén_None
lástička_N	láska_None
lebeční_A	lebka_None
přesladký_A	sladký_None
stimul_N	stimulus_None
třicetiletý_A	třicetiletí_None
úpatní_A	úpatí_None
tonzura_N	tonsura_None
škrhola_N	Škrhola_None
pochrupovat_V	pochrupávat_None
štruplátko_N	štruple_None
hélium_N	helium_None
šrank_N	šraňk_None
slaboulince_D	slaboulinký_None
sodoma_N	Sodoma_None
bakteriální_A	bakterie_None
voděnka_N	voda_None
bezvětrno_N	bezvětrný_None
ekvatoriální_A	ekvátor_None
čekánek_N	čakan_None
fondovní_A	fond_None
rašelinisko_N	rašeliniště_None
popošupovat_V	popošoupnout_None
tichounce_D	tichounký_None
vráskovatý_A	vráskovitý_None
figurační_A	figurace_None
sajka_N	sajga_None
auktor_N	autor_None
skřehotat_V	skřečet_None
Vinohrady_N	vinohrad_None
řiďoučký_A	řiďounký_None
stojka_N	stovka_None
vinný_A	víno_None
bouřlivo_D	bouřlivý_None
přítlačný_A	přitlačování_None
čmáranina_N	čmáranice_None
existencialistický_A	existencialista_None
vilička_N	vila_None
háčkový_A	háček_None
zajoch_N	zajíc_None
výhončlivý_A	výhončivý_None
hnedky_D	hned_None
kačírek_N	kačer_None
oborávka_N	oorávka_None
Jakoubek_N	Jakub_None
úzkostno_D	úzkostný_None
šrůtek_N	šrůtka_None
škvoreček_N	škvor_None
teritoriální_A	teritorium_None
citeček_N	cit_None
honzík_N	Honza_None
Kubíček_N	Kubík_None
žárovečka_N	žárovka_None
vochtr_N	vechtr_None
dlužní_A	dluh_None
zásvětní_A	zásvětí_None
traktůrek_N	traktor_None
žrádelní_A	žrádlo_None
šance_N	všanc_None
špinka_N	špína_None
štěrkovisko_N	štěrkoviště_None
obryně_N	obr_None
hrdelní_A	hrdlo_None
vždycky_D	vždy_None
peruť_N	peroutka_None
vesenný_A	vesna_None
podvlíkačky_N	podvlékačky_None
smrádek_N	smrad_None
šukálek_N	šukal_None
šediveček_N	šedivec_None
utrháček_N	utrhač_None
vzdělanstvo_N	vzdělanství_None
přísavný_A	přisání_None
sanktuář_N	sanktuárium_None
vysoká_N	vysoký_None
vršek_N	vrch_None
strejka_N	strejda_None
Velkobrit_N	Velká_None
uncia_N	unce_None
tělíčko_N	tělo_None
Vilík_N	Vilda_None
přesypný_A	přesypávání_None
Janošík_N	Jánoš_None
prohlídka_N	přehlídka_None
vampýr_N	vamp_None
porost_N	porostlina_None
turner_N	turnér_None
kmotra_N	kmotr_None
Mireček_N	Mírek_None
průvlečný_A	provlékání_None
dombra_N	domra_None
šipka_N	šíp_None
šifrér_N	šifrant_None
mrzce_D	mrzký_None
drobounký_A	drobný_None
zpohanilý_A	zpohanštělý_None
perychta_N	perchta_None
kolegiátní_A	kolegium_None
nepomíjejícnost_N	nepomíjivý_None
zájmíček_N	zájem_None
spektrální_A	spektrum_None
vašek_N	Vašek_None
frakcionářství_N	frakcionářský_None
borka_N	borek_None
Gabriela_N	Gabriel_None
padesátihaléř_N	padesátihalíř_None
Tyrolák_N	Tyrolsko_None
vestálský_A	vestálka_None
fyzický_A	fysický_None
čmelík_N	čmel_None
Vilém_N	Vilím_None
široce_D	široký_None
nežid_N	Nežid_None
Antichrist_N	Antikrist_None
pořízek_N	poříz_None
nárůdek_N	národ_None
muzikoložka_N	muzikolog_None
tetanus_N	tetan_None
zahrádečný_A	zahrádka_None
valdhornista_N	valdhorna_None
Jaromír_N	Jára_None
madras_N	Madrás_None
špýchar_N	špejchar_None
zákampíčko_N	zákampí_None
Řipsko_N	Říp_None
převelice_D	převeliký_None
lichtenštejnský_A	Lichtenštejnsko_None
pohostinský_A	pohostinný_None
závidný_A	záviděníhodný_None
vzdálina_N	vzdálenina_None
huňáček_N	huňáč_None
zlatozvučný_A	zlatozvuký_None
zváhnout_V	váhnout_None
letoucí_A	léto_None
kolonialistický_A	kolonialista_None
pangejt_N	panket_None
odúmrtní_A	odúmrť_None
chmátnout_V	chmatat_None
nepamětno_D	nepamětný_None
svažný_A	svážný_None
Barbora_N	Bára_None
bodře_D	bodrý_None
slide_N	slajd_None
osmihodinný_A	osmihodinový_None
děvčička_N	děvčice_None
mediální_A	médium_None
zlehoučka_D	zlehýnka_None
džentlmen_N	gentleman_None
převeliký_A	velký_None
neviňounký_A	neviňoučký_None
klokaní_A	klokan_None
vousík_N	vous_None
státeček_N	stát_None
hrozno_D	hrozný_None
žebírko_N	žebro_None
símě_N	semeno_None
zbrojniště_N	zbrojiště_None
nemocenské_N	nemocenský_None
ulcerózní_A	ulcerosní_None
vejmluvník_N	výmluvník_None
záhlavek_N	záhlavec_None
úhořík_N	úhoř_None
matinka_N	matka_None
trnečka_N	trnka_None
roštíčko_N	roští_None
aluviální_A	aluvium_None
zvěřinečka_N	zvěřina_None
Hellada_N	Hellas_None
krajinomalebný_A	krajinomalba_None
žvanílek_N	žvanil_None
roztomilounký_A	roztomiloučký_None
čočička_N	čočka_None
kuchyňka_N	kuchyně_None
ženíšek_N	ženich_None
nadvládní_A	návladní_None
útvarný_A	útvar_None
ethylnatý_A	etylnatý_None
ždibánek_N	ždibec_None
řízeníčko_N	řízení_None
krobián_N	grobián_None
správný_A	rovný_None
bakterióza_N	bakteriosa_None
slámečka_N	sláma_None
vložečka_N	vložka_None
anodicky_D	anodický_None
veleslavínský_A	Veleslavín_None
kdeže_D	kdež_None
máselný_A	máslo_None
bazický_A	basický_None
malinkatý_A	maličkatý_None
umělůstka_N	umělost_None
pernikář_N	perníkář_None
mžik_N	mžitka_None
humusovitý_A	humus_None
skokánek_N	skokan_None
zmládí_D	zmladu_None
zálezelský_A	Zálezly_None
veveří_A	veverčí_None
záhumenec_N	záhumeň_None
čtvrtletní_A	čtvrtletí_None
kapku_D	kapánek_None
balzamínka_N	balzamína_None
čtvrtroční_A	čtvrtrok_None
zpomaloučka_D	zpomalounka_None
tichošlápský_A	tichošlápek_None
Polsko_N	Polák_None
venuše_N	Venuše_None
nelzon_N	nelson_None
deštný_A	déšť_None
opřít_V	rozepřít_None
vyoslit_V	vyvoslit_None
Brok_N	brok_None
půlměsíčkovitý_A	půlměsíc_None
zvětšit_V	zveličit_None
rozepatý_A	rozepnout_None
otýpka_N	otep_None
peer_N	pair_None
ponuro_D	ponurý_None
řimbuk_N	řimbuch_None
bazilián_N	basilián_None
viska_N	whisky_None
zvnitřku_D	zvnitřka_None
vztažný_A	vztah_None
dehydrace_N	dehydratace_None
legie_N	legion_None
řehtot_N	řehot_None
řezníček_N	řezník_None
Malostraňačka_N	Malostraňák_None
vidličnatý_A	vidlicovitý_None
škrabálek_N	škrabal_None
Litice_N	lítice_None
oddílek_N	oddíl_None
tepelný_A	teplo_None
rebel_N	rebelant_None
vejměničit_V	výměničit_None
zádíčka_N	záda_None
štuclík_N	štucl_None
podloubíčko_N	podloubí_None
zádvorský_A	zádvorní_None
činěnice_N	čina_None
usapovat_V	usápnout_None
vlýsek_N	vlys_None
kmotřík_N	kmotr_None
pirožek_N	piroh_None
zuzka_N	Zuza_None
jatečný_A	jatky_None
májíček_N	máj_None
orchestřík_N	orchestr_None
čisťounko_D	čisťounký_None
potřebí_D	potřeba_None
mikulášský_A	Mikuláš_None
Kazaška_N	Kazach_None
vývrať_N	vývrat_None
povahopisný_A	povahopis_None
habrůvecký_A	Habrůvka_None
Alžběta_N	Běta_None
monetární_A	moneta_None
vysokánsko_D	vysokánský_None
dezinfektor_N	desinfektor_None
preparativní_A	preparace_None
přírůst_N	přírůstek_None
vrbovisko_N	vrbisko_None
ďoučátko_N	ďouče_None
ordnér_N	ordner_None
výkřik_N	vzkřik_None
vyraženíčko_N	vyražení_None
zrcadlíčko_N	zrcadlo_None
vojačiště_N	vojačisko_None
divizionář_N	divisionář_None
Savojan_N	Savojsko_None
loterní_A	loterie_None
Polka_N	Polák_None
ošoust_N	ošusta_None
záslušný_A	zaslušný_None
veseloučko_D	veseloučký_None
sádelňák_N	sádelník_None
forzato_D	forzando_None
flaše_N	flaška_None
prudce_D	prudký_None
vysíkat_V	vysekávat_None
sanatorní_A	sanatorium_None
zbahnilý_A	zbahnělý_None
vachtmajstr_N	vachmistr_None
trestněprávní_A	trestní_None
vokalický_A	vokál_None
žlutomodře_D	žlutomodrý_None
vůčihledný_A	vůčihledý_None
loubek_N	lub_None
pisánský_A	Pisa_None
tříročí_N	tříroček_None
vírný_A	vír_None
veselový_A	veselí_None
Ota_N	Oto_None
věrolomství_N	věrolomný_None
eman_N	Eman_None
princátko_N	princ_None
tuzex_N	Tuzex_None
šplechtot_N	šplíchot_None
úlehlina_N	ulehlina_None
kynismus_N	cynismus_None
underwoodka_N	underwood_None
odevřít_V	otevřít_None
živnostenský_A	živnost_None
zestrejcovatět_V	zestrýcovatět_None
slzivý_A	slzavý_None
tarbúš_N	tarbuš_None
ženc_N	žnec_None
plískavý_A	plískat_None
zánártní_A	zánártí_None
obstarožný_A	obstarožní_None
Sněžka_N	sněžka_None
znak_N	naznak_None
rutyka_N	rotyka_None
kurevský_A	kurva_None
výdělečný_A	výdělek_None
koňař_N	koňák_None
bižuterní_A	bižutérie_None
existencionální_A	existenciální_None
kopaneček_N	kopanec_None
trop_D	trap_None
manichejský_A	manichejec_None
bělounce_D	bělounký_None
lešeňový_A	lešení_None
jagellonský_A	Jagello_None
řebříček_N	žebříček_None
zakeťasovat_V	zakeťasit_None
fajfkař_N	fajfkář_None
fatranský_A	Fatra_None
moskvič_N	Moskvič_None
Kapsko_N	kapský_None
mazavý_A	mazat_None
fabriční_A	fabrika_None
předkomůrka_N	předkomora_None
lemůvka_N	lemovka_None
vlahoučko_D	vlahoučký_None
zpolehounku_D	zpolehounka_None
ševčík_N	švec_None
Husinec_N	husinec_None
čikóš_N	čikoš_None
griliáž_N	griláž_None
obroučka_N	obruč_None
fantazmagorie_N	fantasmagorie_None
Peruánec_N	Peru_None
očihovat_V	očíhnout_None
záličný_A	zálik_None
amor_N	Amor_None
věchýtek_N	věchet_None
parmazán_N	parmezán_None
pluška_N	plucha_None
Loket_N	loket_None
žitko_N	žito_None
křídelní_A	křídlo_None
vyžíranda_N	vyžírka_None
srabárna_N	srabařina_None
bezmezno_N	bezmezný_None
dávný_A	odedávna_None
víska_N	ves_None
jednovrstevný_A	jednovrstvý_None
ambroziánský_A	ambrosiánský_None
sladce_D	sladký_None
šoltys_N	šolta_None
micka_N	míca_None
indián_N	Indián_None
námezdný_A	námezdní_None
hloupounký_A	hloupý_None
Jarča_N	Jára_None
klášteříček_N	klášter_None
nadace_N	nadání_None
přeradostný_A	radostný_None
klopna_N	klopa_None
vsazka_N	vsadka_None
víníčko_N	víno_None
kaleidoskopický_A	kaleidoskop_None
Eleonora_N	Ela_None
podíleček_N	podíl_None
vyšmaťchat_V	vyšmaťhat_None
litoměřický_A	Litoměřice_None
Maruna_N	Maruše_None
kraťounko_D	kraťounký_None
Jihočeška_N	Jihočech_None
výjimka_N	vyjiskřování_None
sukénko_N	sukno_None
zákupný_A	zákupní_None
čtverečný_A	čtverec_None
hned_D	hnedle_None
zabaranit_V	zaberanit_None
zdrava_N	strava_None
kancelářička_N	kancelář_None
desertní_A	dezert_None
plácanice_N	plácanina_None
skrotální_A	skrotum_None
olejíček_N	olej_None
Márynka_N	Maryna_None
zvolnička_D	zvolninka_None
měkoučce_D	měkounký_None
spálenisko_N	spáleniště_None
perový_A	pero_None
boudka_N	bouda_None
vlásinka_N	vlasina_None
cukřík_N	cukr_None
misogynie_N	misogyn_None
povalečný_A	povalečský_None
outěžek_N	útěžek_None
mejdlíčko_N	mýdlo_None
substantivní_A	substantivum_None
místo_N	pustota_None
titán_N	Titán_None
odděleníčko_N	oddělení_None
dědáček_N	děd_None
záhumenní_A	záhumní_None
augmentativní_A	augmentativum_None
hříšek_N	hřích_None
Turkmenistán_N	Turkmen_None
věrověst_N	věrozvěst_None
závětní_A	závěť_None
kladka_N	kláda_None
jesenní_A	jeseň_None
výdunek_N	výdumek_None
pubertální_A	puberta_None
pošeptmo_D	pošeptmu_None
sbírčička_N	sbírka_None
zauzlenina_N	zauzlina_None
tibet_N	Tibet_None
váhař_N	vahař_None
Vídeňan_N	Vídeň_None
estetička_N	estetik_None
lůžko_N	lože_None
sochat_V	sochařit_None
špejchárek_N	špejchar_None
vraščitý_A	vráščitý_None
pomalounku_D	pomaloučku_None
Brňan_N	Brno_None
kozle_N	kůzle_None
Záhoří_N	záhoří_None
Bosňačka_N	Bosňák_None
paladýn_N	paladin_None
brucelóza_N	brucelosa_None
viktorie_N	Viktorie_None
hrobkovací_A	hrůbkovací_None
balický_A	balík_None
deštivo_D	deštivý_None
mírno_D	mírný_None
fangle_N	fángle_None
krakorec_N	krákorec_None
amnestijní_A	amnestie_None
hrášek_N	hrách_None
španěl_N	Španěl_None
písmenka_N	písmeno_None
prvopočáteční_A	prvopočátek_None
žirafečka_N	žirafa_None
supremacie_N	supremace_None
pandektní_A	pandekty_None
zďubat_V	zďobat_None
neshledaná_N	shledaná_None
viřtlička_N	viřtle_None
placentární_A	placenta_None
dávnověký_A	dávnověk_None
madame_N	madam_None
třesavý_A	třást_None
Tománek_N	Toman_None
Rakušan_N	Rakousko_None
větrnička_N	větrnice_None
Zdenčinka_N	Zdeňka_None
pleurální_A	pleura_None
zaškviknout_V	zaškvěknout_None
baborák_N	bavorák_None
klidno_D	klidný_None
kyblík_N	kýbl_None
marodovat_V	marodit_None
bakule_N	bakula_None
ulnární_A	ulna_None
folikulární_A	folikul_None
ústředivý_A	ustředit_None
Venca_N	Véna_None
ořešník_N	ořešák_None
angličan_N	Angličan_None
Miládka_N	Milada_None
voluntaristický_A	voluntarista_None
podrážečka_N	podrážka_None
prima_D	primisima_None
rustikální_A	rustikál_None
zhrda_D	zhrdání_None
damašek_N	Damašek_None
uměníčko_N	umění_None
amalgám_N	amalgam_None
mínium_N	minium_None
tiský_A	Tisa_None
litříček_N	litr_None
řeholní_A	řehole_None
neutrální_A	neutrum_None
záhorní_A	záhorský_None
uzdravit_V	pozdravit_None
maliličký_A	malý_None
žbrunda_N	žbrynda_None
Ludmila_N	Lidmila_None
soldo_N	sold_None
Kalkuta_N	Kalkata_None
dopolovic_D	dopola_None
šikmolícní_A	šikmolící_None
tunýlek_N	tunel_None
Bohumíra_N	Bohumír_None
vlastnůstka_N	vlastnost_None
rušno_D	rušný_None
pooperativní_A	pooperační_None
Stanislávek_N	Stanislav_None
vyhrůžka_N	výhrůžka_None
bolestínek_N	bolestín_None
Bretaň_N	Bretagne_None
bezhlesný_A	bezhlesý_None
zabednilec_N	zabedněnec_None
třebas_D	třeba_None
chrtí_A	chrt_None
briskní_A	bryskní_None
vykoulit_V	vykulit_None
zálesačka_N	zálesák_None
šestka_N	šesták_None
šakalík_N	šakal_None
perníček_N	perník_None
lánský_A	Lány_None
Vlastislava_N	Vlastislav_None
čajný_A	čaj_None
Kananejec_N	Kanaán_None
napatý_A	napjatý_None
ožera_N	obžera_None
úštěpný_A	uštipný_None
záhybovatý_A	záhybovitý_None
Německo_N	Němec_None
cejcha_N	cícha_None
skromničce_D	skromňoučký_None
bahenní_A	bahno_None
konfederativní_A	konfederace_None
omlouvavý_A	omlouvat_None
chuť_N	všehochuť_None
ukolíbavý_A	ukolébavý_None
korporativistický_A	korporativismus_None
kraťoučký_A	kraťounký_None
tracheální_A	trachea_None
brabec_N	vrabec_None
jednopohlavní_A	jednopohlavný_None
půlkolečko_N	půlkolo_None
čtvrtička_N	čtvrtka_None
knockout_N	knokaut_None
punkevní_A	Punkva_None
urinózní_A	urin_None
menáž_N	mináž_None
hraběcí_A	hrabě_None
řemenovitý_A	řemenitý_None
čuchat_V	čichat_None
šachetní_A	šachta_None
Štajeračka_N	Štajerák_None
sémě_N	semeno_None
perský_A	Persie_None
zvučno_D	zvučný_None
vorvaňovina_N	vorvanina_None
pravý_A	doprava_None
štajerák_N	Štajerák_None
žatevní_A	žatva_None
palmička_N	palma_None
žlíbek_N	žlab_None
Mráz_N	mráz_None
vzteklec_N	vzteklík_None
ďubička_N	ďubinka_None
prosmyk_N	průsmyk_None
vochelný_A	vochle_None
konsistorní_A	konsistoř_None
chyška_N	chýše_None
peckovička_N	peckovice_None
polehounku_D	polehoučku_None
Tomiš_N	Tomek_None
ďubkovitý_A	ďubkatý_None
imperfektivní_A	imperfektivum_None
záhumenka_N	záhumenek_None
martyrologium_N	martyrologie_None
ctižádostivý_A	ctižádost_None
pliocenní_A	pliocén_None
přeubohý_A	ubohý_None
výmyslivý_A	vymýšlivý_None
střída_N	třída_None
bohoslužebný_A	bohoslužba_None
řídce_D	řídký_None
distingvovaný_A	distingovaný_None
Emánek_N	Eman_None
jedubaba_N	ježibaba_None
faktum_N	fakt_None
pobočný_A	poboční_None
znělčička_N	znělka_None
žilčinka_N	žíla_None
rosenka_N	rosa_None
Tibeťan_N	Tibet_None
šidélko_N	šídlo_None
kontrfaj_N	kontrfej_None
podorlický_A	Podorlicko_None
vrubopisný_A	vrubopis_None
momentánní_A	momentální_None
pel_N	pyl_None
zlatomodře_D	zlatomodrý_None
mančaft_N	manšaft_None
Vincencie_N	Vincenc_None
kongruální_A	kongrua_None
oratorní_A	oratorium_None
hryzení_N	hrýzt_None
Plzeňák_N	Plzeň_None
žežhulička_N	žežulka_None
korbílek_N	korbel_None
brambora_N	brambor_None
vydejřit_V	vydýřit_None
šetřílek_N	šetřil_None
muří_A	můří_None
Prajzák_N	Prajz_None
foinický_A	Fénicie_None
vlhavo_D	vlhavý_None
vachtmistr_N	vachmistr_None
Edvard_N	Eda_None
dekolté_A	dekoltáž_None
potrubní_A	potrubí_None
Miroslava_N	Miroslav_None
Makedoňan_N	Makedonie_None
kulaťounce_D	kulaťounký_None
nevídáno_D	nevídaný_None
vídenče_N	vídeňátko_None
bornejský_A	Borneo_None
Velehrad_N	velehrad_None
Hanka_N	Hana_None
příštipkařit_V	příštipkovat_None
dodneška_D	dodnes_None
stárka_N	stárek_None
oblizovat_V	olizovat_None
hlinitý_A	hlína_None
kluzko_D	kluzký_None
jinováč_N	jinovatka_None
zásvětný_A	zásvětní_None
hloupůstka_N	hloupost_None
plína_N	plena_None
čimánek_N	čiman_None
tropikal_N	tropiko_None
winchestrovka_N	vinčestrovka_None
uranium_N	uran_None
kuba_N	Kuba_None
pankejt_N	panket_None
přehluboce_D	přehluboký_None
čtvrtohorní_A	čtvrtohory_None
útličký_A	útlounký_None
vinč_N	vinš_None
špejlek_N	špejle_None
nejenom_D	nejen_None
noremní_A	norma_None
Západoevropan_N	západní_None
vraštička_N	vráska_None
čerkeský_A	Čerkes_None
přečetný_A	četný_None
jehnička_N	jehnice_None
strast_N	strádání_None
zlatolesklý_A	zlatolesk_None
hliniště_N	hliník_None
vzkřek_N	skřek_None
odvěčný_A	odvěký_None
konzument_N	konsument_None
Ladislava_N	Ladislav_None
vyšramovat_V	vyšramat_None
Španiel_N	Španěl_None
jehelní_A	jehla_None
stydno_D	stydný_None
rolní_A	role_None
procesuální_A	proces_None
červeno_N	červený_None
kupectvo_N	knihkupec_None
methanol_N	metanol_None
jehněcí_A	jehněčí_None
anafylaktický_A	anafylaxe_None
velkoměšťačka_N	velkoměsto_None
balza_N	balsa_None
žbluňka_N	žblabuňka_None
chcípat_V	scípat_None
Mikoláš_N	Mikuláš_None
paladin_N	palatin_None
pragmatikální_A	pragmatika_None
provincionální_A	provinční_None
zvolninka_D	zvolňoučka_None
čampulinka_N	čampule_None
fešačka_N	fešák_None
naráz_D	ráz_None
krátko_D	krátký_None
jár_N	járek_None
celebeský_A	Celebes_None
bezprizorní_A	bezprizorný_None
proklitický_A	proklitikon_None
chlopenní_A	chlopeň_None
strůj_N	stroj_None
kolegyňka_N	kolega_None
Pepička_N	Pepíček_None
ráz_N	raz_None
poříční_A	poříčí_None
puding_N	pudink_None
písečný_A	písek_None
Uhry_N	Uher_None
pochlebenství_N	pochlebnictví_None
vangl_N	vandl_None
Bolivijec_N	Bolívie_None
Oluška_N	Olina_None
řehtátko_N	řehtadlo_None
nominální_A	nomen_None
hotýlek_N	hotel_None
šestimiliónový_A	šestimilionový_None
výměnický_A	výměník_None
jeřábí_A	jeřáb_None
sklerenchymatický_A	sklerenchym_None
direktoriát_N	direktorát_None
skromňoučce_D	skromňoučký_None
hlomoz_N	lomoz_None
milounko_D	milounký_None
kurfirst_N	kurfiřt_None
žranička_N	žranice_None
jev_N	najevo_None
bezkonfesijní_A	bezkonfesní_None
vábivo_N	vábivý_None
exkrement_N	exkret_None
znenáhlý_A	znenáhla_None
bulbární_A	bulbus_None
sedativní_A	sedativum_None
taky_D	také_None
široký_A	doširoka_None
kapslička_N	kapsle_None
frajírek_N	frajer_None
zmek_N	zmok_None
chýže_N	chýše_None
soupisný_A	soupis_None
zevzdálí_D	zevzdáli_None
Rudy_N	Ruda_None
horce_D	horký_None
hrdýlko_N	hrdlo_None
vakuový_A	vakuum_None
venek_N	navenek_None
robinzonáda_N	robinsonáda_None
volavečka_N	volavka_None
vzdělanectvo_N	vzdělanstvo_None
vlasteneček_N	vlastenec_None
Byzantinec_N	Byzanc_None
zněmčenec_N	zněmčilec_None
podnební_A	podnebný_None
kriminálníček_N	kriminálník_None
Javánec_N	Jáva_None
obrist_N	obrst_None
vařejka_N	vařeka_None
statutární_A	statut_None
žežhulenka_N	žežulka_None
čvachanice_N	čachtanice_None
návratný_A	návratní_None
klauzura_N	klausura_None
drsno_D	drsný_None
černovousý_A	černovousáč_None
zúředničtit_V	zúředničit_None
choře_D	chorý_None
tlusto_N	tlustý_None
Chilan_N	Chile_None
malounko_D	maloučko_None
mlází_N	mládí_None
kubo_N	Kuba_None
vartéř_N	vartýř_None
travěnka_N	tráva_None
středná_N	střední_None
stojánek_N	stojan_None
vervní_A	verva_None
přemocný_A	mocný_None
třírohý_A	třírohák_None
motto_N	moto_None
komponenta_N	komponent_None
hloupý_A	přehloupý_None
řemenička_N	řemenice_None
číman_N	čiman_None
kontuze_N	kontuse_None
Loti_N	Lota_None
nopa_N	nop_None
jatérka_N	játra_None
utkáníčko_N	utkání_None
Konopiště_N	konopiště_None
růvek_N	rov_None
lučební_A	lučba_None
šaty_N	šatičky_None
těžko_D	těžký_None
zářinka_N	záře_None
krápě_N	krápěj_None
nevolno_D	nevolný_None
souhra_N	spoluhra_None
umělec_N	neumělec_None
tříselný_A	tříslo_None
zásuvečka_N	zásuvka_None
úvodníček_N	úvodník_None
divadelní_A	divadlo_None
drápky_N	drápek_None
brauna_N	braun_None
faldík_N	fald_None
povíce_D	povíc_None
balista_N	basketbal_None
přehmat_N	přehmátnout_None
Krišna_N	Kršna_None
lvíčátko_N	lvíče_None
tajtrdlíkovat_V	tajtrlíkovat_None
pochcat_V	poscat_None
Aramejec_N	Aram_None
větýrek_N	vítr_None
matický_A	matika_None
vedřinný_A	vedřiny_None
oblíknout_V	oblíkat_None
penicilín_N	penicilin_None
dada_N	dadaismus_None
výběrčivý_A	vyběračný_None
číslička_N	číslice_None
svatyňka_N	svatyně_None
vlavý_A	vlát_None
dohola_D	holý_None
depresní_A	deprese_None
úskalíčko_N	úskalí_None
fagocytóza_N	fagocyt_None
Broček_N	brok_None
skrznaskrz_D	skrz_None
ženovat_V	žinýrovat_None
retko_N	retka_None
Prater_N	Prátr_None
vikárský_A	vikář_None
prstýnek_N	prsten_None
tisícinásobek_N	tisícinásobný_None
přejícný_A	přející_None
centrifugální_A	centrifuga_None
místní_A	místo_None
slaďoučce_D	slaďoučký_None
živočichozpyt_N	živočichosloví_None
Celestýn_N	Celestin_None
vichřička_N	vichřice_None
kročný_A	krok_None
kuklička_N	kukla_None
bambusovka_N	bambuska_None
návlečka_N	návlačka_None
Američan_N	Amerika_None
řiďounko_D	řiďounký_None
Korsičan_N	Korsika_None
činovatní_A	činovať_None
rámě_N	rameno_None
nazejtří_D	nazítří_None
stachanovka_N	stachanovec_None
slouha_N	sluha_None
Natálka_N	Natálie_None
lokavý_A	lokat_None
punkt_N	puntík_None
dostatek_N	sdostatek_None
skélko_N	sklo_None
vřídek_N	vřed_None
višínka_N	višeň_None
tříšťka_N	tříska_None
rožnout_V	rozžehnout_None
amfiteatrální_A	amfiteátr_None
navrchu_D	navrch_None
vyrabitel_N	vyrábitel_None
pětitřídní_A	pětitřídka_None
věrolomce_N	věrolomný_None
citronan_N	citran_None
udidla_N	udidlo_None
švagřička_N	švagr_None
Svatoslava_N	Svatoslav_None
bolístka_N	bolest_None
vyhubělý_A	vyhublý_None
Hrdlořezy_N	hrdlořez_None
vlůní_D	vloni_None
tellur_N	telur_None
těžisko_N	těžiště_None
štráchy_N	štráf_None
doliňák_N	dolinář_None
stavebný_A	stavební_None
obmýtní_A	obmýtí_None
semestrální_A	semestr_None
típek_N	tipec_None
sexus_N	sex_None
totalitarismus_N	totalismus_None
pitomoučce_D	pitomoučký_None
líbavý_A	líbat_None
čmachtanice_N	čvachtanice_None
aspoň_D	alespoň_None
rybničný_A	rybník_None
turek_N	Turek_None
maniačka_N	maniak_None
hambalky_N	hambalek_None
přehustý_A	hustý_None
průchodicí_A	průchodní_None
malilinko_D	maliličko_None
baktérie_N	bakterie_None
Frísko_N	Frís_None
pomoc_N	výpomoc_None
koštýř_N	koštéř_None
drobounce_D	drobounký_None
mživý_A	mžít_None
Valentin_N	Valinka_None
torero_N	toreador_None
moravní_A	Morava_None
šárat_V	šátrat_None
vřídélko_N	vřídlo_None
zbohatlec_N	zbohatlík_None
ústíčko_N	ústí_None
fošinkový_A	fošna_None
barnatý_A	baryum_None
výhřička_N	výhra_None
návěští_N	návěst_None
Guatemalec_N	Guatemala_None
útloučce_D	útlounký_None
popozítří_D	popozítřek_None
kostka_N	kost_None
rynek_N	rynk_None
názůrek_N	názor_None
Edmund_N	Edmond_None
hezoučce_D	hezoučký_None
zeleňounký_A	zeleňoučký_None
přepěťový_A	přepětí_None
gustíčko_N	gusto_None
vysměváček_N	vysměvač_None
robinzon_N	Robinson_None
bažantí_A	bažant_None
Británie_N	Brit_None
nedochůdčátko_N	nedochůdče_None
Filipínec_N	Filipíny_None
cukrle_N	cukrátko_None
masív_N	masiv_None
ilustrativní_A	ilustrace_None
Radhošť_N	Radegast_None
koblížek_N	kobliha_None
škrabátko_N	škrabadlo_None
ústrojstvo_N	ústrojenstvo_None
vochmajstr_N	vachmajstr_None
manikýra_N	manikúra_None
zbůjný_A	zbojný_None
Vídeňák_N	Vídeň_None
muslim_N	musulman_None
vylítnout_V	vyletět_None
kozačka_N	kozák_None
žárlivůstka_N	žárlivost_None
gurt_N	kurt_None
Mančinka_N	Manča_None
Pavlík_N	Pavel_None
berunka_N	beroušek_None
voňavo_D	voňavý_None
brejle_N	brýle_None
odjaktěživa_D	odjakživa_None
čtvrteční_A	čtvrtek_None
nechutenství_N	nechuť_None
vární_A	varný_None
toledo_N	Toledo_None
čípkovitý_A	čípkatý_None
obálečka_N	obálka_None
koželužna_N	koželuh_None
Slovena_N	Slovák_None
zbaběleček_N	zbabělec_None
patronace_N	patronance_None
závojík_N	závoj_None
pramen_N	vypramenit_None
jídelní_A	jídlo_None
ždavý_A	ždát_None
patlažán_N	baklažán_None
grošáček_N	grošák_None
zdáníčko_N	zdání_None
skřínečka_N	skříň_None
vrabčátko_N	vrabče_None
sluník_N	slunečník_None
nohsledství_N	nohsled_None
Pavel_N	Pavlína_None
štuleček_N	štulec_None
včílka_N	včíl_None
Anka_N	Anna_None
pracna_N	pracka_None
vysokanánsko_D	vysokánský_None
bezduše_D	bezduchý_None
zaklenec_N	zakletec_None
Minka_N	Mína_None
čípek_N	čep_None
vulkanický_A	vulkán_None
stojné_N	stojný_None
eparchiální_A	eparchie_None
Julie_N	Julius_None
Vševidoucí_N	vševidoucí_None
mírňoučce_D	mírňounký_None
Emílie_N	Emil_None
řezbička_N	řezba_None
rosolička_N	rosolka_None
Bordeaux_N	bordó_None
cheviot_N	ševiot_None
předlouho_D	předlouhý_None
zapláskat_V	zapleskat_None
čičorenka_N	čičorka_None
hladíček_N	hlad_None
žitíčko_N	žito_None
převeselý_A	veselý_None
škartička_N	škartka_None
přeopatrný_A	opatrný_None
zálička_N	zálik_None
horko_D	horký_None
památečný_A	památeční_None
hluboko_N	hluboký_None
zimavo_D	zimavý_None
lukulský_A	Lukullus_None
kredenční_A	kredenc_None
příkladeček_N	příklad_None
zaškvičet_V	zaškvěčet_None
vřídelní_A	vřídlo_None
čtvereční_A	čtverečný_None
urbariátní_A	urbariát_None
morytát_N	moritát_None
kostliveček_N	kostlivec_None
půlnoční_A	půlnoc_None
šaramantní_A	šarmantní_None
tokajské_N	Tokaj_None
škrábnutíčko_N	škrábnutí_None
šrajtoflička_N	šrajtofle_None
kosírek_N	kosárek_None
vyglancovat_V	vyglančit_None
kremrolka_N	kremrole_None
dobrounký_A	dobroučký_None
zákupní_A	zákup_None
šupinkovatý_A	šupinkatý_None
železovitý_A	železitý_None
ústup_N	odstup_None
vagotonik_N	vagotonie_None
virvál_N	virval_None
zarputilý_A	urputný_None
prosťoučce_D	prosťounký_None
Dikobraz_N	dikobraz_None
syfilida_N	syfilis_None
zádrhel_N	zádrh_None
kratinko_D	kratinký_None
medný_A	med_None
sarkastik_N	sarkasta_None
ručníček_N	ručník_None
čertí_A	čert_None
Pionýr_N	pionýr_None
furberk_N	furverk_None
trilobití_A	trilobit_None
srbocharvátský_A	srbochorvatský_None
splávek_N	splav_None
substanciální_A	substance_None
plocho_D	plochý_None
vagantovat_V	vagantit_None
proužek_N	pruh_None
Mexikán_N	Mexiko_None
dobrá_N	dobrý_None
Vlastimila_N	Vlastimil_None
žunkat_V	zunkat_None
akinézie_N	akinesie_None
levý_A	nalevo_None
vychvistnout_V	vychvístnout_None
Bobíšek_N	Bobeš_None
bruslička_N	brusle_None
chiruržka_N	chirurg_None
Dolomity_N	dolomit_None
Bohdana_N	Bohdan_None
přebohatý_A	bohatý_None
vratce_D	vratký_None
zavíjačka_N	zavíječka_None
šnurbártek_N	šnurbart_None
vrbí_N	vrboví_None
konfesijní_A	konfese_None
výškleb_N	výšklebek_None
čuch_N	čich_None
Kamila_N	Kamil_None
zmrhalka_N	zmrhanka_None
sino_A	siný_None
firemní_A	firma_None
vítězkyně_N	vítězka_None
dvojace_D	dvojaký_None
dřevořezbářství_N	dřevořez_None
Fries_N	Frís_None
halušky_N	haluška_None
várečka_N	várka_None
špičička_N	špička_None
Zima_N	zima_None
oprátka_N	oprať_None
krásňounký_A	krásný_None
záhumeň_N	záhumní_None
vápínko_N	vápno_None
balkán_N	Balkán_None
Veronika_N	Verunka_None
maratón_N	Marathón_None
lhotecký_A	Lhotka_None
zlatotřpytný_A	zlatotřpyt_None
cerber_N	Cerber_None
Lojzíček_N	Lojza_None
vichorec_N	vichor_None
zpovědlnice_N	zpovědnice_None
kraťounce_D	kraťounký_None
popeleční_A	popelec_None
úterní_A	úterý_None
přečastý_A	častý_None
jatýrka_N	játra_None
embryonální_A	embryo_None
holubí_A	holub_None
ahasver_N	Ahasver_None
způle_D	způli_None
východiště_N	východisko_None
úplatnictví_N	úplatkářství_None
psýché_N	psycha_None
obdiv_N	odiv_None
heilót_N	hélót_None
vrástička_N	vráska_None
Dněprostroj_N	Dněpr_None
brázdovitý_A	brázditý_None
znenadále_D	znenadála_None
mutra_N	mutr_None
frantík_N	Frantík_None
rohlíček_N	rohlík_None
Madla_N	Magdaléna_None
syndikalistický_A	syndikalista_None
výražní_A	výražný_None
Turecko_N	Turek_None
Rudla_N	Ruda_None
Vládík_N	Vladík_None
rudimentální_A	rudimentární_None
zaječátko_N	zajíče_None
máje_N	máj_None
přeukrutný_A	ukrutný_None
kadlec_N	tkadlec_None
daremný_A	darebný_None
hemeroidy_N	hemoroidy_None
sukatý_A	sukovitý_None
máječek_N	máj_None
primovní_A	prima_None
prďola_N	prďoch_None
právní_A	právo_None
palladium_N	paládium_None
pěšky_D	pěší_None
slepenice_N	slepenina_None
ředinečka_N	ředina_None
potoční_A	potok_None
legrácka_N	legrace_None
vařecha_N	vařeka_None
vkládek_N	vklad_None
zápaleček_N	zápal_None
satyriáza_N	satyriasis_None
diskusní_A	diskuse_None
stáčečka_N	stáčeč_None
špalík_N	špalek_None
seizmický_A	seismický_None
vichor_N	vichr_None
impérium_N	imperiální_None
dolózní_A	dolosní_None
pršiplášť_N	pršák_None
šmudlík_N	šmudla_None
vpolu_D	vpoly_None
žalozpěvný_A	žalozpěv_None
Bohuslava_N	Bohuslav_None
trubní_A	trouba_None
zambezský_A	Zambezi_None
vyslanský_A	vyslanecký_None
židovice_N	Žid_None
bezbožnictví_N	bezbožník_None
zlatohlavý_A	zlatohlav_None
parenchymatický_A	parenchym_None
zákazný_A	zákaz_None
imobilární_A	imobilie_None
velblouďátko_N	velbloudě_None
žďabec_N	ždibec_None
čemejrat_V	čemejřit_None
xenofontovský_A	xenofontský_None
rozvzteklit_V	vzteklit_None
upomínavý_A	upomínací_None
četinka_N	četina_None
uvrci_V	uvrhnout_None
botinka_N	bota_None
vojákyně_N	voják_None
kauzální_A	kausální_None
srdečkový_A	srdíčko_None
ústřelný_A	ústřel_None
suprematistický_A	suprematista_None
maršbatalión_N	maršbaťák_None
péřovitý_A	peřovitý_None
deštík_N	déšť_None
Lenča_N	Léna_None
sanytrový_A	salnitr_None
opozičník_N	oposičník_None
éterno_N	éterný_None
sipáhí_N	spahi_None
hrabošík_N	hraboš_None
žebrovíčko_N	žebroví_None
Padua_N	Padova_None
soupojištění_N	spolupojištění_None
úpravčí_N	úpravce_None
soběslavský_A	Soběslav_None
Stanislava_N	Stanislav_None
laboratorní_A	laboratoř_None
vlhkavo_D	vlhkavý_None
ztumpachovatět_V	ztumpachovět_None
převeselo_D	převeselý_None
všímačný_A	všímavý_None
cherub_N	cherubín_None
zásmolek_N	zásmolec_None
vyšpánkovat_V	vyšpánovat_None
zrabiátnit_V	zrabiátnět_None
trata_N	trať_None
Soluňan_N	Soluň_None
parlamentární_A	parlament_None
veselíčko_N	veselí_None
ženglička_N	žengle_None
obkukovat_V	obkoukat_None
žežhule_N	žežulka_None
Kryštůfek_N	Kryštof_None
šťourálek_N	šťoura_None
patro_N	spatra_None
pradlář_N	pradlák_None
Matěj_N	Matyáš_None
prudko_D	prudký_None
kolegijní_A	kolegium_None
Katalánka_N	Katalánie_None
stipendijní_A	stipendium_None
soudcová_N	soudce_None
ráječek_N	ráj_None
hnojiště_N	hnojnice_None
kultovní_A	kult_None
čepejřit_V	čepýřit_None
doprostředka_D	doprostřed_None
měkkýší_A	měkkýš_None
řepeniště_N	řepiště_None
mišuge_A	mešuge_None
prsíčka_N	prsa_None
soklík_N	sokl_None
skeptička_N	skeptik_None
četyna_N	četina_None
blyskot_N	blýskot_None
přednička_N	přednice_None
virvar_N	virval_None
špicl_N	špic_None
řepoviště_N	řepiště_None
Luboš_N	Lubomír_None
zafajfčit_V	zafajčit_None
nábřežíčko_N	nábřeží_None
uměnoslovný_A	uměnosloví_None
projezd_N	průjezd_None
obilní_A	obilí_None
vidma_N	vědma_None
fantomatický_A	fantóm_None
zips_N	zip_None
vzpurnický_A	vzpurník_None
podruhyně_N	podruh_None
brzký_A	vbrzku_None
oviparní_A	oviparie_None
zvědač_N	zvěd_None
vymetalý_A	vymetaný_None
subretní_A	subreta_None
veseloherní_A	veselohra_None
vochlovna_N	vochlírna_None
železisko_N	želízko_None
veselo_N	veselý_None
zumdlený_A	zumdlelý_None
vichorný_A	vichor_None
nenávratno_D	nenávratný_None
záhrobeň_N	záhrobek_None
tymián_N	dymián_None
evangelický_A	evangelium_None
přešupovat_V	přešoupnout_None
papánek_N	papá_None
řvavý_A	řvát_None
nivelizace_N	nivelace_None
drůbeží_A	drůbež_None
kostýlek_N	kostel_None
tarásek_N	taras_None
Zabajkalí_N	Zabajkalsko_None
toliko_D	tolik_None
žrádélko_N	žrádlo_None
jednozvuk_N	jednozvučný_None
žakarský_A	žakár_None
Ganga_N	Ganges_None
Čudsko_N	Čud_None
ňáko_D	ňák_None
špinaveček_N	špinavec_None
přehrádka_N	přehrada_None
hubeňous_N	hubeňour_None
Kubánec_N	Kuba_None
jemnůstka_N	jemnost_None
kutnohorský_A	Kutná_None
žal_N	žel_None
kupka_N	kupa_None
žebř_N	žebřík_None
sraženinka_N	sraženina_None
plíva_N	pleva_None
asyndetický_A	asyndeton_None
struhátko_N	struhadlo_None
půlmilión_N	půlmilion_None
pouštědlo_N	pušťadlo_None
dusno_D	dusný_None
benediktýn_N	benediktin_None
zludračet_V	zludračit_None
ganglie_N	ganglion_None
videatní_A	videat_None
velkoměšťácký_A	velkoměsto_None
filip_N	Filip_None
spektrografický_A	spektrograf_None
flirtík_N	flirt_None
nástupný_A	nástupní_None
zrádeček_N	zrádce_None
kuriální_A	kurie_None
zchacharovat_V	zchachařit_None
papršlek_N	paprsek_None
těřich_N	teřich_None
propis_N	průpis_None
vpovzdálí_D	vpozdáli_None
volno_N	volný_None
kantýnský_N	kantýna_None
zvor_N	zvůr_None
Josefa_N	Josef_None
zeleno_N	zelený_None
Bohouš_N	Bohuš_None
drobné_N	drobný_None
Florenťan_N	Florencie_None
zasucha_D	suchý_None
eden_N	Eden_None
korpuskulární_A	korpuskule_None
marketinkový_A	marketing_None
živnostní_A	živnost_None
prima_N	primisima_None
suchounko_D	suchounký_None
památný_A	připamatování_None
tavební_A	tavba_None
chmat_N	hmat_None
leva_N	lev_None
Tomíček_N	Tomek_None
Sardinsko_N	Sardinie_None
zalektat_V	zalechtat_None
betlém_N	Betlém_None
žebrákyně_N	žebračka_None
maléř_N	malíř_None
zlehounka_D	zlehýnka_None
Hamburčan_N	Hamburk_None
Otylka_N	Otýlie_None
planetární_A	planeta_None
vzdoušek_N	vzduch_None
roztomilůstka_N	roztomilost_None
galvanizovna_N	galvanisovna_None
osmihlasý_A	osmihlas_None
diminutivum_N	deminutivum_None
pečetní_A	pečeť_None
potichoučku_D	potichu_None
halíř_N	haléř_None
prouhelňování_N	prouhelnění_None
otrůček_N	otrok_None
děrnoštítkový_A	děrný_None
miliontý_A	milióntý_None
kabardinský_A	Kabardinec_None
bitevní_A	bitva_None
šnuptychlíček_N	šnuptychl_None
čunčátko_N	čunče_None
šlachta_N	šlechta_None
šnajdrovat_V	šejdrovat_None
perlinka_N	perlička_None
stodolní_A	stodola_None
volňoučký_A	volňounký_None
sudeťák_N	Sudeťák_None
vepředu_D	vpředu_None
Olga_N	Olina_None
zrzoun_N	rezoun_None
řehonivý_A	řehnivý_None
stůžek_N	stoh_None
belgický_A	Belgie_None
chlumeček_N	chlum_None
neotesánek_N	neotesanec_None
propadavý_A	propadat_None
vekslík_N	veksl_None
vychloubálek_N	vychloubal_None
Achilleus_N	Achilles_None
mateří_A	mateřídouška_None
sídelní_A	sídlo_None
paměť_N	nazpaměť_None
vekslíř_N	vekslář_None
haknkrajclerský_A	haknkrajc_None
Moldávie_N	Moldavsko_None
Indie_N	Ind_None
mladince_D	mladinký_None
sukovka_N	sukovice_None
zlatojasný_A	zlatojas_None
záležitůstka_N	záležitost_None
žmoulat_V	drmolit_None
překrásný_A	krásný_None
vášnička_N	vášeň_None
smíšek_N	smích_None
žilovitý_A	žilovatý_None
kůlna_N	kolna_None
utilitaristní_A	utilitarista_None
přaztička_N	přezka_None
Peršan_N	Persie_None
inerciální_A	inercie_None
Jánošík_N	Jánoš_None
přehluboký_A	hluboký_None
vojáčkovství_N	vojáčkování_None
hlemýždí_A	hlemýžď_None
petrohradský_A	Petrohrad_None
plémě_N	plemeno_None
přeztička_N	přezka_None
žeberní_A	žebro_None
lokýtek_N	loket_None
zkouštička_N	zkouška_None
žíhavka_N	žahavka_None
domovníček_N	domovník_None
klér_N	klérus_None
cvrnkot_N	crnkot_None
pandán_N	pendant_None
Abdéřan_N	Abdéra_None
závětný_A	závětní_None
hříbkař_N	hřibař_None
baladička_N	balada_None
začmoudlý_A	začoudlý_None
prérijní_A	prérie_None
rozcmrndat_V	cmrndat_None
přizrzavělý_A	přizrzlý_None
kamínek_N	kámen_None
naznat_V	znát_None
Sášenka_N	Sáša_None
čtyřnásobek_N	čtyřnásobný_None
Michálek_N	Michal_None
oblačný_A	oblak_None
morní_A	mor_None
fagocytární_A	fagocyt_None
Vratislav_N	Vráťa_None
Praděd_N	praděd_None
útlinký_A	útličký_None
všady_D	všude_None
Theodor_N	Teodor_None
karetní_A	karta_None
dnavý_A	dna_None
vlaze_D	vlahý_None
voskovička_N	voskovice_None
náustek_N	ústenka_None
móres_N	mores_None
špíglák_N	špígl_None
sparťan_N	Sparťan_None
tóneček_N	tón_None
frýdecký_A	Frýdek_None
pohrabáček_N	pohrabáč_None
puntík_N	punkt_None
palatin_N	paladin_None
argus_N	Argus_None
vynachválit_V	nachválit_None
pánvice_N	pánev_None
šepotný_A	šepot_None
měkounce_D	měkounký_None
milánek_N	miláček_None
přeúrodný_A	úrodný_None
ťulpásek_N	ťulpas_None
krápníček_N	krápník_None
arzenovodík_N	arsenovodík_None
předraze_D	předrahý_None
rozinka_N	hrozinka_None
slovacikum_N	slovenikum_None
štafáž_N	stafáž_None
pikolovat_V	pikat_None
vychlemstnout_V	vychlemtnout_None
brambůrek_N	brambor_None
odštipek_N	odštěpek_None
Ilýrie_N	Ilyr_None
Amálka_N	Amálie_None
smola_N	smůla_None
fišmistr_N	fišmajstr_None
zvetešelý_A	zvetšelý_None
zelenavo_N	zelenavý_None
Sparťan_N	Sparta_None
Rudík_N	Ruda_None
ostrožný_A	ostroh_None
tkaloun_N	kaloun_None
veřtat_N	verštat_None
tranda_N	trajda_None
vynadivit_V	nadivit_None
vlnečka_N	vlna_None
způsob_N	nezpůsob_None
voštinatý_A	voští_None
křivo_D	křivý_None
přihořívat_V	hořet_None
zlom_N	zlomený_None
pravěký_A	pravěk_None
klíšťky_N	kleště_None
klacík_N	klacek_None
bazalička_N	bazalka_None
manžestr_N	manšestr_None
žehavka_N	žahavka_None
Rudýnek_N	Ruda_None
abstraktivní_A	abstraktní_None
synagogální_A	synagóga_None
obojace_D	obojaký_None
Tureček_N	Turek_None
Ostravsko_N	Ostrava_None
hřbítek_N	hřbet_None
presbyterní_A	presbyter_None
zkořán_D	kořen_None
expozitura_N	expositura_None
dále_D	dál_None
arzenál_N	arsenál_None
žoužel_N	žížala_None
virčoft_N	virčaft_None
vývojeslovný_A	vývojesloví_None
stroupek_N	strup_None
celestin_N	Celestin_None
citrát_N	citran_None
polo_D	dopola_None
teoréma_N	teorém_None
topický_A	topikum_None
Bedříšek_N	Bedřich_None
jakživ_A	jaktěživ_None
karikaturistický_A	karikaturista_None
zelenčátko_N	zelenče_None
krokvice_N	krokev_None
hlaďounce_D	hlaďounký_None
frajír_N	frajer_None
čisťoučce_D	čisťounký_None
civilněprávní_A	civilní_None
synonymní_A	synonymum_None
Márinka_N	Maryna_None
dvířka_N	dveře_None
Otilie_N	Otýlie_None
archív_N	archiv_None
vařonka_N	vařenka_None
pokradmu_D	pokradmý_None
zájmeček_N	zájem_None
zdomácnět_V	udomácnět_None
konkvistador_N	conquistador_None
manila_N	Manila_None
zapuštění_N	zapustit_None
palmární_A	palmáre_None
přestupkář_N	přestupník_None
dumper_N	dampr_None
matkovražda_N	matkovrah_None
úmluvný_A	úmluva_None
vpředu_D	vpřed_None
Podskalí_N	podskalí_None
vyhlídčička_N	vyhlídka_None
Pyrrhus_N	Pyrrhos_None
teďkonc_D	teďky_None
následek_N	konsekvence_None
pramenní_A	pramen_None
zažehnávka_N	zažehnávadlo_None
veršovní_A	veršovný_None
Lidunka_N	Liduna_None
nekatolička_N	nekatolík_None
vojanština_N	vojanský_None
žabčí_A	žabec_None
volavčátko_N	volavče_None
drdůlek_N	drdol_None
úspěšek_N	úspěch_None
proplach_N	průplach_None
fotýlek_N	fotel_None
leč_N	léč_None
vilečka_N	vila_None
konsumce_N	konsumpce_None
skopský_A	Skopje_None
chalífát_N	kalifát_None
hafánek_N	hafan_None
studně_N	studna_None
bordýlek_N	bordel_None
ferrit_N	ferit_None
waleský_A	Wales_None
bezzvuký_A	bezezvučný_None
poetično_N	poetický_None
operka_N	opera_None
úkojný_A	úkoj_None
krůtička_N	krůta_None
volňounký_A	volný_None
viklefovec_N	viklefista_None
kulaťounký_A	kulatý_None
zlatoplodný_A	zlatoplod_None
šálek_N	šál_None
zápětní_A	zápětný_None
poleženíčko_N	poležení_None
strniště_N	strnisko_None
tamže_D	tamtéž_None
vesílko_N	veslo_None
vysvětleníčko_N	vysvětlení_None
zaječatý_A	zajíčatý_None
řemesílko_N	řemeslo_None
záchytný_A	zachycení_None
vzkázáníčko_N	vzkázání_None
Chorvat_N	Charvát_None
vydřepávat_V	vydřepět_None
Vladěk_N	Vladík_None
pejorativní_A	pejorativum_None
mlátek_N	mlat_None
pikantérie_N	pikanterie_None
modroučce_D	modroučký_None
ostrožský_A	ostroh_None
hloub_N	zhloubí_None
vasomotorický_A	vázomotorický_None
odbíračka_N	odběračka_None
repertář_N	repertorium_None
pogromistický_A	pogromista_None
spíše_D	spíš_None
artritida_N	arthritis_None
kašpar_N	Kašpar_None
milo_D	milý_None
kamínka_N	kamna_None
dopolou_D	dopola_None
přemístit_V	přehrnout_None
dnes_D	dodnes_None
praporeční_A	praporový_None
škatulička_N	škatulka_None
Marcela_N	Marcel_None
Jaroslava_N	Jaroslav_None
vypouklý_A	vypuklý_None
ceremoniál_N	ceremoniel_None
dravčí_A	dravec_None
klubovní_A	klub_None
prozkum_N	průzkum_None
veskrz_D	naveskrz_None
králikárna_N	králíkárna_None
sinhálský_A	Sinhálec_None
výběrný_A	výběr_None
Vladislava_N	Vladislav_None
Dalmatinka_N	Dalmácie_None
prstka_N	prsť_None
reklamka_N	reklama_None
tygřátko_N	tygře_None
apsidální_A	apsida_None
Švýcary_N	Švýcar_None
odmalička_D	odmala_None
fonetička_N	fonetik_None
výslaz_N	výslad_None
zababuchat_V	zababušit_None
zmilitký_A	zmilený_None
pozejtřek_N	pozítřek_None
vojvodkyně_N	vojvoda_None
šerčička_N	šerka_None
ubohoučce_D	ubohoučký_None
Magdalenka_N	Magdaléna_None
šedověký_A	šedověk_None
mediastinální_A	mediastinum_None
uzounce_D	uzounký_None
Maria_N	Marie_None
lavůrek_N	lavor_None
pupíneček_N	pupen_None
Řekyně_N	Řek_None
přadýnko_N	přadeno_None
Oldra_N	Olda_None
Poldinka_N	Poldovka_None
dekompresní_A	dekomprese_None
parenchymatózní_A	parenchym_None
nopka_N	nop_None
intelektualistický_A	intelektualismus_None
zázračný_A	zázrak_None
Ámos_N	Amos_None
molární_A	mol_None
hlezenní_A	hlezno_None
puklička_N	poklice_None
pohoříčko_N	pohoří_None
ratolístka_N	ratolest_None
ovariální_A	ovarium_None
bolusový_A	bolus_None
zlatulenký_A	zlatulinký_None
vysoko_N	vysoký_None
opravička_N	oprava_None
potichounku_D	potichu_None
chování_N	chovat_None
šálička_N	šála_None
obhlížet_V	ohlížet_None
vězníček_N	vězeň_None
vejměník_N	výměník_None
vrtošek_N	vrtoch_None
kemp_N	camp_None
prostup_N	průstup_None
hudební_A	hudba_None
šmelináříček_N	šmelinář_None
vrátenský_A	vrátný_None
zázemní_A	zázemí_None
kanýr_N	karnýr_None
makabejský_A	Makkabi_None
úmrtní_A	úmrtí_None
vysměvavý_A	vysmívavý_None
vroub_N	vrub_None
Ceylon_N	Cejlon_None
herakles_N	Hérakles_None
blokáč_N	blokový_None
purgativní_A	purgace_None
úpravenský_A	úpravna_None
zpytavý_A	zpytat_None
prodromální_A	prodrom_None
vestibulum_N	vestibul_None
štepslík_N	štepsl_None
kubík_N	Kubík_None
bouřní_A	bouře_None
askorbový_A	askorbinový_None
Lahore_N	Láhaur_None
ocelorytectví_N	oceloryt_None
kuférek_N	kufr_None
vřeteň_N	vřeteno_None
parno_D	parný_None
vyvlíknout_V	vyvléci_None
veliký_A	velký_None
zpovolna_D	zpovlovna_None
Zéland_N	novozélandský_None
povidlí_N	povidla_None
kat_N	sekat_None
závěsný_A	zavěšování_None
Honzíček_N	Honza_None
kolpak_N	kalpak_None
Horák_N	horák_None
Plutón_N	Pluto_None
přesladce_D	přesladký_None
těžný_A	těžní_None
zahopcovat_V	zahopsat_None
vpis_N	vpisek_None
výložní_A	výložný_None
visalec_N	viselec_None
drobnůstka_N	drobnost_None
šípek_N	šíp_None
vrtichvostovský_A	vrtichvost_None
brach_N	bráška_None
škot_N	Skot_None
kořalenka_N	kořalka_None
Varšavan_N	Varšava_None
rešeršní_A	rešerše_None
uroseptický_A	urosepse_None
výpomůcka_N	výpomoc_None
výsměšek_N	výsměch_None
náměstkyně_N	náměstek_None
jidáš_N	Jidáš_None
chcíplotina_N	scíplotina_None
lacino_D	laciný_None
zarovno_D	zárovno_None
průlomný_A	průlomový_None
septální_A	septum_None
vanadium_N	vanad_None
fajfčička_N	fajfka_None
august_N	August_None
vpovzdáli_D	vpozdáli_None
lyžička_N	lyže_None
Brňák_N	Brňan_None
Kamčatčan_N	Kamčatka_None
revuální_A	revue_None
uherština_N	uherčina_None
Jarek_N	Jára_None
presbytář_N	presbyterium_None
volán_N	volant_None
pupeční_A	pupek_None
cukrovíčko_N	cukroví_None
hotentot_N	Hotentot_None
mistříček_N	mistr_None
živoživoucí_A	živý_None
pánbíčkářství_N	pámbíčkářství_None
ubrousek_N	ubrus_None
zápřeh_N	zápřah_None
zrnečkovitý_A	zrníčkovitý_None
Plzeňan_N	Plzeň_None
spektákl_N	špektákl_None
jatecký_A	jatky_None
cedítko_N	cedidlo_None
Ivana_N	Ivan_None
nenasytný_A	nenasycený_None
precesní_A	precese_None
Eliška_N	Ela_None
útlounce_D	útlounký_None
vzdělankyně_N	vzdělanec_None
Jenůfka_N	Jenůfa_None
citoslovečný_A	citoslovce_None
čápátko_N	čápě_None
vlnička_N	vlna_None
ženulinka_N	žena_None
drakónský_A	drakonický_None
kurt_N	court_None
podhoří_N	podhůří_None
šklebílek_N	šklebil_None
kmotřenečka_N	kmotřenka_None
Terinka_N	Terka_None
jazyčný_A	jazyk_None
květáček_N	květák_None
posesívní_A	posesivní_None
eocenní_A	eocén_None
lezavý_A	vlezlý_None
shánlivý_A	shánivý_None
marno_D	marný_None
pacifik_N	Pacifik_None
stánek_N	stan_None
fabričný_A	fabriční_None
měďáček_N	měďák_None
voroplavný_A	voroplavba_None
zatrachtilý_A	zatrápený_None
Karolínka_N	Karolína_None
vředovatý_A	vředovitý_None
trávní_A	travní_None
čakana_N	čakan_None
košilenka_N	košile_None
překrátký_A	krátký_None
vochlovačka_N	vochle_None
čajovní_A	čaj_None
řez_N	řezání_None
Liba_N	Líba_None
evangelijní_A	evangelium_None
Javánka_N	Jáva_None
mandelík_N	mandel_None
úvozní_A	úvozový_None
předhůří_N	předhoří_None
křemínek_N	křemen_None
Říman_N	Řím_None
Sibiřan_N	Sibiř_None
žilčička_N	žíla_None
zatrackaný_A	zatrápený_None
zajouch_N	zajíc_None
podpaždí_N	podpaží_None
šípinka_N	šípek_None
Moldavan_N	Moldavsko_None
epopeja_N	epopej_None
přebídný_A	bídný_None
chuďásek_N	chuďas_None
postupimský_A	Postupim_None
půlměsíčitý_A	půlměsíc_None
uplít_V	uplivnout_None
kaplánek_N	kaplan_None
demonstrativní_A	demonstrace_None
Anča_N	Anna_None
lojnatý_A	lojovatý_None
přetěžce_D	přetěžký_None
čínský_A	Čína_None
Svatopluk_N	Svata_None
prašný_A	prach_None
kataleptický_A	katalepsie_None
Bohumila_N	Bohumil_None
obilný_A	obilní_None
imperfektní_A	imperfektum_None
zakážka_N	zakázka_None
palír_N	polír_None
dvojbarevný_A	dvojbarvý_None
nebozízek_N	nebozez_None
onomatopoion_N	onomatopoie_None
urlaub_N	urláb_None
blizounko_D	blizoučký_None
kustodství_N	kustod_None
rozehnat_V	rozdýchat_None
hříbek_N	hřib_None
střevlička_N	střevle_None
návěstí_N	návěští_None
prepubertální_A	prepuberta_None
vejprava_N	výprava_None
hřada_N	hřad_None
zároda_N	zárod_None
halva_N	chalva_None
vědérce_N	vědro_None
orchestrační_A	orchestrace_None
umlkat_V	mlknout_None
dušezpytný_A	dušezpyt_None
společenstevní_A	společenstvo_None
kačeří_A	kačer_None
řevnivůstka_N	řevnivost_None
toulouský_A	Toulouse_None
fars_N	farce_None
úklidno_D	úklidný_None
skalák_N	skalník_None
bystře_D	bystrý_None
nymfomanka_N	nymfomanie_None
šlápůtka_N	šlápota_None
odměrný_A	odměřování_None
cvičenka_N	cvičenec_None
otakárek_N	Otokar_None
volební_A	volba_None
magacín_N	magazín_None
vlhkoměrný_A	vlhkoměr_None
milostnice_N	milovnice_None
výhrozný_A	výhrůžný_None
draze_D	drahý_None
pudlárna_N	pudlovna_None
harampádí_N	harampátí_None
humorální_A	humor_None
šíře_N	šíř_None
zaoblit_V	zaokrouhlit_None
krezol_N	kresol_None
patrimonijní_A	patrimonium_None
Sláva_N	Jaroslav_None
čekan_N	čakan_None
kategoriální_A	kategorie_None
rytmajstr_N	rytmistr_None
štrozok_N	štrúzok_None
jemňounce_D	jemňounký_None
Polabí_N	Polaban_None
žalovavý_A	žalovat_None
zuzana_N	zuzka_None
Žižkovan_N	Žižkov_None
Daniela_N	Daniel_None
truchlenec_N	truchlivec_None
slano_N	slaný_None
zásvětno_N	zásvětní_None
Valaška_N	Valach_None
daleký_A	zdaleka_None
zlotný_A	zlota_None
holo_D	holý_None
svíteček_N	svítek_None
cůpek_N	cop_None
zrovnička_D	zrovinka_None
Věrka_N	Věra_None
verbloud_N	velbloud_None
jachtink_N	jachting_None
črtečka_N	črta_None
vápenný_A	vápno_None
kalmuk_N	Kalmyk_None
zákůpek_N	zákop_None
modlitební_A	modlitba_None
ziskulačnictví_N	ziskulačný_None
štěrkopískovna_N	štěrkopísek_None
Provensálec_N	Provence_None
hnědáček_N	hnědák_None
Pražánek_N	Praha_None
orbitální_A	orbita_None
bubínek_N	buben_None
oxford_N	Oxford_None
zrzek_N	rezek_None
šprota_N	šprot_None
průseč_N	průsek_None
jedenáctiletka_N	jedenáctiletý_None
horenský_A	hora_None
zločinectvo_N	zločin_None
bezzvučný_A	bezzvuký_None
matěj_N	Matěj_None
důle_N	zdůli_None
prostora_N	prostor_None
stíží_D	stěží_None
klícka_N	klec_None
vojačit_V	vojančina_None
evolutivní_A	evoluce_None
štůsek_N	štos_None
odysea_N	Odyssea_None
vichořice_N	vichor_None
redutní_A	reduta_None
unitaristický_A	unitarismus_None
závůdek_N	závod_None
seržán_N	seržant_None
lehko_N	lehký_None
šedomodře_D	šedomodrý_None
sportovní_A	sport_None
parazol_N	parasol_None
poprsní_A	poprsí_None
zdvořilůstka_N	zdvořilost_None
obleček_N	oblek_None
donchuán_N	Don_None
zlýduch_N	zloduch_None
zařehonit_V	zařehnit_None
plecí_A	pletí_None
lavór_N	lavor_None
krupný_A	kroupa_None
vaginální_A	vagína_None
suplentura_N	suplent_None
sloupkář_N	sloupkař_None
Slovenka_N	Slovák_None
relativno_N	relativní_None
zvukomalebný_A	zvukomalba_None
sestřinka_N	sestra_None
linka_N	linie_None
sazební_A	sazba_None
bezbřeze_D	bezbřehý_None
mokro_N	mokrý_None
spořílek_N	spořil_None
Salomon_N	Šalamoun_None
veveruška_N	veverka_None
Východočeška_N	Východočech_None
vrbí_A	vrboví_None
Ječmínek_N	ječmínek_None
pederastie_N	pederast_None
prosebný_A	prosba_None
Švejcar_N	Švýcar_None
čímánek_N	čiman_None
šeptný_A	šeptmý_None
Běloruska_N	Bělorus_None
kolouš_N	kolouch_None
obrataňský_A	Obrataň_None
štvavý_A	štvát_None
vlaho_D	vlahý_None
prepuciální_A	prepucium_None
tence_D	tenký_None
roztažlivý_A	roztažný_None
lucerka_N	lucina_None
zákrs_N	zakrslík_None
chmýříčko_N	chmýří_None
odevšad_D	odevšud_None
zádu_D	zadu_None
četivo_N	čtivo_None
Vševědoucí_N	vševěd_None
okvětní_A	okvětí_None
Žanynka_N	Žanda_None
patricius_N	patricij_None
kaltoun_N	kaldoun_None
štipečka_N	štipka_None
staře_D	starý_None
suchounce_D	suchounký_None
maňásek_N	maňas_None
přešťastný_A	šťastný_None
Potěmkin_N	Poťomkin_None
Arnošt_N	Arne_None
plůdek_N	plod_None
stránčička_N	stránka_None
otaxírovat_V	otaxovat_None
dragant_N	tragant_None
příměšek_N	příměs_None
ťopinka_N	ťopka_None
Zálesí_N	zálesí_None
vardejn_N	vardajn_None
vádrlátko_N	vádrle_None
štěpnička_N	štěpnice_None
sudoměřský_A	Sudoměř_None
kasus_N	casus_None
motáček_N	moták_None
žihavka_N	žíhavka_None
legendární_A	legenda_None
retinální_A	retina_None
mešuge_A	mišuge_None
Jiříček_N	Jiřík_None
prkenný_A	prkno_None
florin_N	florén_None
osmiletka_N	osmiletý_None
virvár_N	virval_None
kaferský_A	Kafr_None
blikavka_N	blikačka_None
šprýmista_N	šprýmař_None
Šumavan_N	Šumava_None
kuzbaský_A	Kuzbas_None
cisterciačka_N	cisterciák_None
bandur_N	bandor_None
krchůvek_N	krchov_None
větřivo_D	větřivý_None
dopolední_A	dopoledne_None
dečička_N	dečka_None
jsoucno_N	jsoucný_None
Sašenka_N	Sáša_None
plazí_A	plaz_None
instinktivní_A	instinkt_None
profák_N	prófa_None
lycejní_A	lyceum_None
kartka_N	karta_None
zemlbába_N	semlbába_None
blatníček_N	blatník_None
třídní_N	třída_None
Janeček_N	Janek_None
Eugenie_N	Eugen_None
kupole_N	kopule_None
tvoreček_N	tvor_None
bagatelka_N	bagatela_None
tablo_N	tabló_None
hnedka_D	hnedky_None
gobijský_A	Gobi_None
hrudní_A	hruď_None
spodnička_N	spodnice_None
rýdovací_A	rejdovací_None
vakuolární_A	vakuola_None
Vind_N	Vend_None
ztichoučka_D	ztichounka_None
ředinký_A	řídký_None
nábřežní_A	nábřeží_None
trapper_N	traper_None
kapénka_N	kapka_None
šansona_N	šanson_None
zakvádlovat_V	zakvadlat_None
hlásek_N	hlas_None
říjenisko_N	říjiště_None
ouřezek_N	úřezek_None
Andalusan_N	Andalusie_None
barevný_A	barva_None
miloučce_D	milounký_None
čapí_A	čáp_None
ovruba_N	obruba_None
zajateček_N	zajatec_None
křížek_N	kříž_None
Florenčan_N	Florencie_None
zoft_N	soft_None
ostnokožec_N	ostnohřbetka_None
kora_N	kůra_None
řásný_A	řasný_None
furnýr_N	fornýr_None
známůstka_N	známost_None
velour_N	velur_None
šacunk_N	šacuňk_None
havana_N	Havana_None
budulínek_N	Budulínek_None
preceptorství_N	preceptor_None
zesvětačit_V	zesvětačet_None
parohovitý_A	parohatý_None
ledaskde_D	ledakde_None
nekale_D	nekalý_None
ustrašeneček_N	ustrašenec_None
pikolo_N	pikolík_None
konverze_N	konverse_None
štíhlátko_N	štíhle_None
Vilemína_N	Vilím_None
vzdušno_D	vzdušný_None
Poťomkin_N	Potěmkin_None
topůrko_N	topor_None
sídlištní_A	sídliště_None
šneček_N	šnek_None
záběrný_A	záběrový_None
vestibulární_A	vestibulum_None
kapínek_N	kapánek_None
kolegiální_A	kolegium_None
výčetný_A	výčet_None
negerka_N	negr_None
palcák_N	palčák_None
reeskompt_N	reeskont_None
pivovarní_A	pivovar_None
poznenáhlý_A	ponenáhlý_None
zákopní_A	zákopový_None
karmelitka_N	karmelitán_None
chobůtek_N	chobot_None
žalářný_A	žalářní_None
poslaneček_N	poslanec_None
zlatozářný_A	zlatozář_None
misijní_A	misie_None
Kliment_N	Klement_None
výplatný_A	výplatní_None
jahelný_A	jáhla_None
glagolský_A	hlaholský_None
žakýtek_N	žaket_None
ledakams_D	ledakam_None
samaritán_N	Samaritán_None
team_N	tým_None
Vladínek_N	Vladík_None
brdečko_N	brdo_None
prachy_N	prach_None
úkosný_A	úkosý_None
pestře_D	pestrý_None
páníček_N	páneček_None
presystolický_A	presystola_None
májovský_A	májovec_None
hořce_D	hořký_None
santiagský_A	Santiago_None
zrcadélko_N	zrcadlo_None
zkušebný_A	zkušební_None
doopravdovský_A	doopravdový_None
rang_N	rank_None
vpovzdálečí_D	vpozdáli_None
zádušný_A	záducha_None
verkštat_N	verštat_None
ostnitý_A	ostnatý_None
Rozára_N	Róza_None
prekluze_N	prekluse_None
Kornélie_N	Kornel_None
Württembersko_N	Württemberg_None
modranský_A	Modra_None
numizmatika_N	numismatika_None
kaberňák_N	kabrňák_None
Vendulička_N	Vendula_None
zrzka_N	zrzek_None
záměreček_N	záměr_None
Libuška_N	Libuše_None
studeň_N	studna_None
pojednáníčko_N	pojednání_None
přechovavatel_N	přechovávač_None
Aloisie_N	Alois_None
vozač_N	vozíčkář_None
vnadno_N	vnadný_None
škandál_N	skandál_None
kasematní_A	kasematy_None
vejstřeší_N	výstřeší_None
sednice_N	světnice_None
maklér_N	makléř_None
rolnička_N	rolna_None
chromajzlík_N	chromajzl_None
rekovný_A	rek_None
alespoň_D	aspoň_None
zmáhnout_V	zmanout_None
faráříček_N	farář_None
porubní_A	porub_None
senzitivní_A	sensitivní_None
prokukovat_V	prokouknout_None
republička_N	republika_None
koštéř_N	koštýř_None
Poříčí_N	poříčí_None
štucílek_N	štucl_None
ústavověrný_A	ústavověrec_None
mermomocí_D	mermo_None
sáhodlouze_D	sáhodlouhý_None
zpovolně_D	zpovolna_None
spahia_N	spahi_None
fach_N	foch_None
třenovní_A	třenový_None
královstvíčko_N	království_None
zápěstní_A	zápěstí_None
památka_N	památný_None
aktovčička_N	aktovka_None
ischiatický_A	ischias_None
švejk_N	Švejk_None
moučníček_N	moučník_None
jaternička_N	jitrnice_None
rozhlásek_N	rozhlas_None
chamradina_N	chamraď_None
Walesan_N	Wales_None
klásek_N	klas_None
veselůstka_N	veselost_None
borkyně_N	borec_None
návěštní_A	návěstní_None
erós_N	Erós_None
lehoučko_D	lehounký_None
pohádkoslovný_A	pohádkosloví_None
popředu_D	příst_None
otitida_N	otitis_None
pražský_A	Praha_None
klejt_N	glejt_None
stužtička_N	stuha_None
tyránek_N	tyran_None
nikosijský_A	Nikósie_None
ontarijský_A	Ontario_None
Žofička_N	Žofie_None
řachnout_V	řachat_None
jaderníček_N	jaderník_None
zupa_N	zupák_None
bouloňský_A	Boulogne_None
vembloud_N	velbloud_None
Cecilka_N	Cecílie_None
Beskydy_N	beskyd_None
basička_N	basa_None
Lojzinka_N	Lojza_None
měkce_D	měkký_None
vzdušní_A	vzdušný_None
vejřit_V	vejrat_None
vzdušno_N	vzdušný_None
pumpovní_A	pumpový_None
smutno_D	smutný_None
výdejný_A	výdej_None
mlsálek_N	mlsal_None
zkumavčička_N	zkumavka_None
žemně_N	žemle_None
štkavý_A	štkát_None
Aljoša_N	Alexej_None
Lothar_N	Lotar_None
Klenčí_N	Kleneč_None
odbory_N	odbor_None
kratičko_D	kratinký_None
jetelíček_N	jetel_None
jesen_N	jasan_None
zpolodarmo_D	zpolodarma_None
šintó_N	šintoismus_None
washingtonský_A	Washington_None
Irčan_N	Ir_None
brožka_N	brož_None
hradební_A	hradba_None
králík_N	král_None
Burma_N	Barma_None
světačka_N	světák_None
bezvýminečný_A	bezvýjimečný_None
Atéňan_N	Atény_None
pondělní_A	pondělí_None
šupa_N	šup_None
pošušňávat_V	pošušňat_None
apotéka_N	apatyka_None
Záporoží_N	Záporožec_None
trimorfní_A	trimorfie_None
vingl_N	vinkl_None
dopuštění_N	dopustit_None
macík_N	macek_None
kyperský_A	Kypr_None
pstroužek_N	pstruh_None
záprstní_A	záprstí_None
vonno_D	vonný_None
vozidýlko_N	vozidlo_None
výmazný_A	výmazní_None
ponejvíce_D	ponejvíc_None
ulmačka_N	ulmovka_None
klíneček_N	klínek_None
zbujný_A	zbojný_None
plevílek_N	plevel_None
rorátní_A	roráty_None
košerácký_A	košerák_None
ledaskdy_D	ledakdy_None
zvukoměřictví_N	zvukoměr_None
vaječnice_N	vaječník_None
flegmonózní_A	flegmóna_None
štěbetálek_N	štěbetal_None
Haličan_N	Halič_None
pony_N	poník_None
Venouš_N	Véna_None
maximalistický_A	maximalista_None
nehospodyně_N	nehospodář_None
zlatořásný_A	zlatořasný_None
zdálečí_D	zdalečí_None
čtvrtláník_N	čtvrtlán_None
vandlička_N	vandle_None
oseníčko_N	osení_None
Dorotka_N	Dorota_None
krmeleček_N	krmelec_None
siro_A	sirý_None
hnusno_D	hnusný_None
dědík_N	děd_None
kozák_N	kozačka_None
opravdivý_A	opravdový_None
dlanička_N	dlaň_None
tenko_N	tenký_None
povláček_N	povlak_None
taneční_N	tanec_None
přemet_N	přemetnout_None
surreálno_N	surreální_None
panamský_A	Panama_None
Hanýžka_N	Hana_None
urbárský_A	urbář_None
unitární_A	unitarismus_None
kašílek_N	kašel_None
větvovitý_A	větvový_None
tolárek_N	tolar_None
majuskulní_A	majuskule_None
jízdné_N	jízdný_None
satba_N	setba_None
šůsek_N	šos_None
škůdný_A	škodný_None
čvaňhal_N	čvaňha_None
pošetilůstka_N	pošetilost_None
rezonance_N	resonance_None
vyžloutlý_A	vyžlutlý_None
erbovní_A	erb_None
teskno_N	teskný_None
reální_A	reálný_None
blíženkyně_N	blíženec_None
tepénka_N	tepna_None
čeřínek_N	čeřen_None
Ještědí_N	Ještěd_None
Toníček_N	Toník_None
kararský_A	Carrara_None
žalno_D	žalný_None
rezovatý_A	rezivý_None
družička_N	družice_None
odstín_N	podtón_None
cvrčíček_N	cvrček_None
pinglík_N	pingl_None
koreček_N	korec_None
filmeček_N	film_None
tepenný_A	tepna_None
chiliastický_A	chiliasta_None
Viléma_N	Vilím_None
přemnohý_N	mnohý_None
vilik_N	vilikus_None
bordeaux_N	Bordeaux_None
halifaxy_N	halifaxky_None
Mexičan_N	Mexiko_None
omalovánky_N	malovánka_None
pícní_A	píce_None
srážlivý_A	sráživý_None
Hildička_N	Hilda_None
Neapolitán_N	Neapol_None
Valachie_N	Valach_None
Petřík_N	Petr_None
Terezička_N	Terezie_None
strnišťový_A	strniskový_None
herkules_N	Herkules_None
byteček_N	byt_None
záštný_A	záštní_None
eskompt_N	eskont_None
koronální_A	koróna_None
Tartar_N	Tartaros_None
ordinárius_N	ordinář_None
vrápka_N	vrap_None
alpínum_N	alpinum_None
elektrotechnička_N	elektrotechnik_None
přívratný_A	přívrat_None
hystereze_N	hysterese_None
den_N	nabíledni_None
Jákob_N	Jakub_None
zarezovatělý_A	zarezavělý_None
bujaře_D	bujarý_None
voroplavec_N	voroplavba_None
čtvero_N	čtverý_None
trubčí_A	trubec_None
prubéř_N	prubíř_None
příměrný_A	příměří_None
jikernatý_A	jikrnatý_None
imaginativní_A	imaginace_None
věžovatý_A	věžatý_None
zářijový_A	září_None
mythický_A	mytický_None
přenádherný_A	nádherný_None
konzola_N	konsola_None
uběrací_A	ubírací_None
bijáček_N	biják_None
vášnivkyně_N	vášnivec_None
bismut_N	vizmut_None
Habešan_N	Habeš_None
vřeten_N	vřeteň_None
rozvlálý_A	rozevlátý_None
cukrdle_N	cukrle_None
amazonka_N	Amazonka_None
tarzální_A	tarsální_None
chrtík_N	chrt_None
role_N	rula_None
zubří_A	zubr_None
bantovat_V	buntovat_None
čenstochovský_A	Čenstochová_None
zaječička_N	zaječice_None
Etrusk_N	Etrurie_None
klyzma_N	klysma_None
chechot_N	chechtot_None
zbabčelý_A	zbabčilý_None
středohorský_A	středohoří_None
šťouchat_V	šťuchat_None
ticho_D	tichý_None
štofeček_N	štof_None
prakticistický_A	prakticista_None
hrádecký_A	hrádek_None
kolíbčička_N	kolébka_None
řásně_N	řasný_None
nanejvíce_D	nanejvíc_None
Tyrolka_N	Tyrolsko_None
konsekutivní_A	konsekuce_None
provlíknout_V	provléci_None
poloninský_N	polonina_None
kořenáček_N	kořenáč_None
kontíčko_N	konto_None
jak_N	jakž_None
próba_N	průba_None
brestský_A	Brest_None
tejden_N	týden_None
ukolébačka_N	ukolébavka_None
předlouze_D	předlouhý_None
včála_N	včela_None
stupínek_N	stupeň_None
vyhubenělý_A	vyhubělý_None
bratrovrah_N	bratrovražda_None
třaskot_N	třeskot_None
knoflikářství_N	knoflíkářství_None
zoufanlivý_A	zoufalec_None
Bělorus_N	Bílá_None
Anynka_N	Anina_None
zvavý_A	zvát_None
řídko_N	řídký_None
máknout_V	makat_None
svícnový_A	svícen_None
pošmourno_D	pošmourný_None
konfekcionářský_A	konfekcionář_None
trus_N	výtrus_None
poplužní_A	popluží_None
deklarativní_A	deklarace_None
byznys_N	business_None
hornička_N	horna_None
vydýřit_V	vydejřit_None
sukénka_N	sukně_None
balzám_N	balšám_None
krychelný_A	krychle_None
zaměstnaneček_N	zaměstnanec_None
bosky_D	bosý_None
zvenčí_D	zvenku_None
syrovo_D	syrový_None
primaciální_A	primas_None
zarmutlivý_A	zármutný_None
maltézský_N	Malta_None
zátečka_N	zátka_None
oblačno_D	oblačný_None
zhostní_A	zhost_None
krapánek_D	krapínek_None
jiskérka_N	jiskra_None
úklonný_A	úklon_None
zákrslík_N	zakrslík_None
robka_N	roba_None
Saturnus_N	Saturn_None
vlákenný_A	vlákno_None
brzoučko_D	brzičko_None
Hedvička_N	Hedvika_None
pracharanda_N	prachanda_None
učenlivý_A	učelivý_None
maloměšťanstvo_N	maloměšťan_None
hřebčí_A	hřebec_None
historka_N	historie_None
Joza_N	Józa_None
vraňátko_N	vráně_None
útloboce_D	útloboký_None
putýnka_N	putna_None
žufánek_N	šufan_None
blátivo_D	blátivý_None
včelný_A	včela_None
wagnerismus_N	wagnerianismus_None
urbariálný_A	urbární_None
vidinný_A	vidina_None
datlovník_N	datle_None
kouzlíčko_N	kouzlo_None
zřídelní_A	zřídlo_None
amerika_N	Amerika_None
tyčkovina_N	tyčovina_None
špíček_N	špek_None
polsko_N	Polák_None
aktovečka_N	aktovka_None
druhohorní_A	druhohory_None
pinčl_N	pinč_None
blata_N	Blata_None
trojčátko_N	trojče_None
lípaneček_N	lepanec_None
svistot_N	svist_None
paží_N	paždí_None
zimový_A	zimní_None
dračice_N	drak_None
verštátek_N	veřtat_None
pertuse_N	pertusis_None
Norvéžsko_N	Nor_None
žádoucný_A	žádoucí_None
Afričan_N	Afrika_None
přehršel_N	přehršle_None
sadební_A	sadbový_None
Germánie_N	Germán_None
nadevšecko_D	nadevše_None
krevnatý_A	plnokrevník_None
identický_A	identita_None
guberniální_A	gubernie_None
nemohoucný_A	nemohoucí_None
paragráfek_N	paragraf_None
horizontář_N	horizontkář_None
přepestře_D	přepestrý_None
pipina_N	pipka_None
štuchnout_V	šťuchnout_None
příjičný_A	příjice_None
goliáš_N	Goliáš_None
divotvorce_N	divotvůrce_None
podkovitý_A	podkovovitý_None
láje_N	láj_None
dozický_A	dosický_None
kelim_N	kilim_None
Bořivoj_N	Bořek_None
dcerunka_N	dcera_None
bobří_A	bobr_None
Melanésan_N	Melanésie_None
záprdek_N	záprtek_None
pastevní_A	pastva_None
trošinku_D	troška_None
tangenta_N	tangens_None
prso_N	prs_None
nultý_A	nula_None
žvatlálek_N	žvatlal_None
zbojce_N	zbůjce_None
Argentinec_N	Argentina_None
stovečka_N	stovka_None
Mirek_N	Mírek_None
režný_A	rež_None
vychytřelý_A	vychytralý_None
Španihel_N	Španěl_None
Štýřan_N	Štýrsko_None
chytře_D	chytrý_None
čičorečka_N	čičorka_None
chudera_N	chuděra_None
pohádečka_N	pohádka_None
prolítnout_V	proletět_None
poslíček_N	posel_None
zvenka_D	zvenčí_None
závratno_D	závratný_None
mefisto_N	Mefisto_None
zalihotat_V	zaligotat_None
Tádžikistán_N	Tádžik_None
mezaliance_N	mesaliance_None
Ančička_N	Anča_None
proso_N	prosík_None
zrcátko_N	zrcadlo_None
stejnak_D	stejně_None
zábradelní_A	zábradlový_None
zápecný_A	zápecní_None
Itálie_N	Ital_None
předevčírek_N	předvčerejšek_None
šmirglpapír_N	šmirgl_None
zákřoví_N	zákří_None
prašno_N	prašný_None
země_N	zem_None
lankrabství_N	lankrabě_None
Slavonsko_N	Slavonie_None
znamínko_N	znamení_None
vochlička_N	vochle_None
vstoje_D	stojací_None
Pražka_N	Praha_None
Malajsko_N	Malajec_None
Emička_N	Ema_None
škádlílek_N	škádlil_None
chlubílek_N	chlubil_None
vinice_N	viník_None
gobelín_N	goblén_None
pronájemce_N	pronajímatel_None
tolikerý_A	tolik_None
slez_N	sléz_None
břitce_D	břitký_None
celulární_A	celula_None
jenjen_D	jen_None
kananejský_A	Kanaán_None
pikartka_N	pikart_None
střelný_A	střelit_None
radovat_V	radýrovat_None
Lojzek_N	Lojza_None
zlatovousý_A	zlatovous_None
mokřad_N	mokřaď_None
poznenáhlu_D	ponenáhlu_None
snášenlivý_A	snášelivý_None
mincovní_A	mince_None
sroubek_N	srub_None
Kopanice_N	kopanice_None
Johana_N	Johan_None
Frýgie_N	Frýg_None
frnknout_V	frknout_None
nuselský_A	Nusle_None
Kypřan_N	Kypr_None
stotisící_A	sto_None
ušmudlánek_N	ušmudlanec_None
hořko_N	hořký_None
sklerální_A	skléra_None
chróm_N	chrom_None
škrtílek_N	škrtil_None
černobýlí_N	černobýl_None
kolchozní_A	kolchoz_None
výslužné_N	výslužný_None
jaterní_A	játra_None
vyšklibovat_V	vyšklebit_None
Bělehraďan_N	Bělehrad_None
persekuce_N	perzekuce_None
grešlička_N	grešle_None
bruneta_N	brunet_None
idololatrie_N	idolatrie_None
vytřípat_V	vytřepávat_None
zátěrečka_N	zátěrka_None
Palestinec_N	Palestina_None
podpěnka_N	podpínka_None
konstantinopolský_A	Konstantinopol_None
tisícerý_A	tisíc_None
Pepíček_N	Pepa_None
čelední_A	čeleď_None
štimovat_V	štymovat_None
prašno_D	prašný_None
panička_N	paní_None
cáchovna_N	cechovna_None
rúrský_A	ruhrský_None
škrobovna_N	škrobárna_None
chřaplavý_A	křaplavý_None
kavárna_N	velkokavárna_None
šedo_N	šedý_None
umístit_V	vstavit_None
tabulička_N	tabule_None
vpoly_D	vpolo_None
lumpenproletář_N	lumpenproletariát_None
bezmrazný_A	bezmrazý_None
jezevčátko_N	jezevče_None
ležáček_N	ležák_None
medúza_N	Medusa_None
hrabky_N	hrábě_None
středeční_A	středa_None
křečný_A	křeč_None
křivičný_A	křivice_None
Ludvika_N	Ludvík_None
zoufalkyně_N	zoufalec_None
písecký_A	Písek_None
vratko_D	vratký_None
rožmberský_A	Rožmberk_None
předobrý_A	dobrý_None
registr_N	rejstřík_None
Nymburčan_N	Nymburk_None
slépka_N	slípka_None
chloupek_N	chlup_None
vdovní_A	vdoví_None
křisitel_N	křísitel_None
kroužkovitý_A	kroužek_None
univerzální_A	universální_None
vlásinový_A	vlasinový_None
vochtrovna_N	vechtrovna_None
konfesní_A	konfese_None
pětinásobek_N	pětinásobný_None
lehoučce_D	lehounký_None
třetiřadý_A	podřadný_None
zemlanka_N	zemljanka_None
Miluška_N	Miluše_None
žinantní_A	ženantní_None
studeno_N	studený_None
vtipař_N	vtipkář_None
vyslanstvo_N	vyslanectvo_None
tolar_N	dolar_None
šemík_N	Šemík_None
Vládínek_N	Vladík_None
varhánky_N	varhany_None
výpovědní_A	výpověď_None
krční_A	krk_None
Augustin_N	Gustav_None
rozvoj_N	rozvin_None
odpolední_A	odpoledne_None
lebečka_N	lebka_None
řehotný_A	řehot_None
pitoma_N	pitomec_None
mladičký_A	mladinký_None
ústavodárný_A	ústavodárce_None
znání_N	neznání_None
Jituška_N	Jitka_None
oflakovat_V	oflákat_None
Stáníček_N	Stáňa_None
štamprdle_N	štamprle_None
bezesporu_D	bezesporný_None
kraťoučce_D	kraťounký_None
zmužný_A	zmužilý_None
žernůvek_N	žernov_None
chichtot_N	chichot_None
záduma_N	zadumanec_None
Lotar_N	Lothar_None
posesorní_A	posesor_None
třapec_N	střapec_None
osmiúhelný_A	osmiúhlý_None
rýmička_N	rýma_None
čerňounký_A	čerňoučký_None
břichomluvec_N	břichomluva_None
rumisko_N	rumiště_None
údolní_A	údolí_None
bandonium_N	bandoneon_None
zdůraznit_V	podškrtnout_None
fetální_A	fétus_None
panonský_A	Panonie_None
sádeček_N	sad_None
kupní_A	kup_None
koncilní_A	koncil_None
ramplovat_V	rumplovat_None
cestní_A	cesta_None
zášer_N	zášeří_None
líno_D	líný_None
opak_N	naopak_None
harenda_N	arenda_None
řepovisko_N	řepoviště_None
šeptmistr_N	šepmistr_None
vycicat_V	vycucat_None
Kerberos_N	Cerber_None
Vladimíra_N	Vladimír_None
rektální_A	rektum_None
vrkůček_N	vrkoč_None
směneční_A	směnečný_None
signatární_A	signatář_None
záhřivný_A	záhřevný_None
Janoško_N	Jánoš_None
železnický_A	železník_None
portské_N	portský_None
nazpátek_D	nazpět_None
střelmistrovský_A	střelmistr_None
beduín_N	Beduín_None
měkko_N	měkký_None
prudko_N	prudký_None
vlhce_D	vlhký_None
bodovka_N	bodovačka_None
myšátko_N	myše_None
zodiakální_A	zodiak_None
kojeňátko_N	kojeně_None
clematis_N	klematis_None
Iliada_N	Ilias_None
Valérie_N	Valinka_None
Xaverius_N	Xaver_None
zpěvoherec_N	zpěvohra_None
ostének_N	osten_None
kníničský_A	Kníničky_None
chuďounký_A	chuďoučký_None
dranc_N	nadranc_None
vřetenovky_N	vřetenky_None
pyje_N	pyj_None
pramének_N	pramen_None
tržný_A	tržní_None
ataka_N	atak_None
pirožka_N	pirožek_None
pomaličku_D	pomalinku_None
bouřliváček_N	bouřlivák_None
byznysmen_N	businessman_None
dextróza_N	dextrosa_None
zlatičký_A	zlaťoučký_None
bór_N	bor_None
fukárek_N	fukar_None
zchytřet_V	zchytrat_None
přimáčknout_V	přivalit_None
bratrovražda_N	bratrovrah_None
kosmonoský_A	Kosmonosy_None
dezinfekce_N	desinfekce_None
melanéský_A	Melanésie_None
trpce_D	trpký_None
přítelíček_N	přítel_None
průba_N	próba_None
vonidlo_N	voňadlo_None
vrchnoradovský_A	vrchní_None
Arábie_N	Arab_None
slívka_N	slíva_None
oxygen_N	oxygenium_None
díkůvzdání_N	díkuvzdání_None
črtka_N	črta_None
kápí_N	kápě_None
Hercegovec_N	Hercegovina_None
Metud_N	Metoděj_None
hmat_N	chmat_None
vínek_N	věnec_None
příkůpek_N	příkop_None
regulární_A	regulérní_None
nakonec_D	konec_None
skromňounce_D	skromňoučký_None
bankovní_A	banka_None
podřízený_N	podřídit_None
Barmánec_N	Barma_None
Evženie_N	Evžen_None
zrovninka_D	zrovinka_None
růženeček_N	růženec_None
štětinka_N	štětina_None
karikaturka_N	karikatura_None
orchestříček_N	orchestr_None
znenadajky_D	znenadaja_None
lajdáček_N	lajdák_None
žernosecké_N	Žernoseky_None
výjezdný_A	výjezdní_None
Hanýsek_N	Hanys_None
Toskána_N	Toskánsko_None
aramejský_A	Aram_None
aerobní_A	aerob_None
Jindříšek_N	Jindřich_None
Bavory_N	Bavorsko_None
povahokresebný_A	povahokresba_None
potad_D	potaď_None
grošíček_N	groš_None
čteníčko_N	čtení_None
podružný_A	podruží_None
Tony_N	Toni_None
lehounko_D	lehounký_None
liberka_N	libra_None
podstřeší_N	podstřešek_None
sporo_D	sporý_None
kose_N	kosý_None
studijní_A	studium_None
zřídkavý_A	zřídký_None
ještěřice_N	ještěrka_None
znovu_D	znova_None
rožek_N	růžek_None
bláha_N	blaho_None
ťapkot_N	ťapot_None
sofizma_N	sofisma_None
bezhlasný_A	bezhlasý_None
virginál_N	virginal_None
deka_N	deko_None
Květa_N	Květuše_None
vavřinčák_N	vavřiňák_None
výherní_A	výhra_None
mílek_N	Mílek_None
linoleový_A	linoleum_None
kraťounký_A	krátký_None
misogynství_N	misogyn_None
přípřežný_A	přípřež_None
zástěrečka_N	zástěra_None
dějinný_A	dějiny_None
štěrkárna_N	štěrkovna_None
krk_N	krkatý_None
ustrachovaný_A	ustrašený_None
andělí_A	anděl_None
dudačka_N	dudák_None
paterý_A	pět_None
schematický_A	schéma_None
zlundračit_V	zludračet_None
plíčky_N	plíce_None
vrtulníček_N	vrtulník_None
jahodina_N	jahodí_None
biřmovanka_N	biřmovanec_None
kližka_N	klihovka_None
padanka_N	padavka_None
smoking_N	smokink_None
okenice_N	okénečko_None
šizunk_N	šizuňk_None
kratičce_D	kratinký_None
dělíčko_N	dělo_None
roztaživý_A	roztažný_None
ofábořený_A	ofáborovaný_None
přerozmanitý_A	rozmanitý_None
bratrovražedný_A	bratrovrah_None
zrzatý_A	zrzavý_None
offside_N	ofsajd_None
naprázdno_D	prázdný_None
začasté_D	začasto_None
Františka_N	František_None
políbeníčko_N	políbení_None
zdířka_N	zděř_None
vyzyvatel_N	vyzývatel_None
čakánek_N	čakan_None
králický_A	Králíky_None
filištín_N	Filištín_None
hebce_D	hebký_None
průvodný_A	průvodní_None
eruptivní_A	erupce_None
Řehůřek_N	Řehoř_None
ústaveček_N	ústav_None
doteďka_D	doteď_None
Blata_N	blata_None
záleský_A	zálesí_None
nadreálno_N	nadreální_None
zdědkovatět_V	dědkovatět_None
hřívečka_N	hříva_None
prvoligový_A	první_None
žákyně_N	žák_None
prvohorní_A	prvohory_None
vyprašovák_N	vyprašovač_None
trumfovní_A	trumf_None
Detvan_N	Detva_None
herynek_N	herynk_None
oddych_N	oddech_None
tuho_D	tuhý_None
pecka_N	pec_None
Vincek_N	Vinca_None
záhumek_N	záhumeň_None
cyperský_A	Kypr_None
spájedlo_N	spáječka_None
zubný_A	zub_None
smolnička_N	smolnice_None
vazce_D	vazký_None
prouha_N	proužek_None
vespol_D	vespolek_None
raznička_N	raznice_None
vrátce_N	vratký_None
panstvíčko_N	panství_None
přejný_A	přející_None
oborní_A	obora_None
drajv_N	drive_None
kořaleční_A	kořalka_None
Olympan_N	Olymp_None
depot_N	depo_None
vestoje_D	vstoje_None
mandibulární_A	mandibula_None
nadskutečno_N	nadskutečný_None
rudohlavý_A	rudohlávek_None
leckams_D	leckam_None
vítavý_A	vítat_None
křoustat_V	křupat_None
žleb_N	žlab_None
isomorfie_N	izomorfie_None
měštka_N	měšťák_None
vichřičný_A	vichřice_None
odkap_N	okap_None
estuárium_N	estuár_None
řešato_N	řešeto_None
Uran_N	uran_None
enzymatický_A	enzym_None
paralaktický_A	paralaxa_None
uhlíčko_N	uhlí_None
veždy_D	vždy_None
vlídno_N	vlídný_None
záložnička_N	záložna_None
hofmistrovský_A	hofmistr_None
Sváťa_N	Svata_None
piliár_N	biliár_None
labuťátko_N	labutě_None
prýmka_N	prýmek_None
démotický_A	démos_None
převodný_A	převod_None
mizet_V	lézt_None
větérek_N	vítr_None
vlasta_N	Vlasta_None
trakářek_N	trakař_None
hradecký_A	hradec_None
zvolilinka_D	zvolňoučka_None
knůtek_N	knot_None
poštovní_A	pošta_None
svlíknout_V	svléci_None
solitární_A	solitérní_None
kdyže_D	kdy_None
výstřednůstka_N	výstřednost_None
diluviální_A	diluvium_None
vrapa_N	vrap_None
zavazadélko_N	zavazadlo_None
zpěvno_D	zpěvný_None
zpolehoučku_D	zpolehounka_None
onehdá_D	onehdy_None
vzpomínečka_N	vzpomínka_None
zmijinský_A	zmijský_None
věterný_A	větrný_None
lyrička_N	lyrik_None
pinklíček_N	pingl_None
větoslovný_A	větosloví_None
jubileum_N	jubilovat_None
prašulky_N	prašule_None
vzdušný_A	vzduch_None
kdež_D	kde_None
zápašek_N	zápach_None
ambulatorní_A	ambulatorium_None
čerchmant_N	čechman_None
buntovat_V	bantovat_None
můstek_N	most_None
umrlčí_A	umrlec_None
vegetárka_N	vegetárna_None
zpolehoučka_D	zpolehounka_None
stearín_N	stearin_None
čočovička_N	čočovice_None
proštudovat_V	prostudovat_None
Ferdyš_N	Ferda_None
přítužný_A	přitahování_None
mlhavo_D	mlhavý_None
stehenní_A	stehno_None
čachřík_N	čachr_None
tchořík_N	tchoř_None
zpozdálí_D	zpozdáli_None
obídek_N	oběd_None
Švejda_N	Švéd_None
bederní_A	bedra_None
vlhko_N	vlhký_None
karafinka_N	karafa_None
Tunisko_N	Tunis_None
nedělička_N	neděle_None
kolegáček_N	kolega_None
písárna_N	pisárna_None
stříhárna_N	střihárna_None
průplet_N	proplet_None
zámět_N	záměť_None
sluj_N	sloj_None
vazební_A	vazebný_None
páneček_N	pan_None
rozpíček_N	rozpek_None
vika_N	vikev_None
post_N	půst_None
Slezsko_N	Slezan_None
oblomovština_N	Oblomov_None
délka_N	Adéla_None
pracinka_N	pracka_None
droboučce_D	drobounký_None
Bosňan_N	Bosna_None
přečasto_D	přečastý_None
přechytře_D	přechytrý_None
trapno_D	trapný_None
podivnůstka_N	podivnost_None
záhumení_N	záhumní_None
hlučno_D	hlučný_None
závírka_N	zavírka_None
Kamýk_N	kamýk_None
jaderný_A	jádro_None
pašalik_N	pašalík_None
chuďoučce_D	chuďoučký_None
půlkilovka_N	půlkilo_None
žilový_A	žíla_None
bandička_N	banda_None
Vergilius_N	Vergil_None
bizoní_A	bizon_None
přehoušel_N	přehršle_None
věštka_N	věštec_None
terciérní_A	terciér_None
vtipkálek_N	vtipkal_None
zbůj_N	zboj_None
zodiakus_N	zodiak_None
chumelice_N	chumelenice_None
rohlíčkář_N	rohlíkář_None
roajalista_N	royalista_None
skot_N	Skot_None
činovatina_N	činovať_None
kotletky_N	kotleta_None
pavláčka_N	pavlač_None
pudrovačka_N	pudrátko_None
zajisto_D	zajisté_None
memorandový_A	memorandum_None
perka_N	perko_None
sugestivní_A	sugesce_None
batůžek_N	batoh_None
vulgarizace_N	vulgarismus_None
blaze_D	blahý_None
vplyv_N	vliv_None
přihroublý_A	přihrublý_None
pravdička_N	pravda_None
cvičebný_A	cvičební_None
kožíšek_N	kožich_None
fyskulturník_N	fyskultura_None
kapesní_A	kapsa_None
molekulární_A	molekula_None
cizineček_N	cizinec_None
sortovat_V	sortýrovat_None
litomyšlský_A	Litomyšl_None
draselný_A	draslo_None
sprosťačka_N	sprosťák_None
nedávno_N	nedávný_None
stavební_A	stavba_None
rorejs_N	rorýs_None
šestistěnný_A	šestistěn_None
zořička_N	zoře_None
nantský_A	Nantes_None
jasnopoljanský_A	Jasná_None
účelík_N	účel_None
bambula_N	bambule_None
vtípek_N	vtip_None
stádce_N	stádo_None
roláda_N	ruláda_None
reagencie_N	reagens_None
normál_N	norma_None
vesní_A	vesničan_None
dimorfní_A	dimorfie_None
uhýlek_N	uhel_None
oktávie_N	Oktávie_None
něžňounce_D	něžňounký_None
tříroční_A	tříroček_None
sněhurka_N	Sněhurka_None
Ludvička_N	Ludvík_None
sex_N	sexus_None
vlýska_N	vlýsek_None
vyblemtnout_V	vybleptnout_None
Evička_N	Eva_None
peluňka_N	pelyněk_None
bezmraký_A	bezmračný_None
záslibný_A	záslibní_None
vousy_N	vousatět_None
pilnice_N	pilník_None
koutní_A	kout_None
amoleta_N	omeleta_None
zbředit_V	zbřídit_None
kalorimetricky_D	kalorimetr_None
presenilní_A	presenium_None
Léna_N	Lenka_None
vejpůlky_D	vejpůl_None
zpěvohříčka_N	zpěvohra_None
Vincenc_N	Vinca_None
difúzní_A	difusní_None
nestvůrčička_N	nestvůra_None
hupky_D	hopky_None
marokánka_N	Marokánka_None
brebtat_V	breptat_None
šampaňské_N	šampaňský_None
Kbely_N	Gbely_None
vratislavský_A	Vratislav_None
sklínečka_N	sklenice_None
klíh_N	klih_None
hmoždíř_N	moždíř_None
pulovřík_N	pulovr_None
Katalánsko_N	Katalánie_None
zkořen_D	zkořán_None
ztečný_A	zteč_None
výčepný_A	výčepní_None
rondó_N	rondo_None
vyvolenka_N	vyvolenec_None
úboční_A	úbočný_None
ostrůvek_N	ostrov_None
Karel_N	Karlík_None
pomaloběžný_A	pomaluběžný_None
nezměrný_A	nezměřitelný_None
Bedřiška_N	Bedřich_None
vlasostřižna_N	vlasostřih_None
žerdička_N	žerď_None
kanáří_A	kanár_None
obálčička_N	obálka_None
droboučký_A	drobounký_None
dratvička_N	dratev_None
kušnička_N	kušna_None
neodymitý_A	neodym_None
gerontoložka_N	gerontolog_None
laxativum_N	laxans_None
lepota_N	lepost_None
honem_D	hon_None
borek_N	bor_None
dveřní_A	dveře_None
eliptický_A	elipsa_None
žehnátko_N	žehnáček_None
vachmajstr_N	vachmistr_None
okruh_N	okruží_None
borta_N	porta_None
zářecký_A	zářečí_None
konzistence_N	konsistence_None
nebulární_A	nebula_None
zoufalivý_A	zoufalý_None
veménko_N	vemeno_None
selfmademanství_N	selfmademan_None
žandár_N	žandarm_None
šprusel_N	šprycl_None
obcička_N	obec_None
analistický_A	analista_None
vsatský_A	Vsetín_None
Podještědí_N	Ještěd_None
podnožka_N	podnož_None
veřeje_N	veřej_None
saský_A	Sas_None
Šišák_N	šišák_None
Féničan_N	Fénicie_None
žalářní_N	žalář_None
zlatodějný_A	zlatoděj_None
makovníček_N	makovník_None
Tatrovka_N	tatrovka_None
rýmovní_A	rým_None
půlmilionář_N	půlmilion_None
mysteriózní_A	mystérium_None
děvenka_N	dívka_None
vyšklíbat_V	vyšklibovat_None
zástřeška_N	zástřeší_None
jikernáč_N	jikrnáč_None
překrutý_A	krutý_None
taneční_A	tanec_None
pokoušivý_A	pokoušet_None
bezeškodný_A	bezškodný_None
Věruška_N	Věra_None
neurastenička_N	neurastenik_None
vyběravý_A	vybíravý_None
tříčtvrtka_N	tříčtvrteční_None
šupna_N	šopa_None
srážkoměrný_A	srážkoměr_None
vůnička_N	vůně_None
trojský_A	Trója_None
deminutivní_A	deminutivum_None
kojeneček_N	kojenec_None
zlaťounký_A	zlatičký_None
nehýtek_N	nehet_None
věrolomstvo_N	věrolomný_None
veveřina_N	veverčina_None
klenotnička_N	klenotnice_None
syřišťový_A	syřiště_None
Asyřan_N	Asýrie_None
velice_D	velký_None
restante_N	poste_None
proběh_N	průběh_None
bílkovitý_A	bílkovina_None
verkovní_A	verk_None
Bosňák_N	Bosna_None
šestispřežení_N	šestispřeží_None
zhlavek_N	zhlavec_None
bohosloví_N	bohoslovec_None
Leopolda_N	Leopold_None
mořeplavec_N	mořeplavba_None
provázeček_N	provaz_None
svetýrek_N	svetr_None
rvavý_A	rvát_None
labrador_N	Labrador_None
lajska_N	lajsna_None
estetično_N	estetický_None
akvarijní_A	akvárium_None
kultus_N	kult_None
tržební_A	tržba_None
kořalečka_N	kořalka_None
divo_D	divý_None
kypře_D	kyprý_None
řetízek_N	řetěz_None
zepředu_D	zpředu_None
neřkuli_D	neřku_None
Vladislav_N	Vláďa_None
pilný_A	napilno_None
šohajík_N	šuhaj_None
husárek_N	husar_None
zblizounka_D	zblizoučka_None
Jura_N	jura_None
obočíčko_N	obočí_None
sem_D	semhle_None
nizounko_D	nizoučký_None
fuksa_N	fuks_None
blízce_D	blízký_None
veršováníčko_N	veršování_None
soupeřství_N	řevnivost_None
zakančit_V	zakaňkat_None
genocida_N	genocidium_None
propástka_N	propast_None
ploše_D	plochý_None
doktrinární_A	doktrína_None
zvědy_N	zvěd_None
šaržička_N	šarže_None
lux_N	luxus_None
elektivní_A	elekce_None
kreozot_N	kreosot_None
eluviální_A	eluvium_None
konývka_N	konev_None
haše_N	hašé_None
krvavý_A	krev_None
nůžtičky_N	nůžky_None
žemla_N	žemle_None
pobratimství_N	pobratim_None
hranečník_N	hraničník_None
punclák_N	puclák_None
tritonus_N	tritón_None
mystérie_N	mystérium_None
šístka_N	šesták_None
voračka_N	oračka_None
samčí_A	samec_None
malíček_N	malík_None
ženačka_N	ženáč_None
burundský_A	Burundi_None
přívěšek_N	přívěsek_None
hastrmánek_N	hastrman_None
víničko_N	víníčko_None
bůh_N	pánbůh_None
vyprahlo_N	vyprahlý_None
batumský_A	Batumi_None
pažní_A	paže_None
předraho_D	předrahý_None
obležení_N	oblehnout_None
beroušek_N	berunka_None
slepáček_N	slepák_None
pikel_N	pikle_None
cize_D	cizí_None
večernička_N	večernice_None
bosňák_N	Bosňák_None
bezpohlavný_A	bezpohlavní_None
vyprat_V	přeprat_None
kořeníčko_N	koření_None
labutěnka_N	labuť_None
svatka_N	svat_None
Cerberus_N	Cerber_None
dvouletek_N	dvouletka_None
pythagorejec_N	pythagorovec_None
zsinavý_A	zsinat_None
Julínek_N	Julius_None
zpejchnout_V	zpychnout_None
rakovnický_A	Rakovník_None
říjniště_N	říjiště_None
tříproudý_A	tříproudový_None
verkšucák_N	verkšuc_None
Turek_N	Turecko_None
řečinka_N	řeč_None
ležačka_N	ležák_None
vajdošek_N	vajda_None
živůtek_N	život_None
přenešťastný_A	nešťastný_None
kontoár_N	kontor_None
Olomoučan_N	Olomouc_None
Jurka_N	Jura_None
ultimativní_A	ultimátum_None
Kunhuta_N	Kunka_None
Bosna_N	Bosňák_None
xantipa_N	Xantipa_None
veprostřed_D	vprostřed_None
pindík_N	pinďour_None
Tyroly_N	Tyrolsko_None
intenzita_N	intensita_None
paschální_A	pascha_None
pahejl_N	pahýl_None
žízeň_N	žíznivec_None
zbožní_A	zboží_None
Prajzsko_N	Prajz_None
šikulda_N	šikula_None
pastorkyně_N	pastorek_None
triko_N	trikot_None
těsno_D	těsný_None
raz_D	ráz_None
Kolobřeh_N	Kolobrzeg_None
konstituce_N	konstrukce_None
zponenáhlu_D	zponenáhla_None
třasavisko_N	třasovisko_None
poblíž_D	poblízku_None
mobiliární_A	mobilární_None
bezezvučný_A	bezzvuký_None
chmelíček_N	chmel_None
žilenka_N	žíla_None
obouruční_A	obouruč_None
savčí_A	savec_None
aortální_A	aorta_None
arab_N	Arab_None
půnebí_N	podnebí_None
rafika_N	rafije_None
včas_D	nevčas_None
sympodiální_A	sympodium_None
zatouhlý_A	zatuhlý_None
zblíčko_N	zblo_None
clonný_A	clona_None
jak_D	jakž_None
čiřidlo_N	čiřicí_None
Matyáš_N	Matěj_None
výhostný_A	výhostní_None
pobídka_N	vybídka_None
zlejduch_N	zloduch_None
Pragovka_N	pragovka_None
stulpna_N	štulpna_None
branzole_N	branzol_None
ediktální_A	edikt_None
bočný_A	boční_None
hledáček_N	hledač_None
klusavý_A	klusat_None
Jeseníky_N	Jeseník_None
hrabička_N	hrabice_None
okůvek_N	okov_None
luska_N	lusk_None
trdýlko_N	trdlo_None
šramůtek_N	šramot_None
brankařský_A	brankář_None
kvádřík_N	kvádr_None
počty_N	počet_None
jakkoliv_D	jakkoli_None
podleský_A	podlesí_None
příční_A	příčný_None
lapovací_A	lapování_None
žravý_A	žrát_None
Galie_N	Gal_None
žábátko_N	žábě_None
bordó_N	Bordeaux_None
kontribučenský_A	kontribuce_None
zápěnka_N	zápinka_None
zybák_N	zibák_None
miliardtý_A	miliarda_None
převysoký_A	vysoký_None
afélium_N	afel_None
přehořce_D	přehořký_None
žebříčko_N	žebírko_None
darwinovec_N	darwinista_None
zhasínavý_A	zhasínat_None
modrounce_D	modroučký_None
vyžel_N	vyžle_None
nalezeneček_N	nalezenec_None
dvojenka_N	dvojenec_None
flámeček_N	flám_None
vědomůstka_N	vědomost_None
Anuše_N	Anna_None
volha_N	Volha_None
protokolní_A	protokol_None
pohova_N	pohov_None
žilečka_N	žíla_None
rybniční_A	rybničný_None
tříaktovka_N	tříaktový_None
vzlétavo_D	vzlétavý_None
zklackovitět_V	zklackovatět_None
entuziasmus_N	entusiasmus_None
municipální_A	municipium_None
sukýnko_N	sukno_None
pořez_N	pořízek_None
uretrální_A	uretra_None
Kanaďan_N	Kanada_None
tanganický_A	Tanganika_None
uchichtnout_V	uchechtnout_None
Nizozemí_N	Nizozemsko_None
kok_N	koks_None
Karlíček_N	Karlík_None
klenebný_A	klenbový_None
Cínovec_N	cínovec_None
Boloňa_N	Bologna_None
svědkyně_N	svědek_None
parasympatický_A	parasympatikus_None
verneovka_N	vernovka_None
neznámý_N	nezvěstný_None
perseverance_N	perseverace_None
tulení_A	tuleň_None
ústečka_N	ústa_None
rozestup_N	rozstup_None
robinson_N	Robinson_None
mopsl_N	mops_None
Blažka_N	Bláža_None
Freda_N	Fred_None
male_D	malý_None
plstní_A	plsní_None
Egypťan_N	Egypt_None
zapěrač_N	zapírač_None
urbární_A	urbář_None
šlaka_N	šlak_None
daguerrotypie_N	daguerrotyp_None
zákonní_A	zákonný_None
úryv_N	úryvek_None
nanejvýše_D	nanejvýš_None
chalífa_N	kalif_None
přestarostlivý_A	starostlivý_None
kilim_N	kelim_None
pobručívat_V	pobručovat_None
záklasník_N	záklasek_None
dceř_N	dcera_None
kebule_N	chebule_None
ovocnický_A	ovocnářský_None
navijáček_N	naviják_None
Podhradí_N	podhradí_None
neznání_N	znát_None
observatorní_A	observatoř_None
smavý_A	smát_None
děsno_D	děsný_None
rachomejtle_N	rachejtle_None
úsměvno_D	úsměvný_None
nedozírno_N	nedozírný_None
zadumlý_A	zádumný_None
benjamín_N	Benjamín_None
vytáhlec_N	vytáhlík_None
záplatkář_N	záplatář_None
stávkokazectví_N	stávkokaz_None
trpajzlík_N	trpaslík_None
odrodilství_N	odrodilecký_None
zdarebatělý_A	zdarebnělý_None
strumózní_A	struma_None
Hranice_N	hranice_None
pustotina_N	pustina_None
záušnička_N	záušnice_None
draho_D	drahý_None
předkyně_N	předek_None
kostřec_N	kostrč_None
kontagiozita_N	kontagiosita_None
učenkyně_N	učenec_None
ovárek_N	ovar_None
zlambidlo_N	slonbidlo_None
volebný_A	volba_None
prádelní_A	prádlo_None
výbavní_A	výbava_None
šachmat_N	šach_None
skladebný_A	skladební_None
budžet_N	budget_None
úbyt_N	úbytek_None
pinzeta_N	pinseta_None
podlážka_N	podlaha_None
vyvoslit_V	vyoslit_None
lůza_N	luza_None
kutisko_N	kutiště_None
kompozice_N	komposice_None
černokněžný_A	černokněz_None
Rudolfína_N	Rudolf_None
zuňkat_V	zunkat_None
korpus_N	corpus_None
profil_N	promítání_None
trias_N	triáda_None
rovno_D	rovně_None
svěravý_A	svíravý_None
admisní_A	admise_None
vrahoušek_N	vrah_None
trošininku_D	troška_None
kalvárie_N	Kalvárie_None
záhlavní_A	záhlaví_None
makrónka_N	makrónek_None
blizounký_A	blizoučký_None
trojník_N	troník_None
tetan_N	tetanus_None
zakřivlý_A	zakřivený_None
zvukovodný_A	zvukovod_None
varírovat_V	variovat_None
ženný_A	ženní_None
vikarius_N	vikář_None
lázeňský_N	lázně_None
Evženka_N	Evžen_None
šestispřežní_A	šestispřeží_None
poseroutka_N	posera_None
Polačka_N	Polák_None
zvenku_D	zvenčí_None
vláčíček_N	vlak_None
mírňounce_D	mírňounký_None
corpus_N	korpus_None
šumno_D	šumný_None
Kazachstán_N	Kazach_None
ksichtíček_N	ksicht_None
deštníček_N	deštník_None
soustíčko_N	sousto_None
výměneční_A	výměnkový_None
konzumpce_N	konsumpce_None
rozdávačka_N	rozdavač_None
obzůrek_N	obzor_None
lydický_A	Lýdie_None
zpathetičtělý_A	zpatetičtělý_None
květňák_N	květník_None
Zora_N	zora_None
jiterní_A	jitro_None
výdutka_N	výdutek_None
Klárinka_N	Klára_None
zničehožnic_D	zničehonic_None
privilej_N	privilegium_None
provázek_N	provaz_None
řepnisko_N	řepiště_None
suchounký_A	suchý_None
führer_N	fýrer_None
zárovní_A	zárovný_None
pápěří_N	pápěra_None
poříz_N	pořízek_None
žídek_N	Žid_None
při_A	přivléci_None
písklátko_N	pískle_None
kotrmeleček_N	kotrmelec_None
ryze_D	ryzí_None
methyl_N	metyl_None
vrbičný_A	vrbice_None
zápeceň_N	zápec_None
půlmilion_N	půl_None
čmoudit_V	čoudit_None
konzistoř_N	konsistoř_None
otisk_N	obtisk_None
hnutíčko_N	hnutí_None
půllitřík_N	půllitr_None
předpřádací_A	předpřádání_None
sufixální_A	sufix_None
ruka_N	rukoudání_None
Ferdinand_N	Ferda_None
skývečka_N	skýva_None
rezatý_A	rezivý_None
nádražní_A	nádraží_None
špačík_N	špaček_None
ančovička_N	anšovička_None
prvočíselný_A	prvočíslo_None
Velkobritánec_N	Velkobrit_None
vlásek_N	vlas_None
recesní_A	recese_None
travka_N	tráva_None
uzdravitelkyně_N	uzdravitel_None
modýlek_N	model_None
revizionismus_N	revisionismus_None
bandor_N	bandur_None
paterní_A	patro_None
ďásek_N	ďas_None
tintítko_N	tintidlo_None
jura_N	Jura_None
účetník_N	účetní_None
sejf_N	sejp_None
zásuvčička_N	zásuvka_None
šnops_N	šnaps_None
čmelák_N	včelák_None
přeslavný_A	slavný_None
semo_D	sem_None
vojevodstvo_N	vojvodstvo_None
služtička_N	služka_None
sterling_N	šterlink_None
mírňounký_A	mírný_None
přídavek_N	přídatek_None
odpočívátko_N	odpočívadlo_None
výminečný_A	výměnkový_None
schémátko_N	schéma_None
Moravka_N	Moravec_None
ňouma_N	ňuma_None
vojenčina_N	vojančina_None
dvanáctistěnný_A	dvanáctistěn_None
žaloudek_N	žaludek_None
zelňačka_N	zelnačka_None
sudoměřický_A	Sudoměřice_None
tarantula_N	tarantela_None
hovězí_N	hovado_None
žblabolit_V	žblabonit_None
krváček_N	krvák_None
užitečno_N	užitečný_None
Zajordánsko_N	Zajordání_None
osmistopý_A	osmistěn_None
Josefína_N	Josef_None
žarno_N	žernov_None
suchoučce_D	suchounký_None
vlažno_D	vlažný_None
špakát_N	špagát_None
záklopečka_N	záklopka_None
výměničný_A	výměnický_None
úžlabní_A	úžlabí_None
triumfální_A	triumf_None
výtažní_A	výtažný_None
přeuctivý_A	uctivý_None
Pentagon_N	pentagon_None
kapinku_D	kapku_None
tatra_N	Tatra_None
nožař_N	nožíř_None
předzpěvačka_N	předzpěvák_None
figurální_A	figura_None
vášnivůstka_N	vášnivost_None
mefistofelský_A	Mefistofeles_None
zdvořilec_N	zdvořák_None
Antonie_N	Antonín_None
osenní_A	osení_None
Janoš_N	Jánoš_None
naposledy_D	naposled_None
pepice_N	pepík_None
blizounce_D	blizoučký_None
výlivka_N	výlevka_None
konsensní_A	konsens_None
popílek_N	popel_None
bankocedule_N	bankocetle_None
brousírna_N	brusírna_None
zákazní_A	zákaz_None
miniový_A	minium_None
Hellas_N	Helada_None
starost_N	starý_None
bohapustý_A	bohopustý_None
franco_D	franko_None
hroudovatý_A	hrudovatý_None
sorbet_N	šerbet_None
jaktěživ_A	jakživ_None
kladička_N	kladka_None
zorný_A	zora_None
úžasno_D	úžasný_None
pomíjejícný_A	pomíjející_None
bikinky_N	bikiny_None
nizoučko_D	nizoučký_None
křivdička_N	křivda_None
nepřehledno_N	nepřehledný_None
přejemný_A	jemný_None
loupežníček_N	loupežník_None
horka_N	hora_None
Kijev_N	Kyjev_None
Rozina_N	Róza_None
zpráchnilý_A	zpráchnět_None
Lužičan_N	Lužice_None
plachetka_N	plachta_None
vepsí_D	psí_None
přetajemný_A	tajemný_None
evokativní_A	evokace_None
omastek_N	mastidlo_None
škornička_N	škorně_None
avantgardistický_A	avantgardista_None
narda_N	nard_None
výkladnice_N	výkladna_None
marsovský_A	Mars_None
výhoda_N	nevýhoda_None
subjektivistický_A	subjektivista_None
Standa_N	Stáňa_None
Smíchovan_N	Smíchov_None
renonce_N	renonc_None
zpěvoherní_A	zpěvohra_None
košilička_N	košile_None
výkupčí_N	výkupce_None
třísměnný_A	trojsměna_None
ozev_N	ozva_None
poliomyelitida_N	poliomyelitis_None
klípek_N	klep_None
plektron_N	plektrum_None
poťouchlec_N	poťouchlík_None
bílo_N	bělo_None
Karla_N	Karel_None
zpanchartělý_A	zparchantělý_None
zeštudovat_V	zestudovat_None
talián_N	Talián_None
otýpečka_N	otýpka_None
zkoumat_V	koumat_None
poblíže_D	poblíž_None
vuřtík_N	vuřt_None
adoptace_N	adopce_None
Edík_N	Eda_None
poudačka_N	povídačka_None
tříboký_A	trojboký_None
jednohlasý_A	jednohlas_None
psýcha_N	psycha_None
úkradmý_A	úkradný_None
pochichtávat_V	pochechtávat_None
kufírek_N	kufr_None
Eduard_N	Edvard_None
párkář_N	párkař_None
úkradmo_D	úkradný_None
kafáček_N	kafáč_None
svěže_D	svěží_None
špičinka_N	špička_None
úmluvní_A	úmluvný_None
snobík_N	snob_None
fanfrnoch_N	famfrnoch_None
carevna_N	car_None
dlažební_A	dlažba_None
kdežpak_D	kdepak_None
kružní_A	kruh_None
pediatrie_N	pediatr_None
chyže_N	chýže_None
ušklebavý_A	ušklíbavý_None
motanina_N	motanice_None
přejemnělý_A	zjemnělý_None
všudybýlek_N	všudybyl_None
lipoid_N	lipid_None
srdečný_A	srdce_None
stroze_D	strohý_None
třířadovka_N	trojřad_None
sanskritský_A	sanskrt_None
bábi_N	babi_None
isomer_N	izomer_None
zmlada_D	zmladu_None
stojný_A	stát_None
trojúhelníkovitý_A	trojúhelník_None
výročitý_A	výroční_None
induktivní_A	indukce_None
másílko_N	máslo_None
začátník_N	začátečník_None
víryhodný_A	věrohodný_None
zakrňovat_V	krnět_None
Matys_N	Matýs_None
rubopisník_N	rubopis_None
ložní_A	lože_None
šťářička_N	šťára_None
vozdr_N	vozher_None
post_A	půst_None
mináž_N	menáž_None
jenerál_N	generál_None
zora_N	zor_None
krotce_D	krotký_None
zpolou_D	zpola_None
kulovnička_N	kulovnice_None
štítonoš_N	štítník_None
litice_N	lítice_None
laclík_N	lacl_None
pudrátko_N	pudrovátko_None
výškoměrný_A	výškoměr_None
vejvoda_N	vévoda_None
imitativní_A	imitace_None
Otesánek_N	otesánek_None
dívečka_N	dívka_None
Zuzanečka_N	Zuzana_None
haltéř_N	haltýř_None
současno_N	současný_None
prvý_A	první_None
míšenský_A	míšeňský_None
povrch_N	napovrch_None
centezimální_A	centesimální_None
galanterní_A	galantérie_None
dlouze_D	dlouhý_None
šestitřídní_A	šestitřídka_None
vrchovato_D	vrchovatý_None
vráňátko_N	vráně_None
žulit_V	šulit_None
orostlý_A	obrostlý_None
lehce_D	lehký_None
Jaroslávek_N	Jaroslav_None
konzul_N	konsul_None
kilíčko_N	kilo_None
komplement_N	kompliment_None
chválabohu_D	chvála_None
bystrozrace_D	bystrozrak_None
kumpanie_N	kompanie_None
jesaul_N	esaul_None
Milena_N	milenka_None
zvěří_A	zvěř_None
vagant_N	vakant_None
hospodáříček_N	hospodář_None
samotince_D	samotinký_None
champion_N	šampión_None
katarální_A	katar_None
Tonda_N	Tonča_None
švýcar_N	Švýcar_None
markrabí_N	markrabě_None
kolébavka_N	kolíbavka_None
znevážlivý_A	zneváživý_None
žaberní_A	žábra_None
nákolenka_N	nákoleník_None
garde_N	gardedáma_None
flekční_A	flexe_None
brundibár_N	brundibál_None
venkovánek_N	venkovan_None
sofijský_A	Sofie_None
niobium_N	niob_None
notýsek_N	notes_None
úhořiště_N	úhořisko_None
teplo_N	teplý_None
zdravo_D	zdravý_None
ocásek_N	ocas_None
synáček_N	syn_None
plný_A	naplno_None
žakarový_A	žakár_None
Zakavkazsko_N	Zakavkazí_None
kaprice_N	kapric_None
židovka_N	Žid_None
hnojní_A	hnojný_None
verštat_N	veřtat_None
prýt_N	prejt_None
stařina_N	starina_None
věžnatý_A	věžatý_None
corrida_N	korida_None
pitíčko_N	pití_None
zaloktat_V	zalechtat_None
suchárek_N	suchar_None
vídrholec_N	vidrholec_None
jehlánek_N	jehlan_None
sukýnka_N	sukně_None
vsypný_A	vsyp_None
mechtle_N	techtle_None
porculán_N	porcelán_None
leprózní_A	lepra_None
kolovrátek_N	kolovrat_None
habituální_A	habitus_None
Litvan_N	Litva_None
zvetečilý_A	zvetešelý_None
teslo_N	tesla_None
limon_N	lemon_None
Franci_N	Franc_None
yorkshirský_A	Yorkshire_None
žehýlko_N	žehlo_None
vyvřeskovat_V	vybřeskovat_None
Stalingraďan_N	Stalingrad_None
galánečka_N	galán_None
plodnička_N	plodnice_None
chomáč_N	chumáč_None
Iráčan_N	Irák_None
mělnické_N	Mělník_None
falckrabí_N	falckrabě_None
Saša_N	Sáša_None
zůstáváníčko_N	zůstávání_None
předsudečný_A	předsudek_None
zardělky_N	zarděnky_None
Texasan_N	Texas_None
zvukosledný_A	zvukosled_None
trenky_N	trenýrky_None
záští_N	zášť_None
oblinka_N	oblina_None
kloset_N	klozet_None
řepní_A	řepa_None
Banát_N	banát_None
klubat_V	klovat_None
vyspáníčko_N	vyspání_None
kartaginský_A	Kartágo_None
smrkat_V	mrkat_None
mechoviště_N	mechovisko_None
vir_N	virus_None
pražan_N	Pražák_None
minuskula_N	minuskule_None
předivný_A	divný_None
vyprávka_N	vyprávění_None
radostno_D	radostný_None
výletíček_N	výlet_None
orchidej_N	orchidea_None
postižní_A	postih_None
Australan_N	Austrálie_None
židovečka_N	židověnka_None
Bělorusko_N	Bělorus_None
galerijní_A	galerie_None
fakturní_A	faktura_None
mimoňský_A	Mimoň_None
věčnostný_A	věčnostní_None
krušno_D	krušný_None
diminutivní_A	deminutivum_None
závětříčko_N	závětří_None
zpovzdáli_D	zpozdáli_None
vyšehrad_N	Vyšehrad_None
záslibní_A	záslib_None
lyšaj_N	lišaj_None
žežulice_N	žežulka_None
pragmatistický_A	pragmatista_None
lexikální_A	lexikon_None
říkáníčko_N	říkání_None
viničný_A	vinice_None
zkejsnout_V	zkysnout_None
dispozice_N	disposice_None
černobrvka_N	černobrvý_None
pámbíček_N	pánbíček_None
předloketní_A	předloktí_None
Pařížan_N	Paříž_None
požitkář_N	poživač_None
slunečno_D	slunečný_None
povlíknout_V	povléci_None
milounce_D	milounký_None
mrazivo_D	mrazivý_None
roční_A	dvouroček_None
Búr_N	burský_None
novorozeneček_N	novorozeně_None
praporní_A	prapor_None
uraninit_N	uranin_None
blízký_A	nablízku_None
přírodozpytný_A	přírodozpyt_None
posuněk_N	posunek_None
polo_N	dopola_None
stranička_N	strana_None
závrať_N	závrativý_None
třas_N	třes_None
chloumek_N	chlum_None
pětistý_A	pět_None
vtipkálský_A	vtipkálek_None
zmatečný_A	zmateční_None
zvnějška_D	zvnějšku_None
přetrpký_A	trpký_None
štěpka_N	štěpek_None
Slávinka_N	Sláva_None
besarabský_A	Besarábie_None
zkrutný_A	zkrucování_None
Elinka_N	Ela_None
měditiskař_N	měditisk_None
čechmant_N	čechman_None
kontinentální_A	kontinent_None
zpravodatel_N	zpravodavce_None
steláž_N	šteláž_None
vápno_N	vápenný_None
nepamětno_N	nepamětný_None
kupříkladu_D	příklad_None
retabulum_N	retábl_None
evangelní_A	evangelium_None
takořka_D	takřka_None
ledakdys_D	ledakdy_None
vrchnický_A	vrchník_None
řibet_N	hřbet_None
fortuna_N	Fortuna_None
dětičky_N	dítě_None
přejasný_A	jasný_None
uršulinský_A	uršulinka_None
ďáblice_N	ďábel_None
kolo_N	dokola_None
desatero_N	desaterý_None
zpovědní_A	zpověď_None
tamo_D	tam_None
cizojazyčný_A	cizí_None
pozejtří_D	pozítří_None
nízce_D	nízký_None
vzkřekat_V	vzkřek_None
výmolný_A	výmol_None
varhanní_A	varhany_None
loudálek_N	loudal_None
pronominální_A	pronomen_None
lahodno_D	lahodný_None
Zličan_N	Zlicko_None
smrtící_A	smrťoucí_None
šišlat_V	šeplat_None
kastovní_A	kasta_None
lokajík_N	lokaj_None
komatózní_A	kóma_None
Frýg_N	frygický_None
Doudleby_N	Doudleb_None
aseptický_A	asepse_None
lhavý_A	lhát_None
explozivní_A	explosivní_None
vyslovit_V	vyžalovat_None
kosterní_A	kostra_None
událůstka_N	událost_None
výběrčí_N	sběratel_None
větérec_N	větérek_None
uchroupnout_V	uchrupnout_None
jahodiní_N	jahodí_None
arzenitý_A	arsenitý_None
žabeček_N	žabec_None
soft_A	zoft_None
havel_N	Havel_None
kynik_N	cynik_None
zlatohřívý_A	zlatohřivák_None
špánek_N	špán_None
jeskyňka_N	jeskyně_None
sunnita_N	sunita_None
věrtýlek_N	věrtel_None
žurnální_A	žurnál_None
tříkolý_A	tříkolka_None
oblehatel_N	obléhatel_None
palečný_A	palec_None
znamínečko_N	znamení_None
Růžena_N	Růža_None
jizevnatý_A	jizvovitý_None
verzírovaný_A	versírovaný_None
wals_N	waltz_None
zápecíčko_N	zápecí_None
utrých_N	utrejch_None
odkudže_D	odkudž_None
Rusko_N	Rus_None
krejcárek_N	krejcar_None
zmrštěk_N	zmrsk_None
expozé_N	exposé_None
vystoupit_V	vstoupit_None
flastřík_N	flastr_None
perónní_A	perón_None
krapínek_N	krapánek_None
škica_N	skica_None
záhublivý_A	záhubný_None
zfotrovatět_V	fotrovatět_None
tlusťouš_N	tlusťoch_None
hebounce_D	hebounký_None
pluton_N	Pluto_None
koktat_V	škobrtat_None
spodek_N	spodky_None
vysoce_D	vysoký_None
Muhamed_N	Mohamed_None
Stuartovna_N	Stuartovec_None
step_N	štep_None
vrato_N	vráteň_None
mezička_N	mez_None
Květoslava_N	Květa_None
zlatohřívek_N	zlatohřivák_None
padoušek_N	padouch_None
šmátnout_V	šmatat_None
loutečka_N	loutka_None
inertní_A	inercie_None
skarabeus_N	skarab_None
ženec_N	ženc_None
živočíšek_N	živočich_None
humenský_A	Humenné_None
poradenský_A	poradna_None
přehrozný_A	hrozný_None
parůžek_N	paroh_None
větevní_A	větevný_None
jarmárka_N	jarmara_None
necičky_N	necky_None
křehce_D	křehký_None
poslice_N	posel_None
prajzský_A	Prajz_None
Lori_N	Lora_None
skotačka_N	skoták_None
pandur_N	bandur_None
Gruzín_N	Gruzie_None
ředitelíček_N	ředitel_None
kultíček_N	kult_None
zastrkovátko_N	zastrkovadlo_None
zdrávkat_V	zdravkat_None
pelíšek_N	pelech_None
zbořenisko_N	zbořeniště_None
zapacknout_V	zapackat_None
hlásný_A	hlášení_None
spavý_A	spát_None
holenní_A	holeň_None
katastrální_A	katastr_None
Valentýn_N	Valentin_None
nikdá_D	nikdy_None
pouzdříčko_N	pouzdro_None
epopeje_N	epopej_None
plukovní_A	pluk_None
Apollón_N	Apollo_None
zpozdálečí_D	zpozdáli_None
kšeftovní_A	kšeft_None
tajtrdlík_N	tajtrlík_None
Kartaginec_N	Kartágo_None
rumovisko_N	rumiště_None
růžovoučce_D	růžovoučký_None
polátko_N	políčko_None
tapisérie_N	tapiserie_None
strefný_A	strefa_None
numizmatik_N	numismatik_None
teďkon_D	teďky_None
šatní_A	šatový_None
Polynésan_N	Polynésie_None
blyskotavý_A	blyskotat_None
tajno_D	tajný_None
nedorozumění_N	dorozumět_None
Rafaela_N	Rafael_None
vinkl_N	vingl_None
liščátko_N	lišče_None
jablečný_A	jablko_None
přeuboze_D	přeubohý_None
Medník_N	medník_None
Pšovan_N	Pšov_None
Alaman_N	Aleman_None
ztuchlotina_N	ztuchlota_None
bezedno_N	bezedný_None
průdušný_A	průdyšný_None
Vilím_N	Vilém_None
zásuvička_N	zásuvka_None
paranoidní_A	paranoia_None
švandovní_A	švanda_None
pláteček_N	plátek_None
vozotaj_N	vozataj_None
pásnička_N	pásnice_None
závěreček_N	závěr_None
terapie_N	terapeutika_None
zádumný_A	zádumčivý_None
výzdobný_A	výzdoba_None
říhot_N	řehot_None
prvovýrobek_N	prvovýroba_None
zasvé_D	svůj_None
krumpáček_N	krumpáč_None
nunátko_N	ňuňátko_None
šeptálek_N	šeptal_None
jednonásobek_N	jednonásobný_None
vozovna_N	vozovka_None
zlatokvětý_A	zlatokvět_None
zamlzený_A	zamlžený_None
Žalov_N	žalov_None
xylolitář_N	xylolit_None
sladko_N	sladký_None
ořešina_N	ořeší_None
hezounce_D	hezounký_None
jizbice_N	jizba_None
marodérství_N	marodér_None
kesírek_N	keser_None
říjeniště_N	říjenisko_None
zmotchaný_A	zmotaný_None
řada_N	řádek_None
hovnivár_N	hovnivál_None
karásek_N	karas_None
krýt_V	sekret_None
Stašek_N	Stáša_None
Mája_N	Majka_None
hedžra_N	hidžra_None
všade_D	všady_None
smutečný_A	smuteční_None
parataktický_A	parataxe_None
zhybák_N	zibák_None
pomeje_N	pomyje_None
zástřešek_N	zástřeší_None
lehounce_D	lehounký_None
Bohuška_N	Bohuš_None
melantrišský_A	Melantrich_None
zdřepnělý_A	zdřepěný_None
lehýnce_D	lehounký_None
výsměvný_A	vysměvačný_None
kajetán_N	Kajetán_None
impresionistní_A	impresionismus_None
patrimoniální_A	patrimonium_None
princezna_N	princ_None
zrzavice_N	zrzavec_None
vrahyně_N	vrah_None
zapejřit_V	zapeřit_None
kopulovitý_A	kupolovitý_None
plecní_A	plec_None
plzeňské_N	Plzeň_None
vpolou_D	vpoly_None
řemenný_A	řemen_None
prošťuchovat_V	prošťouchnout_None
orgiastický_A	orgiasta_None
spoře_D	sporý_None
ještěže_D	ještě_None
převzácný_A	vzácný_None
roznemoci_V	moci_None
víneček_N	vínek_None
výčepnický_A	výčepník_None
tenze_N	tense_None
pronik_N	průnik_None
strůpek_N	strop_None
výpadný_A	výpadní_None
Miluše_N	Míla_None
jednoduše_D	jednoduchý_None
provinční_A	provincialismus_None
hřejivý_A	hřát_None
verbalistní_A	verbalista_None
podsvětní_A	podsvětí_None
hluše_D	hluchý_None
chorus_N	chór_None
apelativní_A	apelativum_None
březňáček_N	březňák_None
šprušle_N	šprycl_None
diskutant_N	diskutér_None
mešní_A	mše_None
Vyškovan_N	Vyškov_None
kotrmelec_N	kozelec_None
sokyně_N	sok_None
úterek_N	úterý_None
ventrikulární_A	ventrikul_None
želno_D	žalný_None
stebélko_N	stéblo_None
pivovárek_N	pivovar_None
atributivní_A	atribut_None
zákulisní_A	zákulisí_None
hvězdka_N	hvězda_None
zeměnín_N	zemanín_None
jatka_N	jatky_None
převislý_A	přepadlý_None
Podolí_N	podolí_None
slaboučce_D	slaboučký_None
dvoustý_A	dvě_None
foen_N	fén_None
sumární_A	suma_None
matčin_A	matka_None
litovelský_A	Litovel_None
Médie_N	Méd_None
svodnice_N	svůdník_None
zouplna_D	zúplna_None
odprejsknout_V	odprýsknout_None
Prokůpek_N	Prokop_None
Transjordánsko_N	Transjordánie_None
prýmkář_N	prýmkař_None
snížek_N	sníh_None
žluťounký_A	žluťoučký_None
participiální_A	participium_None
kořalinka_N	kořalka_None
čepeníčko_N	čepení_None
tichoučce_D	tichounký_None
vraždiště_N	vraždírna_None
madona_N	Madona_None
pásemný_A	pásmo_None
provazochodec_N	provazolezec_None
radlička_N	radlice_None
strnádek_N	strnad_None
iracionalistický_A	iracionalista_None
zakratinko_D	zakratičko_None
oupadlina_N	úpadlina_None
suspenze_N	suspense_None
zemčatový_A	zemče_None
duchovenský_A	duchovní_None
vartovní_A	varta_None
trabant_N	drabant_None
věníčko_N	věno_None
výletit_V	výletovat_None
piko_A	pikola_None
podelbí_N	podlebí_None
saduceus_N	saducej_None
Edáček_N	Eda_None
kovařík_N	kovářík_None
forzýtie_N	forsytie_None
dvouročák_N	dvouroček_None
pokrm_N	pikantnost_None
dloužek_N	dluh_None
smeč_N	smečka_None
larvální_A	larva_None
spucnout_V	spucat_None
balšám_N	balšán_None
pozvolný_A	pozvolna_None
vlaštovčátko_N	vlaštovče_None
skála_N	škála_None
čtverohrbolí_N	čtyřhrbolí_None
přeostrý_A	ostrý_None
vyhlídečka_N	vyhlídka_None
cviklík_N	cvikl_None
mrtvo_D	mrtvý_None
plíšek_N	plech_None
lyrično_N	lyrický_None
ráže_N	ráž_None
veskrze_D	veskrz_None
Benátčan_N	Benátky_None
zákoutní_A	zákoutí_None
kmetný_A	kmet_None
ischiadický_A	ischias_None
ječný_A	ječmen_None
tenince_D	teničký_None
sarajevský_A	Sarajevo_None
sochůrek_N	sochor_None
konzum_N	konsum_None
bohorodička_N	bohorodice_None
zplozeneček_N	zplozenec_None
držátko_N	držadlo_None
zpovzdálečí_D	zpozdáli_None
zvěřena_N	zvířena_None
fluviatilní_A	fluviální_None
skladební_A	skladba_None
přimísenina_N	přimíšenina_None
špatno_D	špatný_None
závitořezný_A	závitořez_None
malíř_N	maléř_None
šestinedělní_A	šestinedělí_None
vřesný_A	vřesový_None
vdych_N	vdech_None
liberál_N	liberalista_None
osobnůstka_N	osobnost_None
viktuální_A	viktuálie_None
Voříšek_N	oříšek_None
plasticita_N	plastičnost_None
hlaďoučce_D	hlaďounký_None
verbální_A	verbum_None
zárodečný_A	zárodek_None
školdozorský_A	školdozorce_None
Burgunďan_N	Burgund_None
kopáček_N	kopáč_None
krátce_D	krátký_None
vábnička_N	vábnice_None
rytkyně_N	rytec_None
dispenzář_N	dispensář_None
Miloslava_N	Miloslav_None
mikulášenský_A	mikulášenec_None
zlomyslnůstka_N	zlomysl_None
podkrovní_A	podkroví_None
donkichot_N	Don_None
bárina_N	bárin_None
vrčavý_A	vrčivý_None
cok_N	cokna_None
Elamita_N	Elam_None
bohudíky_D	bohudík_None
ženýrovat_V	žinýrovat_None
učníček_N	učnice_None
třasavka_N	třesavka_None
mainada_N	menáda_None
Porýnsko_N	Porýní_None
jasno_D	jasný_None
slovnědruhový_A	slovní_None
příměsek_N	příměs_None
výkrajek_N	výkrojek_None
šatky_N	šaty_None
zašnejdrovat_V	zašejdrovat_None
okukovat_V	okoukat_None
švadrona_N	škadrona_None
vtipkář_N	vtipkař_None
vzdych_N	vzdech_None
dobšinský_A	Dobšiná_None
břímě_N	břemeno_None
lokýnka_N	lokna_None
Evropan_N	Evropa_None
double_A	dubl_None
sklípek_N	sklep_None
šmírař_N	šmírák_None
bagatel_N	pakatel_None
Kavkazan_N	Kavkaz_None
hlásný_N	hlášení_None
ziminka_N	zima_None
čtyřbarevný_A	čtyřbarvý_None
Sněžník_N	sněžník_None
kalhotky_N	kalhoty_None
Bráhma_N	bráhma_None
okružní_A	okruh_None
zápřežný_A	zápřež_None
gangrenózní_A	gangréna_None
záře_N	zář_None
droby_N	drob_None
anglický_A	Anglie_None
zespodu_D	zespod_None
podlažní_A	podlaha_None
senzál_N	sensál_None
butylnatý_A	butyl_None
ostře_D	ostrý_None
vlažička_N	vláha_None
vzdělanství_N	vzdělanectví_None
lazar_N	Lazar_None
zmladu_D	zmládí_None
zpozdilůstka_N	zpozdilost_None
plužní_A	pluh_None
smetí_N	smetník_None
rabiát_N	rabiák_None
přítma_N	přítmí_None
hadice_N	had_None
moritát_N	morytát_None
baštička_N	bašta_None
paulánský_A	pavlán_None
ředitýlek_N	ředitel_None
pinka_N	pěnkava_None
nakukovat_V	nakouknout_None
oficiózní_A	oficiosní_None
stoupátko_N	stupátko_None
výlomný_A	výlomový_None
černotmavý_A	černotemný_None
puleček_N	pulec_None
souchoty_N	souchotiny_None
vybřeskovat_V	vyvřeskovat_None
prima_A	primisima_None
výzkumce_N	výzkumník_None
obchůdek_N	obchod_None
Gaskoňsko_N	Gaskoněc_None
jednoručka_N	jednoruký_None
kortikosteroid_N	kortikoid_None
prostince_D	prostinký_None
šprtek_N	šprček_None
rousnatý_A	rousný_None
bijásek_N	biják_None
výplet_N	pletení_None
semilský_A	Semily_None
chladno_D	chladný_None
abortus_N	abort_None
horečka_N	hora_None
přelaskavý_A	laskavý_None
tyreoidální_A	tyreoidea_None
pařízek_N	pařez_None
lakýrna_N	lakovna_None
horačka_N	horák_None
degresívní_A	degrese_None
vláknatý_A	vláknitý_None
Johánek_N	Johan_None
náhoda_N	nahodilost_None
olivinický_A	olivín_None
přemálo_N	přemalý_None
střiž_N	stříž_None
odekdy_D	odkdy_None
jód_N	jod_None
půlkruhovitý_A	půlkruh_None
třetihorní_A	třetihory_None
jeř_N	jař_None
záhražka_N	zahrážka_None
soudružka_N	soudruh_None
nebožtík_N	nebožka_None
kalup_N	galop_None
sokratický_A	Sokrates_None
Jana_N	Jan_None
budovní_A	budova_None
čmuchálek_N	čmuchal_None
nízko_D	nízký_None
žel_N	žal_None
pročpak_D	proč_None
zimno_D	zimný_None
tellurium_N	telurium_None
šmatlat_V	šmaťhat_None
režijní_A	režie_None
Ferdáček_N	Ferda_None
příkládek_N	příklad_None
pachtovní_A	pacht_None
sérový_A	sérum_None
tuberkulínový_A	tuberkulin_None
marnotratnictví_N	marnotratník_None
neón_N	neon_None
ministerský_A	ministr_None
vlákénko_N	vlákno_None
misantropie_N	misantrop_None
divoce_D	divoký_None
lvíček_N	lev_None
textík_N	text_None
Zélanďan_N	Zéland_None
grejcar_N	krejcar_None
pomaluběžný_A	pomaloběžný_None
rozvozní_A	rozvoz_None
kvelbík_N	kvelb_None
zájemní_A	zájem_None
tajno_N	tajný_None
Porýnsko_A	Porýní_None
čmáranec_N	čáranec_None
tranzitorní_A	transitorní_None
niterní_A	niterný_None
vanilie_N	vanilka_None
panský_N	pán_None
chrabře_D	chrabrý_None
Sokol_N	sokol_None
adverbiální_A	adverbium_None
holandka_N	holanďanka_None
syntaktický_A	syntax_None
šuhajíček_N	šuhaj_None
postýlka_N	postel_None
sobík_N	sobec_None
brousek_N	brus_None
emisní_A	emise_None
vřetánko_N	vřeténko_None
zavírka_N	závěrka_None
