sladit	V
ilegální	A
vlát	V
ratolest	N
fantasy	A
převis	N
veverka	N
výstroj	N
kolize	N
neteř	N
louže	N
sérum	N
legie	N
procesí	N
chatrč	N
zdráhat	V
farmacie	N
tázat	V
elán	N
chilli	N
pošetilý	A
třicítka	N
páter	N
point	N
křivý	A
linout	V
průzračný	A
car	N
leasing	N
abeceda	N
nadto	D
sou	N
bestie	N
vyhledávač	N
lenka	N
kriminál	N
gorila	N
páchat	V
nořit	V
sloka	N
příšera	N
indukce	N
svižný	A
butik	N
úhledný	A
alkalický	A
souvrství	N
agrese	N
koncil	N
demence	N
manévr	N
všudy	D
čtyřicítka	N
fér	D
part	N
kocovina	N
paradigma	N
makléř	N
nezaměstnaný	N
lágr	N
kredit	N
dóm	N
nadmíru	D
nesmrtelnost	N
ambulance	N
nicota	N
privilegium	N
precizní	A
břidlice	N
rámus	N
naprázdno	D
mast	N
otok	N
bicykl	N
duna	N
sterilní	A
vyprostit	V
věřící	N
blůza	N
béžový	A
henry	N
přečkat	V
didaktika	N
onak	D
bazar	N
bedra	N
sci-fi	A
schůdky	N
hltat	V
nemožnost	N
kuriózní	A
ztotožnit	V
nástraha	N
namístě	D
kolmo	D
senzace	N
mnout	V
potácet	V
oáza	N
email	N
koncentrovat	V
kupole	N
tutor	N
prima	A
pryskyřice	N
kurátor	N
sok	N
odmlka	N
salám	N
defekt	N
kupé	N
meloun	N
mara	N
plotna	N
nadbytek	N
revír	N
hříva	N
logistika	N
náčiní	N
vřed	N
řemen	N
luna	N
tamtéž	D
malér	N
odsun	N
rozléhat	V
klamat	V
zdálky	D
magor	N
kašna	N
publicita	N
krát	D
studně	N
kvantum	N
bdít	V
hulákat	V
suť	N
polevit	V
houska	N
neznalost	N
půldruhý	A
oponovat	V
baroko	N
esemeska	N
ráčit	V
zášť	N
rýma	N
sólo	N
cloud	A
přítmí	N
sprint	N
rytmický	A
pochva	N
týl	N
neshoda	N
kolemjdoucí	N
špitál	N
vybíhat	V
partyzán	N
zadruhé	D
navždycky	D
přihrádka	N
torzo	N
batole	N
sova	N
skaut	N
kolísat	V
návrší	N
šílet	V
frajer	N
skřípat	V
pletivo	N
úbor	N
sacharid	N
kvádr	N
doupě	N
sténat	V
réva	N
veronika	N
kompatibilní	A
lodyha	N
vulgární	A
paruka	N
stádium	N
niva	N
obíhat	V
haló	N
hospodin	N
vylétnout	V
šerif	N
lupa	N
drahocenný	A
bezbranný	A
kosmos	N
vstřebat	V
apoštol	N
pseudonym	N
zámožný	A
jedle	N
příkon	N
choulostivý	A
vitrína	N
žula	N
recepční	N
flóra	N
osma	N
explodovat	V
sympózium	N
extáze	N
píchat	V
kmín	N
trans	N
lpět	V
nevinnost	N
šlacha	N
puls	N
drahokam	N
paralela	N
huť	N
retro	A
živoucí	A
republikán	N
oběsit	V
helium	N
mudrc	N
zeman	N
bašta	N
skepse	N
benefit	N
plýtvat	V
sára	N
zdola	D
šaman	N
konstruovat	V
spláchnout	V
nazpět	D
hostinský	N
šikana	N
močál	N
hřebec	N
plodit	V
tymián	N
neznámý	N
bestseller	N
zprovoznit	V
synagoga	N
zpola	D
slalom	N
přívěs	N
čišet	V
stoh	N
couvat	V
vepředu	D
roura	N
nadpřirozený	A
ksicht	N
uzávěr	N
předmluva	N
hýčkat	V
porno	N
nevědomky	D
harmonika	N
vzdor	N
green	N
zaživa	D
krunýř	N
oprávnit	V
psovod	N
kýžený	A
vyvěrat	V
debakl	N
etnikum	N
mantinel	N
přehlušit	V
don	N
nadzemní	A
urostlý	A
zašlý	A
kaňon	N
plížit	V
truhla	N
sentimentální	A
ohavný	A
obout	V
beletrie	N
špice	N
marže	N
levno	D
rezonance	N
story	N
bourat	V
rouška	N
aróma	N
lalok	N
houf	N
nepřátelství	N
neochota	N
profi	A
snědý	A
mód	N
likér	N
konzistence	N
borůvka	N
boka	N
mást	V
beta	N
tmel	N
svatý	N
láva	N
mumie	N
balada	N
poleno	N
pointa	N
diskurs	N
glóbus	N
břevno	N
clo	N
idnes	N
klopýtat	V
účetní	N
pardon	N
teror	N
jachta	N
sloj	N
celistvý	A
koště	N
mikina	N
sráz	N
cola	N
metan	N
orgasmus	N
steh	N
fosfor	N
ornament	N
šmouha	N
café	N
saně	N
apelovat	V
trus	N
skokan	N
nazítří	D
vzad	D
plantáž	N
kvark	N
dezinfekce	N
stožár	N
delfín	N
situovat	V
kaktus	N
saze	N
míhat	V
paměti	N
dál	N
renault	N
šarm	N
spot	N
půllitr	N
lis	N
prosvítat	V
buchta	N
apartmán	N
rov	N
kýč	N
evokovat	V
kontura	N
kupón	N
špek	N
tříska	N
baba	N
kompas	N
delikt	N
piknik	N
plást	N
prima	D
slot	N
duha	N
akcent	N
pochmurný	A
havarijní	A
audio	A
prostup	N
kumpán	N
oblázek	N
nezdar	N
kára	N
malárie	N
zoufat	V
kochat	V
potmě	D
suk	N
dřeň	N
puma	N
oplývat	V
violeta	N
reputace	N
kanón	N
máta	N
provize	N
brousit	V
saranče	N
ulita	N
bezchybný	A
journal	N
vinout	V
moderna	N
dividenda	N
zátylek	N
čich	N
přítok	N
prodrat	V
lilie	N
vřít	V
zřídkakdy	D
šibenice	N
beach	A
brodit	V
dýha	N
žlab	N
akord	N
lůno	N
dynamo	N
brejk	N
trafika	N
stříkat	V
hold	N
vlaštovka	N
live	N
pojednou	D
archa	N
utopie	N
lysý	A
kovboj	N
sloh	N
jmout	V
odhadem	D
komando	N
rubl	N
konverze	N
pařez	N
skútr	N
ctihodný	A
káča	N
alarm	N
korigovat	V
kopřiva	N
maršál	N
palice	N
unikát	N
koroze	N
kombinéza	N
porotce	N
ochromit	V
rozvaha	N
šiška	N
loajální	A
pobízet	V
nestabilita	N
špendlík	N
plivat	V
ježek	N
flaška	N
western	N
kauce	N
zázvor	N
mokřad	N
archaický	A
glukóza	N
singl	N
zeť	N
kóta	N
bolševik	N
heroin	N
klobása	N
týrat	V
kampus	N
výzbroj	N
nevědomí	N
tchán	N
bořit	V
zárubeň	N
intelekt	N
ranč	N
magnát	N
bufet	N
nepřízeň	N
dědit	V
pop	N
folklor	N
vulkán	N
laptop	N
kúra	N
líh	N
zoom	N
hysterie	N
výpar	N
baňka	N
blikat	V
absorbovat	V
bazilika	N
moderovat	V
top	N
stmívat	V
kastelán	N
dumat	V
ústraní	N
magma	N
montovat	V
hřib	N
jubileum	N
napájet	V
poník	N
šortky	N
figurína	N
doktrína	N
integrita	N
múza	N
sesuv	N
bazalka	N
tržnice	N
samet	N
sultán	N
ustálit	V
exprese	N
flash	A
nespočet	N
pokání	N
prostituce	N
mimino	N
balancovat	V
doširoka	D
veš	N
barel	N
šašek	N
topol	N
odjinud	D
kolemjdoucí	A
nazpaměť	D
nepřeberný	A
levandule	N
spět	V
nedávno	N
konsorcium	N
parketa	N
svitek	N
nespavost	N
póza	N
ofenziva	N
mol	N
žalář	N
náplast	N
kombi	N
šlágr	N
střevíc	N
outsider	N
spasit	V
vyprovodit	V
znamenitý	A
konrád	N
report	N
fréza	N
difrakce	N
korálky	N
šál	N
tlapa	N
přeshraniční	A
kolos	N
garant	N
součinitel	N
rozvědka	N
kácet	V
kůr	N
grimasa	N
poddajný	A
škubat	V
lešení	N
áčko	N
dáseň	N
oslnit	V
glazura	N
veličenstvo	N
štír	N
um	N
tlumočit	V
hyena	N
temperament	N
minus	D
opomíjet	V
air	N
šat	N
vosa	N
oklika	N
pigment	N
tykat	V
povoz	N
jez	N
taxi	N
ostroh	N
nešťastník	N
skelet	N
mrkat	V
cvok	N
astma	N
tsunami	N
rating	N
adoptovat	V
babi	N
šestka	N
team	N
computer	N
koktat	V
dorostenec	N
trumf	N
neúprosný	A
implementovat	V
repríza	N
jesle	N
bistro	N
stimul	N
esence	N
dealer	N
striktní	A
bas	N
domorodý	A
indikovat	V
celer	N
napoprvé	D
čáry	N
dominance	N
nova	N
ťukat	V
poker	N
korba	N
otálet	V
fáma	N
kapsle	N
krypta	N
klisna	N
rozinka	N
štípat	V
lichý	A
parka	N
tápat	V
exaktní	A
ceremoniál	N
lišejník	N
nelibost	N
liják	N
detekovat	V
markýz	N
túra	N
chlév	N
klon	N
krychle	N
bit	N
jitro	N
referovat	V
enormní	A
béčko	N
prahnout	V
chmel	N
krotit	V
mašina	N
koláž	N
šampon	N
výztuž	N
revue	N
vpád	N
obojek	N
hutný	A
varieta	N
emotivní	A
róba	N
zbroj	N
liberál	N
výstřední	A
satan	N
zrát	V
kvóta	N
havarovat	V
opencard	N
korán	N
aparatura	N
rarita	N
truchlit	V
mrštit	V
zrůda	N
tradovat	V
skluz	N
import	N
subtilní	A
kuráž	N
antika	N
sekyra	N
kóma	N
prozatímní	A
roj	N
vevnitř	D
dotovat	V
stagnovat	V
pluh	N
hobby	N
hurikán	N
pstruh	N
přelud	N
volvo	N
kabaret	N
arogance	N
hrách	N
havran	N
kajuta	N
chechtat	V
dunět	V
balzám	N
smršť	N
okusit	V
karneval	N
demise	N
pakt	N
vichr	N
fit	A
safari	N
nacismus	N
nepřesnost	N
pulsovat	V
sahara	N
nektar	N
karavan	N
alibi	N
přízračný	A
zinek	N
šklebit	V
song	N
hřeb	N
dramaturgie	N
zátiší	N
mango	N
čumět	V
imaginace	N
destruktivní	A
ústřice	N
promenáda	N
puč	N
děd	N
exhibice	N
vyhoupnout	V
nečinnost	N
záchytný	A
šifra	N
kolegium	N
modus	N
skica	N
odtok	N
podrost	N
rak	N
alexandr	N
dupat	V
kolébat	V
nevědomost	N
observatoř	N
drhnout	V
kláda	N
zprostit	V
krab	N
debil	N
ostění	N
cisterna	N
nora	N
inkontinence	N
skanzen	N
plavit	V
špageta	N
kutálet	V
krejčí	N
tropy	N
manifest	N
šlehat	V
cikán	N
adaptovat	V
erupce	N
těkat	V
netrpělivost	N
fór	N
zátka	N
veskrze	D
pudink	N
erb	N
dochutit	V
hřídel	N
net	N
loterijní	A
brožura	N
soutěska	N
nať	N
distance	N
sedan	N
nika	N
iracionální	A
granule	N
choulit	V
sálat	V
odnož	N
hamburger	N
kredenc	N
brva	N
defenziva	N
rozpínat	V
žirafa	N
kofein	N
kalhotka	N
tuner	N
tuňák	N
simulovat	V
potyčka	N
škrob	N
libreto	N
altán	N
depozitář	N
hospic	N
dur	N
hmat	N
hnus	N
džíp	N
notář	N
píle	N
dvoudenní	A
šestnáctka	N
lóže	N
vandal	N
blank	N
skrz	D
salva	N
konformní	A
meruňka	N
řinout	V
generálka	N
soda	N
verva	N
log	N
zazší	A
decentní	A
lichotit	V
osmifinále	N
pervitin	N
diabetes	N
varle	N
součin	N
elf	N
kulhat	V
kretén	N
mecenáš	N
termální	A
halit	V
trolejbus	N
pant	N
propiska	N
šnek	N
audience	N
posměch	N
pólo	N
podcelek	N
čnít	V
entita	N
šrám	N
jestřáb	N
špion	N
rozbíhat	V
gin	N
zápraží	N
tuberkulóza	N
regulérní	A
slavík	N
předzvěst	N
navečer	D
expresionismus	N
food	N
mohyla	N
bambus	N
triatlon	N
dogma	N
gusto	N
mdlý	A
hubnout	V
fraška	N
rezistence	N
vrčet	V
development	N
éter	N
arzenál	N
advent	N
kompakt	N
neandertálec	N
nároží	N
hrouda	N
rezervovat	V
prefekt	N
oddálit	V
judita	N
smažit	V
apokalypsa	N
laguna	N
zčistajasna	D
draslík	N
únosce	N
osten	N
lingvistika	N
přívlastek	N
kultivar	N
rohož	N
haléř	N
pupen	N
souběžný	A
represe	N
šrot	N
převlek	N
špalek	N
tornádo	N
bobr	N
lobby	N
strašák	N
konvoj	N
tulipán	N
morče	N
dozlatova	D
kauzální	A
chlór	N
drobeček	N
kojit	V
nenadálý	A
koukej	N
podiv	N
očividný	A
ekzém	N
weber	N
netřeba	D
připojištění	N
mamut	N
přemíra	N
potkan	N
taxon	N
otěž	N
bál	N
nažloutlý	A
divý	A
žvanit	V
kondom	N
lamela	N
art	N
jednolitý	A
výchylka	N
madlo	N
údobí	N
podhled	N
fejeton	N
vous	N
vědro	N
nadrobno	D
rentgen	N
nej	A
výčep	N
koloběh	N
syčet	V
vrtule	N
spíž	N
kreveta	N
obézní	A
kari	N
stařičký	A
asistovat	V
trošičku	D
kosa	N
mezek	N
tepat	V
stolice	N
zpříjemnit	V
spolubydlící	N
vrabec	N
kapuce	N
plavý	A
nedokonalost	N
zhoupnout	V
erekce	N
reverend	N
komoda	N
relikt	N
konstelace	N
barikáda	N
pudr	N
bagr	N
žhnout	V
rádža	N
vrzat	V
wehrmacht	N
čížek	N
chuchvalec	N
obětavý	A
vepř	N
nevina	N
představený	N
obnos	N
alan	N
odiv	N
mazlit	V
komplet	N
blecha	N
berle	N
vláha	N
kroupa	N
kterak	D
zakusit	V
online	D
příboj	N
zpestřit	V
chlastat	V
učedník	N
uchechtnout	V
rubín	N
brandy	N
bodat	V
odchov	N
viola	N
natvrdo	D
kyčel	N
jednodenní	A
intence	N
evakuovat	V
rozvor	N
migréna	N
digestoř	N
dirigovat	V
smetí	N
emirát	N
vařič	N
služebna	N
testosteron	N
spleť	N
sát	V
prvořadý	A
triumfovat	V
medio	N
klubko	N
svoz	N
lest	N
kopule	N
rekvizita	N
výt	V
savana	N
povyk	N
manévry	N
aura	N
go	N
protéza	N
propočet	N
chýlit	V
fundamentální	A
drobek	N
nevidomý	N
obluda	N
bysta	N
houští	N
škrtat	V
fiasko	N
desktop	N
souměrný	A
obezřetný	A
konev	N
prostřít	V
tréma	N
ještěr	N
kóje	N
dřímat	V
výlohy	N
emil	N
ségra	N
mícha	N
chorál	N
eventuální	A
medailón	N
tolar	N
korzet	N
žokej	N
korporátní	A
rez	N
zvážnět	V
spin	N
konzul	N
pysk	N
pergola	N
neznámo	N
ječmen	N
radovánky	N
spřádat	V
ring	N
tribunál	N
salto	N
oukej	D
prostata	N
pesticid	N
expandovat	V
zotavit	V
eutanazie	N
broskev	N
zprudka	D
bzučet	V
hlíza	N
kabriolet	N
chátrat	V
kastrol	N
klokan	N
rašelina	N
nasnadě	D
strádat	V
skalpel	N
fixovat	V
bageta	N
katar	N
mizera	N
málo	N
zepředu	D
predikce	N
dodneška	D
šumět	V
kečup	N
rezoluce	N
výchoz	N
spořit	V
sinice	N
patricius	N
snítka	N
rozeslat	V
taj	N
poddruh	N
prvorozený	A
comeback	N
buvol	N
blána	N
šváb	N
touchpad	N
přístřeší	N
intrika	N
genius	N
průplav	N
kynout	V
diesel	N
karotka	N
opce	N
obilovina	N
najemno	D
vpravdě	D
indicie	N
cigáro	N
veslo	N
iris	N
slída	N
přívoz	N
opat	N
džem	N
majonéza	N
vestibul	N
lump	N
achát	N
neřest	N
oprostit	V
fixní	A
zout	V
vřava	N
jatky	N
záludný	A
zespodu	D
žehlit	V
kapacitor	N
manžeta	N
nepoznání	N
kabela	N
várka	N
pupek	N
trenýrky	N
padouch	N
grandslam	N
patriot	N
ester	N
třímat	V
spaliny	N
čáp	N
vratký	A
slimák	N
sestřih	N
běda	N
polda	N
rekombinantní	A
atrium	N
odlehčit	V
okolky	N
rádoby	D
atak	N
dálný	A
balón	N
odedávna	D
šavle	N
kmitat	V
perník	N
žehnat	V
útrapa	N
výstřižek	N
ch	N
boule	N
rover	N
bejvat	V
anekdota	N
kymácet	V
předstoupit	V
diecéze	N
admirál	N
jedenáctka	N
odlitek	N
rally	N
fanatik	N
guru	N
hygienik	N
hýždě	N
sedimentární	A
vsedě	D
zebra	N
pahýl	N
stokoruna	N
poklid	N
kadeř	N
idyla	N
řapík	N
laureát	N
vor	N
cuketa	N
lán	N
svištět	V
komplementární	A
glosa	N
ničema	N
lať	N
rito	N
hojit	V
profík	N
trable	N
úlek	N
předjímat	V
laskat	V
rozlétnout	V
kongregace	N
zdvih	N
předkrm	N
bezděky	D
nocleh	N
vynakládat	V
oktaedr	N
explicitní	A
omega	N
jetel	N
hábit	N
makro	N
kaskáda	N
petržel	N
tlukot	N
hitparáda	N
pampeliška	N
tunika	N
nukleotid	N
nóbl	D
urputný	A
žito	N
komiksy	N
tíhnout	V
prve	D
průvodčí	N
pixel	N
naoko	D
zavánět	V
kdes	D
adoptivní	A
matrice	N
svár	N
symbióza	N
konzum	N
bizon	N
vábit	V
znechutit	V
bloumat	V
šestice	N
kýbl	N
pádit	V
bouchat	V
nonstop	D
vřes	N
dok	N
průliv	N
antidepresivum	N
árie	N
čedič	N
fax	N
žampion	N
jalový	A
invence	N
narativní	A
tát	V
plazmid	N
cukat	V
porta	N
přehoupnout	V
přikročit	V
průsmyk	N
vztlak	N
křen	N
performance	N
klep	N
funět	V
jiřina	N
motorika	N
nezvěstný	A
memorandum	N
křeček	N
postřik	N
fůra	N
brokolice	N
matrika	N
fena	N
zdvihat	V
kompliment	N
nepozornost	N
rozmarýn	N
invalida	N
mys	N
tandem	N
ovál	N
třetice	N
rezonovat	V
delikátní	A
finta	N
šerpa	N
horda	N
nymfa	N
amfiteátr	N
násobit	V
komplic	N
loupat	V
skolit	V
nukleární	A
notes	N
vágní	A
česat	V
líbezný	A
šalvěj	N
hemoglobin	N
beztvarý	A
gradient	N
odkudsi	D
nedohledno	N
real	N
škrtit	V
spár	N
nutriční	A
kalamita	N
poupě	N
brambor	N
příčit	V
bochník	N
renomé	N
špunt	N
konsens	N
chrápat	V
piha	N
klanět	V
úprk	N
trajekt	N
stoj	N
kanystr	N
sršet	V
ostych	N
naživo	D
slunovrat	N
msta	N
prskat	V
refrén	N
bujarý	A
rybíz	N
neutuchající	A
semknout	V
hasit	V
kobka	N
skvět	V
amulet	N
příkrov	N
sokl	N
tuze	D
anamnéza	N
garsonka	N
promoce	N
šedesátka	N
namátkou	D
mok	N
excelovat	V
špaček	N
vydra	N
střídmý	A
přezka	N
cihelný	A
iniciála	N
extra	D
airbag	N
chat	N
jícen	N
vnikat	V
strast	N
zápolit	V
tříměsíční	A
podchod	N
op	N
propásnout	V
chomáč	N
lačný	A
kantýna	N
dril	N
anestezie	N
jakž	D
smog	N
kiwi	N
drive	N
chróm	N
žebrat	V
konkrece	N
kalibr	N
zastřít	V
piškot	N
dřepnout	V
chřest	N
underground	N
inventář	N
cinkat	V
charisma	N
presso	N
kobliha	N
přiléhat	V
obušek	N
hobit	N
dusný	A
tůně	N
asteroid	N
moll	N
instantní	A
kurýr	N
palačinka	N
předzahrádka	N
břečťan	N
echo	N
spropitné	N
ananas	N
vzruch	N
degradovat	V
mýto	N
drbat	V
ohon	N
paliativní	A
stativ	N
prodražit	V
úhoř	N
vitální	A
klas	N
kokos	N
hanebný	A
shop	N
křišťál	N
kolonáda	N
rýt	V
snacha	N
benedikt	N
hýřit	V
hlen	N
sup	N
nedopalek	N
obyčej	N
kaviár	N
jízdárna	N
orloj	N
mžourat	V
kudla	N
tuba	N
talisman	N
imperativ	N
behaviorální	A
máchat	V
nerovnováha	N
souběh	N
folk	N
pět	V
bodyguard	N
ranec	N
vojevůdce	N
game	N
příst	V
cloumat	V
prezídium	N
milice	N
bungalov	N
firewall	N
retribuce	N
diabet	N
finiš	N
kubík	N
miniatura	N
linoleum	N
vegetarián	N
oddenek	N
nedopatření	N
dotěrný	A
kotec	N
svědit	V
skrýše	N
šmejd	N
šedozelený	A
foyer	N
gympl	N
lepšit	V
skulina	N
cvičný	A
fašismus	N
kánon	N
šuškat	V
štace	N
mašle	N
aquapark	N
parciální	A
pěší	N
hbitý	A
závěrný	A
krusta	N
prostoupit	V
ozubený	A
cvakat	V
fantom	N
výsev	N
pražec	N
florbal	N
žížala	N
trousit	V
korál	N
obligátní	A
zakročit	V
mrňous	N
rozestup	N
satira	N
alegorie	N
doměkka	D
páv	N
strůjce	N
serena	N
puch	N
nedostatečnost	N
fuga	N
anorexie	N
koráb	N
improvizovat	V
computing	N
vikýř	N
humánní	A
stereo	A
exces	N
rezort	N
vagína	N
genocida	N
olše	N
upgrade	N
úhona	N
outfit	N
glosovat	V
zombie	N
bažant	N
neurčitost	N
sekulární	A
netbook	N
šustit	V
lejstro	N
ferdinand	N
katecheze	N
břečka	N
nikotin	N
přesila	N
svrchu	D
jojo	N
jilm	N
sít	V
tryskat	V
roztržka	N
virus	N
chlopeň	N
joint	N
reaktivní	A
džentlmen	N
imitovat	V
forvard	N
frak	N
zástěna	N
odkdy	D
matador	N
kvílet	V
čmelák	N
skafandr	N
směrodatný	A
takž	D
malicherný	A
šichta	N
artikl	N
koloběžka	N
drmolit	V
naslepo	D
kápnout	V
líheň	N
brokovnice	N
relikvie	N
bublat	V
valčík	N
prim	N
burácet	V
prosperovat	V
zemitý	A
punc	N
seshora	D
pergamen	N
judikatura	N
chlácholit	V
difuzní	A
trapas	N
imise	N
píst	N
pionýr	N
depo	N
snoubit	V
komponovat	V
dispečer	N
žalm	N
patos	N
subwoofer	N
peleta	N
měsíčník	N
nemotorný	A
misie	N
šukat	V
vizáž	N
cech	N
kartel	N
harém	N
opus	N
zeširoka	D
snubní	A
pop	A
showbyznys	N
tříšť	N
memoriál	N
štěnice	N
krtek	N
šourat	V
menhir	N
komprese	N
ultimátum	N
drobounký	A
štamgast	N
příklon	N
kozačka	N
píča	N
romance	N
kvartet	N
suplovat	V
neutrino	N
brož	N
nátura	N
razie	N
kopr	N
vemeno	N
gymnastika	N
sudý	A
jantar	N
koriandr	N
len	N
reál	N
kurzor	N
porto	N
macecha	N
antikvariát	N
nacionální	A
krédo	N
spílat	V
ceremonie	N
aba	N
ostruha	N
hangár	N
esenciální	A
nakřivo	D
zvnějšku	D
negr	N
sonáta	N
imponovat	V
osamět	V
bačkora	N
rozmysl	N
terra	N
autismus	N
termoska	N
culík	N
háv	N
odmala	D
adaptivní	A
šlépěj	N
zhola	D
sliz	N
třešeň	N
orgie	N
břímě	N
velebit	V
věštit	V
konejšit	V
kyprý	A
cifra	N
odér	N
řad	N
kánoe	N
frčet	V
silo	N
chmýří	N
kontinuum	N
luštěnina	N
bazický	A
parný	A
beran	N
provinční	A
secese	N
líhnout	V
zahltit	V
zmije	N
třáseň	N
seance	N
výron	N
hynout	V
ochutit	V
sele	N
koks	N
skandovat	V
čep	N
kodek	N
sakrální	A
manko	N
fiat	N
rafinerie	N
diferenciál	N
arboretum	N
neštovice	N
karbanátek	N
hroch	N
liturgie	N
cín	N
skrovný	A
nozdra	N
buržoazní	A
lub	N
naschvál	D
pašije	N
fjord	N
kapilára	N
kompot	N
prýštit	V
cestopis	N
znejistět	V
stream	N
onehdy	D
bago	N
šarvátka	N
magistrála	N
aut	N
gama	A
pleš	N
paštika	N
kapusta	N
prvotina	N
včetně	D
konzola	N
hospodárný	A
recyklovat	V
ultra	A
demontáž	N
mesiáš	N
aranžmá	N
nehorázný	A
přednes	N
jikra	N
notný	A
podlý	A
citroen	N
vavřín	N
hvízdat	V
čepec	N
end	N
publicistika	N
prcek	N
inkluze	N
osivo	N
vibrovat	V
bikiny	N
tuleň	N
ansámbl	N
pařát	N
týpí	N
muškát	N
puchýř	N
předsevzít	V
rozběh	N
papá	N
opium	N
koala	N
gejzír	N
nešvar	N
klarinet	N
grál	N
nahrubo	D
tombola	N
bobby	N
druhořadý	A
patina	N
cizorodý	A
fízl	N
rastr	N
mikrob	N
vykolejit	V
desátník	N
neplatnost	N
sutina	N
pupík	N
dekolt	N
báje	N
ofenzíva	N
muchomůrka	N
dojit	V
plejáda	N
lízat	V
krčma	N
percepce	N
mystika	N
škeble	N
vstoje	D
studit	V
odteď	D
baculatý	A
posunek	N
turbulence	N
happening	N
market	N
pat	N
párky	N
ovace	N
mimika	N
jízlivý	A
průprava	N
mačeta	N
paralyzovat	V
lapit	V
štika	N
lata	N
káď	N
meditovat	V
voština	N
difuze	N
zřídlo	N
sob	N
fádní	A
litera	N
podvědomý	A
forenzní	A
vymáčknout	V
bentonit	N
neochvějný	A
gladiátor	N
vulkanit	N
fígl	N
kokpit	N
dvouhra	N
rachotit	V
vřískat	V
poslíček	N
jasan	N
zívat	V
avokádo	N
punč	N
úkos	N
tikat	V
katoda	N
napomínat	V
obscénní	A
chanel	N
halena	N
špejle	N
bastard	N
pinzeta	N
šindel	N
sarkasmus	N
ostružina	N
pohan	N
outdoorový	A
odtažitý	A
citrus	N
hradlo	N
vysychat	V
konceptuální	A
loudat	V
toast	N
tonout	V
dakota	N
omráčit	V
znehybnět	V
lastura	N
kýta	N
klenout	V
suita	N
óda	N
vrávorat	V
odnikud	D
ken	N
plaše	D
rekonvalescence	N
našinec	N
droždí	N
elipsa	N
insolvence	N
nazbyt	D
štěpit	V
angel	N
pokryv	N
lektvar	N
arbitr	N
klonit	V
odstřel	N
imunní	A
výlov	N
tyristor	N
stamilión	N
kontrovat	V
univerzum	N
krocan	N
klábosit	V
tobolka	N
nejinak	D
chips	N
paket	N
štos	N
žeton	N
rotovat	V
pyrit	N
srnec	N
ležák	N
noblesa	N
nikl	N
vespod	D
pooperační	A
hovado	N
silikon	N
optimum	N
lilek	N
kopa	N
vrták	N
nemilost	N
arktida	N
mantra	N
runa	N
neoblomný	A
depeše	N
kárat	V
překupník	N
modrobílý	A
obruč	N
premisa	N
plena	N
skluzavka	N
buřt	N
árijský	A
zneklidnit	V
akustika	N
vývěr	N
pilota	N
rekrutovat	V
poslepu	D
skulptura	N
graffiti	N
nuance	N
karafa	N
man	N
míza	N
casting	N
embargo	N
krumpáč	N
pleistocén	N
society	N
nadstandard	N
lekat	V
poprask	N
políček	N
seslat	V
čenich	N
kargo	N
výheň	N
chorý	A
strž	N
viadukt	N
pegmatit	N
peugeot	N
punk	N
hvozd	N
žezlo	N
prolog	N
lama	N
king	N
pokladní	N
luštit	V
harfa	N
akné	N
kápo	N
kravál	N
skleróza	N
dóza	N
apel	N
šasi	N
fobie	N
celulitida	N
zvesela	D
ruleta	N
hvizd	N
šafrán	N
díkůvzdání	N
satisfakce	N
kobyla	N
tříštit	V
popcorn	N
ladem	D
mošt	N
srab	N
štítit	V
dispečink	N
bojkot	N
zmetek	N
surrealismus	N
podnož	N
mánie	N
konstrukt	N
elixír	N
demo	N
ofsajd	N
grémium	N
bundesliga	N
soukat	V
postroj	N
liána	N
uskladnit	V
montérky	N
švih	N
vegetativní	A
šalotka	N
infúze	N
střemhlav	D
radno	A
nepohoda	N
primer	N
pročpak	D
odkudkoli	D
kos	N
sushi	N
averze	N
buclatý	A
front	N
zefektivnit	V
žalud	N
jatka	N
aplaus	N
omeleta	N
pantofle	N
obchůzka	N
placatý	A
ateismus	N
apatie	N
šarže	N
přimáčknout	V
vikář	N
projektil	N
kanec	N
veto	N
zahálet	V
porsche	N
turban	N
dikce	N
hryzat	V
trnout	V
tobogan	N
dlít	V
teorém	N
tristní	A
klít	V
determinovat	V
apetýt	N
perón	N
chór	N
statika	N
hnít	V
kord	N
netknutý	A
kout	V
mentor	N
vlohy	N
korýš	N
tata	N
dužina	N
rand	N
vřeteno	N
band	N
kapku	D
kápě	N
palanda	N
baret	N
emo	N
stupidní	A
květena	N
ostýchat	V
fotr	N
třicátník	N
kuna	N
přepad	N
rehabilitovat	V
šejk	N
zhusta	D
antilopa	N
vát	V
prohibice	N
šťourat	V
šatičky	N
oves	N
tyfus	N
bachař	N
nesoulad	N
uléhat	V
kát	V
přebíhat	V
bezútěšný	A
tampon	N
perzekuce	N
karavana	N
ubikace	N
sekrece	N
prd	N
rozverný	A
opel	N
bon	N
revolta	N
pavilón	N
poštěstit	V
plzeň	N
černočerný	A
styling	N
jonathan	N
plak	N
instrument	N
sos	N
smoking	N
ragby	N
hranolky	N
culit	V
broukat	V
re	N
anarchie	N
narkóza	N
paranoia	N
sítí	N
signor	N
devítka	N
sumec	N
titulka	N
lokus	N
neviňátko	N
bus	N
glaciál	N
eskorta	N
doprostřed	D
podvodní	A
ortel	N
traktát	N
šup	N
neplodnost	N
platan	N
duet	N
lomcovat	V
nedozírný	A
etablovat	V
píď	N
aula	N
diference	N
krůpěj	N
převýšit	V
prodyšný	A
missa	N
narcis	N
inverze	N
roláda	N
hajduk	N
australopiték	N
torpédo	N
alimenty	N
impulzívní	A
memento	N
epos	N
turniket	N
humus	N
beryl	N
objížďka	N
uhel	N
hníst	V
dřívějšek	N
pomaličku	D
úchylka	N
widget	N
igelit	N
kštice	N
chryzantéma	N
zpronevěra	N
syžet	N
marináda	N
hr	D
feminismus	N
neuróza	N
bujet	V
monument	N
smaragd	N
aspirin	N
renta	N
sobec	N
astra	N
laň	N
pracka	N
tinktura	N
groteska	N
pětistovka	N
hatchback	N
úschova	N
luka	N
cucat	V
říje	N
vodnář	N
dychtit	V
prospekt	N
úsloví	N
struska	N
famózní	A
měch	N
zajedno	D
kvartál	N
putyka	N
buldozer	N
lodžie	N
chaluha	N
přerod	N
bula	N
level	N
škodolibý	A
kavalec	N
ozdravný	A
rozestoupit	V
swing	N
nemístný	A
sporťák	N
rula	N
ofina	N
zhmotnit	V
vidle	N
průduch	N
siločára	N
amoniak	N
písemka	N
kozoroh	N
věstník	N
neprospěch	N
tenor	N
archanděl	N
náruživý	A
alba	N
odsouzený	N
sonet	N
černovlasý	A
příhraniční	A
vlétnout	V
pralinka	N
dillí	N
obstrukce	N
křižák	N
surfovat	V
peloton	N
nanebevzetí	N
fixa	N
tříslo	N
nerozlučný	A
rým	N
sentiment	N
padesátník	N
tretra	N
dvoudílný	A
marxismus	N
zrána	D
promokavý	A
falanga	N
držka	N
podmanit	V
korektura	N
navýsost	D
rozjímat	V
drolit	V
patrona	N
fňukat	V
nahatý	A
ploužit	V
labilní	A
geneze	N
majestát	N
monstrózní	A
jod	N
mšice	N
gong	N
deportovat	V
plankton	N
mobiliář	N
lodivod	N
botanika	N
komika	N
fet	N
třeštit	V
kárný	A
exotika	N
turismus	N
humr	N
peníz	N
humanismus	N
nadloží	N
loci	N
narůžovělý	A
uhádnout	V
výmol	N
prenatální	A
drdol	N
nexus	N
minorita	N
bezprecedentní	A
rozkol	N
doga	N
emblém	N
disent	N
machinace	N
soft	A
zář	N
kajak	N
disertace	N
cudný	A
jen	N
dielektrikum	N
almužna	N
titěrný	A
hovět	V
albánský	A
enkláva	N
safír	N
aerobik	N
cylindr	N
gepard	N
afekt	N
věstit	V
archív	N
třtina	N
tubus	N
spočetný	A
delikatesa	N
strouha	N
bezpodmínečný	A
chvost	N
blíženec	N
postulát	N
úhor	N
naskýtat	V
dukát	N
kalcit	N
bárka	N
lyrika	N
šátrat	V
vpich	N
sfinga	N
samuraj	N
puzzle	N
tao	N
tempomat	N
podomácku	D
kňučet	V
kanape	N
voděodolný	A
sulfid	N
badminton	N
svitnout	V
kacíř	N
svízel	N
svrchovaný	A
blábol	N
vmáčknout	V
pašovat	V
klusat	V
karanténa	N
meandr	N
vštípit	V
aligátor	N
několikerý	A
navigovat	V
tovaryš	N
rolák	N
nadhoz	N
cello	N
karabina	N
adéla	N
hrtan	N
jaksepatří	D
nesvoboda	N
zarputilý	A
pancíř	N
mhouřit	V
provenience	N
maringotka	N
bonmot	N
dozvuk	N
beruška	N
hulit	V
škádlit	V
kohezní	A
klopit	V
navzdory	D
soprán	N
titan	N
baldachýn	N
buš	N
runda	N
pryčna	N
mizérie	N
pleskat	V
obskurní	A
čouhat	V
kvitovat	V
sója	N
vole	N
odevšad	D
drift	N
morbidní	A
maturovat	V
marginální	A
šeřík	N
vypláchnout	V
maskot	N
groš	N
aerobní	A
kaolín	N
hněvat	V
subsystém	N
vesna	N
nimrod	N
názvosloví	N
burcovat	V
krupobití	N
mangan	N
rozstřel	N
pyrop	N
bulva	N
plomba	N
domino	N
drásat	V
protekce	N
pandur	N
mastek	N
bezpilotní	A
pater	N
nevrlý	A
solidární	A
kanonáda	N
panda	N
angína	N
mnohde	D
lotr	N
papyrus	N
masopust	N
krážem	D
binární	A
dron	N
kdovíjak	D
youtube	N
jehně	N
peřej	N
krkolomný	A
armatura	N
septik	N
klastr	N
doutnat	V
trakař	N
řehtat	V
párat	V
otáčko	N
šmrnc	N
tribun	N
živořit	V
porozvodový	A
bodrý	A
trampolína	N
ruksak	N
exkrement	N
laso	N
krejcar	N
tasit	V
adjektivum	N
naspěch	D
oscilovat	V
podpovrchový	A
metla	N
havěť	N
potence	N
kolosální	A
sedma	N
mauzoleum	N
koncese	N
garnitura	N
odlétnout	V
hlodat	V
flákat	V
sigma	N
křížem	D
nanic	D
satén	N
restrikce	N
prérie	N
nasucho	D
šilink	N
závlaha	N
litanie	N
tag	N
sitcom	N
blizna	N
humno	N
krůta	N
sebelítost	N
trust	N
cedr	N
akta	N
sardinka	N
vestavný	A
mač	N
anonym	N
spanilý	A
back	N
nestranný	A
diva	N
umývárna	N
pomaloučku	D
konverzovat	V
peeling	N
plaketa	N
inspektorát	N
fík	N
milénium	N
hihňat	V
rej	N
zpoplatnit	V
sci-fi	N
militantní	A
inovovat	V
orodovat	V
průtrž	N
fošna	N
udolat	V
briefing	N
bajonet	N
draft	N
plénum	N
platina	N
lira	N
kuklit	V
skalp	N
kasta	N
poduška	N
relevance	N
levhart	N
director	N
listen	N
šinout	V
zvěstovat	V
námraza	N
cukrovar	N
ropucha	N
nepohodlí	N
kotrmelec	N
chřtán	N
lanýž	N
facelift	N
řapíkatý	A
spam	N
tropit	V
průduška	N
talk	N
signora	N
camp	N
klíčit	V
kolorit	N
nakročit	V
skin	N
záplata	N
kudrna	N
zamanout	V
protivit	V
obruba	N
analgetikum	N
podružný	A
sherry	N
lechtat	V
bacil	N
placenta	N
drožka	N
palisáda	N
provizórium	N
fokus	N
vzpínat	V
čtvrťák	N
trojitý	A
leknín	N
vykřičník	N
chuligán	N
šik	N
roztržitý	A
grázl	N
dopodrobna	D
zásnuby	N
opál	N
zesměšnit	V
pykat	V
rapid	N
fenykl	N
firmware	N
kazajka	N
flashdisk	N
stefan	N
zatvrzelý	A
ozón	N
photoshop	N
teatrální	A
postrach	N
diferencovat	V
kalit	V
dynamit	N
treska	N
mečbol	N
pelest	N
dopamin	N
cypřiš	N
reptat	V
neposedný	A
bádat	V
gazela	N
neúčast	N
heřmánek	N
straka	N
karma	N
odemykat	V
kanovník	N
vlítnout	V
stvol	N
lino	N
klakson	N
mušketýr	N
amík	N
lokna	N
rákos	N
neon	N
sípat	V
dvanáctka	N
fenotyp	N
margareta	N
šlechetný	A
almara	N
podtón	N
škaredý	A
nissan	N
arkáda	N
nadosmrti	D
šerm	N
modem	N
sedativum	N
drn	N
script	N
despekt	N
pyré	N
kolibřík	N
pískovna	N
vtírat	V
mrskat	V
paušální	A
rezervoár	N
zřít	V
bakalář	N
siemens	N
pieta	N
spartak	N
cizokrajný	A
pižmo	N
boltec	N
fén	N
bezvýchodný	A
fort	N
nebezpečnost	N
roztodivný	A
svůj	A
herbicid	N
štafle	N
biker	N
jüan	N
plato	N
truck	N
klátit	V
ládovat	V
vniveč	D
amfibol	N
magistr	N
převor	N
pojezd	N
udice	N
recidiva	N
machr	N
kofola	N
pelyněk	N
reklamovat	V
znervóznět	V
grácie	N
pražit	V
rozčilit	V
zevrubný	A
sesout	V
suspenze	N
gondola	N
skřek	N
lelek	N
obhlídka	N
mosaz	N
fanfára	N
malinkatý	A
populismus	N
pádlo	N
anoda	N
revival	N
dovětek	N
polder	N
legíny	N
pavián	N
posměšek	N
poněkolikáté	D
nezkrotný	A
okov	N
harampádí	N
komuna	N
medikament	N
varan	N
voliéra	N
lego	N
jaguár	N
emitor	N
natožpak	D
medailonek	N
mat	N
častovat	V
nepravidelnost	N
džihád	N
judo	N
pitvat	V
patnáctka	N
chmura	N
bez	N
bilancovat	V
skučet	V
aqua	N
utichat	V
penále	N
neandrtálec	N
dehet	N
bělmo	N
honda	N
slídit	V
vmžiku	D
smrtonosný	A
výtrus	N
osika	N
tvárný	A
pulec	N
aloe	N
priori	D
spratek	N
crčet	V
hodovat	V
amplión	N
trychtýř	N
zacelit	V
kopretina	N
kaučuk	N
lipid	N
třetihory	N
axiom	N
rašit	V
inklinovat	V
nefér	D
minaret	N
lachtan	N
šanon	N
plápolat	V
sejf	N
želé	N
tala	N
cejch	N
kolonialismus	N
tóra	N
pramice	N
redigovat	V
vypláznout	V
maxima	N
briketa	N
řiť	N
namol	D
klauzule	N
otka	N
sofa	N
dezén	N
étos	N
rekviem	N
altruismus	N
showroom	N
dualismus	N
odnepaměti	D
hornatý	A
nálevka	N
dvoukřídlý	A
trýzeň	N
matrix	N
bezvýrazný	A
vylodit	V
žlutat	V
manufaktura	N
tykev	N
lamino	N
slum	N
panter	N
newton	N
kolon	N
implikovat	V
khaki	A
tetelit	V
oj	N
snob	N
chvátat	V
anémie	N
amonný	A
rébus	N
hlady	D
manikúra	N
chobot	N
orgazmus	N
signifikantní	A
bezúdržbový	A
korouhev	N
akr	N
font	N
jinovatka	N
brouzdat	V
přítěž	N
rotunda	N
katarze	N
úzkostlivý	A
knot	N
akumulovat	V
opad	N
čakra	N
pípa	N
hyzdit	V
balanc	N
zespoda	D
zanevřít	V
kanyla	N
lithium	N
kaprál	N
book	N
hepatitida	N
mitochondriální	A
profit	N
pesto	N
sloupcovitý	A
risknout	V
přízvisko	N
příkoří	N
pendlovat	V
zlotý	N
rustikální	A
nesmlouvavý	A
předpokoj	N
nepravda	N
pavlač	N
provozní	N
supět	V
rubáš	N
letargie	N
morfium	N
virtuos	N
úzus	N
vně	D
flow	N
kýla	N
vazal	N
osvobozenecký	A
prak	N
folklór	N
čurat	V
karamel	N
zaoceánský	A
dědina	N
dresink	N
razance	N
ždímat	V
orat	V
agonie	N
yard	N
alt	N
jakbysmet	D
kozák	N
diskriminovat	V
šedomodrý	A
invertor	N
kamélie	N
kornout	N
louh	N
pesimismus	N
množný	A
cynik	N
šlahoun	N
dávit	V
tichounce	D
plahočit	V
placebo	N
masožravý	A
cenzor	N
jasmín	N
odpal	N
syndikát	N
fajnšmekr	N
zenit	N
infantilní	A
mana	N
vývěsní	A
riviéra	N
etuda	N
znělka	N
steroid	N
šutr	N
šoustat	V
deci	N
skríning	N
ametyst	N
trumpeta	N
bortit	V
nádeník	N
běs	N
třetinový	A
pleva	N
parafráze	N
kobra	N
káně	N
markrabě	N
dráb	N
skoupý	A
leukémie	N
pištět	V
báchorka	N
obhlížet	V
kahan	N
ordinovat	V
migrovat	V
rouno	N
úvoz	N
nok	N
špeh	N
hominid	N
činorodý	A
mlok	N
přihlouplý	A
rampouch	N
odshora	D
načít	V
zubr	N
kompozit	N
bookmaker	N
rolnička	N
participovat	V
kolika	N
mademoiselle	N
