achát	achát
ajnclík	ajnclík
akorát	akorát
akvabela	akvabela
alej	alej
aleluja	aleluja
alka	alka
almanach	almanach
almara	almara
alpaka	alpaka
altán	altán
amen	amen
ametyst	ametyst
amok	amok
amulet	amulet
apoštol	apoštol
ar	ar
arak	arak
aréna	aréna
arch	arch
archa	archa
arkáda	arkáda
artikl	artykl
artyčok	artyčok
arzenál	arsenal
atakovat	atak
atašé	atašé
atlas	atlas
atrapa	atrapa
avokádo	avokado
babočka	babočka
bacil	bacil
bacil	bacil
baculatý	baculatý
bača	bača
bačkora	bačkora
bačkora	bačkora
bafat	bafat
bach	bach
bachyně	bachyně
baklažán	baklažán
bakšiš	bakšiš
balada	balada
balalajka	balalajka
balast	balast
baldachýn	baldachýn
balet	balet
balík	balit
balík	balík
baloňák	plášť
balustráda	balustráda
barbiturát	barbiturát
baret	baret
bařtipán	pan
baryt	baryt
bašta	bašta
batist	batist
bavlna	vlna
bazalka	bazalka
bečet	bé
bedekr	bedekr
bek	bek
bekyně	bekyně
bela	bela
beruška	beruška
bešamel	bešamel
betl	betl
beton	beton
béžový	béžový
bíbr	bíbr
biřmovat	biřmovat
blahovičník	blahovičník
blejzr	blejzr
blekotat	blekotat
blizna	blizna
bluma	bluma
bod	bodnout
bodyček	bodyček
bohém	bohém
bojar	bojar
bojínek	bojínek
bojkot	bojkot
bolero	bolero
boltec	boltec
borec	borec
bort	bort
bota	bota
botel	botel
boule	boule
bourec	bourec
brak	brak
brčál	brčál
brejlovec	brýle
brok	brok
brokát	brokát
brokolice	brokolice
brom	brom
brož	brož
brukev	brukev
brusle	brusle
bryčka	bryčka
brykule	brykule
bryndat	bryndat
bryskní	bryskní
brzlík	brzlík
buclatý	buclatý
bufa	bufat
buchar	bouchat
buchar	buchar
buchta	buchta
buket	buket
buklé	buklé
bula	bula
bulík	bulík
bulík	bulík
buližník	buližník
bulva	bulva
buly	buly
bůr	bůr
burák	ořech
buřinka	buřina
buřt	buřt
buřt	buřt
busola	buzola
buš	buš
buš	buš
butelka	butelka
buzar	buzar
bužírka	bužírka
bzikat	bzikat
bžunda	bžunda
cajk	cajk
cálovat	cálovat
cár	cár
cedr	cedr
cedule	cedule
cech	cech
cejch	cejch
cejcha	cícha
cejn	cejn
cejn	cejn
cela	cela
celer	celer
cemr	cemr
cepenět	cepenět
cibetka	cibet
cihla	cihla
cikáda	cikáda
cikcak	cikcak
cikorka	cikorka
cíl	cíl
cimra	cimra
cink	cinknout
cíp	cíp
citadela	citadela
civět	civět
cizrna	cizrna
clo	clo
cop	cop
coul	coul
courat	courat
couvat	couvat
cukat	cuknout
cuketa	cuketa
cukr	cukr
cupovat	cupovat
cválat	cval
cvičit	cvičit
cvikr	cvikr
cvrček	cvrkat
cypřiš	cypřiš
cypřiš	cypřiš
čača	čača
čachrovat	čachr
čapka	čapat
čardáš	čardáš
časopis	časopis
častovat	častovat
čečetka	čečetka
čechrat	čechrat
čejka	čejka
čekanka	čekat
černokněžník	černokněz
čičorka	čičorka
činka	čina
čižma	čižma
čokoláda	čokoláda
čolek	čolek
čtverylka	čtverylka
čuba	čuba
čubrnět	čubrnět
čučet	čučet
čumět	čumět
čuně	čuně
čupřina	čupřina
čutat	čutat
čutora	čutora
čuvač	čuvač
daktyl	daktyl
dalamánek	dalamánek
další	dál
dáma	dáma
debužírovat	bužírovat
dědic	dědit
děkan	děkan
deklasovat	klasa
děkovat	dik
dikobraz	dikobraz
divizna	divizna
dlask	dlask
dmýchat	dmychat
dok	dok
dolomit	lámat
domino	domino
don	don
dort	dort
drabař	drabař
drachma	drachma
drak	drak
dražé	dražé
drek	drek
droby	drob
dromedár	dromedár
drops	drops
drožka	drožka
dřík	dřík
dudy	dudy
duchna	duchna
dukát	dukát
dumat	dumat
duna	duna
dunět	dunět
dupat	dupnout
dur	dur
důra	důra
dural	dural
durch	durch
dynamit	dynamit
ebonit	ebonit
edém	edém
echo	echo
ekrazit	ekrazit
elév	elév
epopej	epopej
epos	epos
éra	éra
erár	erár
erb	erb
erteple	erteple
eskadra	eskadra
eskapáda	eskapáda
estakáda	estakáda
ešus	ešus
etáž	etáž
eternit	eternit
etuda	etuda
etuje	etuje
fěrtoch	fěrtoch
fidlat	fidlat
fiknout	fikat
fofr	fofr
frc	frčet
fujara	fujara
fůra	fůra
hábit	hábit
háček	hák
háček	háček
hadr	hadr
hafan	hafat
háj	háj
hajat	hajat
hajdalák	hajdalák
hajduk	hajduk
hajlovat	hajlovat
hala	hala
hala	hala
halali	halali
halas	hlas
halda	halda
halena	halit
haléř	haléř
halit	halit
halma	halma
halo	halo
halucinace	halucinace
hamr	hamr
hantýrka	hantýrka
haprovat	haprovat
harém	harém
hartusit	hartusit
hasák	hasit
hastroš	hastroš
haše	haše
háv	háv
havíř	havíř
hazuka	hazuka
hedvábí	hedvábí
hmoždíř	hmoždit
hnípat	hnípat
hokuspokus	pokusit
hokynář	hokynář
holba	holba
holport	holport
holt	holt
horda	horda
horna	horna
hosana	hosana
hospic	hospic
houser	husa
hroch	hroch
hrubián	hrubý
hučet	hučet
hudlařit	hudlařit
hukot	houkat
hulit	hulit
hulvát	hulvát
humr	humr
husar	husar
huť	huť
hýčkat	hýčkat
hydrát	hydrát
chám	chám
chamtivý	chamtit
chlastat	chlastat
chlopeň	chlopeň
chmura	chmura
chňapat	chňapnout
cholera	cholera
chrom	chrom
ibis	ibis
ibišek	ibišek
ikebana	ikebana
ikonostas	ikonostas
itinerář	itinerář
jaspis	jaspis
jehněda	jehněda
jepice	jepice
ježibaba	ježibaba
jidáš	jidáš
jidiš	jidiš
jidiš	jidiš
jilec	jilec
jinan	jinan
jírovec	jírovec
jiřina	jiřina
jitro	jitro
jola	jola
juka	juka
jury	jury
just	just
kabát	kabát
kádr	kádr
kádr	kádr
kafe	káva
kachel	kachel
kalamajka	kalamajka
kalamář	kalamář
kalhoty	kalhoty
kaloň	kaloň
kaloun	kaloun
kalumet	kalumet
kalup	kalup
kamarád	kamarád
kamaše	kamaše
kamelot	kamelot
kamizola	kamizola
kamna	kamna
kamrlík	kamrlík
kanár	kanár
kanec	kanec
kanimůra	kanimůra
kanovník	kanovník
kápě	kápě
kápo	kápo
kaprál	kaprál
kapsa	kapsa
kapsle	kapsle
kapusta	kapusta
kaput	kaput
karamel	karamel
karát	karát
karavan	caravan
karavana	karavana
karavela	karavela
karbol	karbol
kardan	kardan
karkule	karkule
káro	káro
karotka	karotka
kartáč	kartáč
karusel	karusel
kasematy	kasematy
kasematy	kasematy
kastaněty	kastaněty
kastrol	kastrol
kašna	kašna
kaštan	kaštan
katr	katr
kavalec	kavalec
kavalír	kavalír
kečup	kečup
kejklat	kejklat
keks	keks
kelímek	kelímek
kepr	kepr
klábosit	klábosit
klacek	klacek
klacek	klacek
klaka	klaka
klaret	klaret
klášter	klášter
klávesa	klávesa
klavichord	klavichord
klematis	clematis
klempírovat	klempíř
klikva	klikva
klip	klip
klokan	klokan
klot	klot
klozet	klozet
klůcek	klůcek
kmán	kmán
kmihat	kmihat
knot	knot
kňour	kňour
kňourat	kňourat
kňučet	kňučet
kočár	kočár
kočkodan	kočkodan
kočovat	kočí
koketa	koketa
kokrhat	kokrhat
koks	koks
koláž	koláž
kolej	kolej
koliba	koliba
kolibřík	kolibřík
kolísat	kolísat
koňak	koňak
končíř	končíř
kónický	kůň
kontrola	kontrola
konvalinka	konvalinka
kopa	kopa
koprnět	koprnět
kopule	kopule
korba	korba
kormorán	kormorán
koruna	koruna
korýš	korýš
kořalka	kořala
koření	kořit
kosodřevina	kosodřevina
kostel	kostel
kostival	kostival
košer	košer
košer	košer
košťál	košťál
koštovat	koštovat
kotník	kotník
koukat	koukat
kozák	kozák
kozák	kozák
kozlík	kozlík
kozoroh	roh
krab	krab
krakorec	krakorec
krám	krám
kramflek	kramflek
kramle	kramle
kras	kras
kráter	kráter
kravál	kravál
kravata	kravata
krb	krb
krejcar	krejcar
krejzl	krejzl
krém	krém
kremrole	kremrole
krep	krep
kreslit	kreslit
kroket	kroket
krokodýl	krokodýl
kruchta	kruchta
krumpáč	krumpáč
krůta	krůta
křída	křída
křižmo	křižmo
kuběna	kuběna
kudla	kudla
kuchyň	kuchyň
kukla	kukla
kulak	kulak
kulantní	kulantní
kulich	kulich
kulich	kulich
kulma	kulma
kupé	kupé
kuplet	kuplet
kuplíř	kuplíř
kurát	kurát
kurtizána	kurtizána
kustod	kustod
kuše	kuše
kutálka	kutálka
kutat	kutit
kutloch	kutloch
kvádr	kvádr
kvádro	kvádro
kvalita	kvalita
kvaš	kvaš
kvaš	kvaš
kvazar	kvazar
kvedlat	kvedlat
kvelb	kvelb
kvér	kvér
kvit	kvit
kviz	kviz
kýbl	kýbl
kýč	kýč
kýl	kýl
kyt	kyt
kyt	kyt
kytlice	kytle
kytovec	kytovec
kyz	kyz
kýžený	kýžený
lacl	lacl
ládovat	ládovat
lajdat	lajdák
lajntuch	lajntuch
lajsna	lajsna
lak	lak
lák	lák
lakýrník	lakýrna
lán	lán
lano	lano
larva	larva
laso	laso
lať	lať
laterna	laterna
láteřit	látro
láva	láva
lavor	lavor
leč	léč
ledňáček	led
lejstro	lejstro
lékořice	lékořice
lemur	lemur
léno	léno
lenoch	lenoch
lenoch	líný
leták	letět
letora	letora
letovat	letovat
levandule	levandule
levhart	levhart
levity	levity
ležérní	ležérní
libeček	libeček
libela	libela
libra	libra
licousy	licousy
lila	lila
lišaj	lišaj
lišta	lišta
livrej	livrej
lob	lob
lodyha	lodyha
loch	loch
lokaj	lokaj
lokna	lokna
lokomotiva	lokomotiva
lomikámen	lomikámen
lord	lord
los	los
loto	loto
lotos	lotos
lotr	lotr
loubí	loubí
lpět	lpět
lucerna	lucerna
lulka	lulka
lumík	lumík
lupa	lupa
lustr	lustr
lůza	lůza
lyže	lyže
madam	madam
machr	machr
máj	máj
máj	máj
maják	maják
majolika	majolika
majuskule	majuskule
majzlík	majzlík
makadam	makadam
makak	makak
malovat	malovat
malta	malta
mamut	mamut
mana	mana
mandl	mandl
manéž	manéž
maník	maník
mapa	mapa
marabu	marabu
mariáš	mariáš
marka	marka
markovat	markovat
markrabě	hrabě
marmeláda	marmeláda
marš	marš
maršál	maršál
masa	masa
masakr	masakr
maskot	maskot
mašle	mašle
matice	matka
matjes	matjes
máz	máz
mazurka	mazurka
mazut	mazut
mečbol	mečbol
meduňka	meduňka
mejdan	mejdan
melodram	melodram
memorovat	memorovat
menu	menu
merčit	merk
meruňka	meruňka
mešita	mešita
metateze	těžký
mezanin	mezanin
míle	míle
milost	milý
mina	mina
minaret	minaret
mince	mince
mincíř	mincíř
miňonka	miňonka
minus	minus
minus	minus
minuskule	minuskule
mířit	mířit
mistral	mistral
mitra	mitra
mlaskat	mlaskat
mlok	mlok
mlž	mlž
mnich	mnich
mňoukat	mňoukat
mohutný	mohutný
mochna	mochna
moka	moka
mop	mop
moped	moped
morče	morče
mord	mord
morda	morda
morous	morous
mortadela	mortadela
moruše	moruše
mošt	mošt
moula	moula
mrakodrap	mrakodrap
mramor	mramor
mrkat	mrknout
muknout	mukat
mul	mul
mul	mul
mulda	mulda
mumlat	mumlat
mumraj	mumraj
můra	můra
muset	muset
mustr	mustr
muškát	muškát
mušle	mušle
myslivec	myslit
mýtina	mýtit
nabádat	nabádat
nabob	nabob
náčelník	náčelní
nádhera	nádhera
nach	nach
najáda	najáda
námět	namítnout
napalm	napalm
náplast	náplast
napospas	spasit
národ	rod
narval	narval
nářadí	řada
nářečí	říct
návladní	návladní
návladní	vládnout
nebozez	nebozez
nehorázný	nehorázný
nekropole	nekropole
nemotorný	nemotorný
neplecha	neplecha
neplecha	neplecha
nestvůra	tvořit
nešvar	švarný
nika	nika
nikl	nikl
nitro	nitro
nok	nok
nokturno	nokturno
nomád	nomád
nopál	nopál
nora	nora
nosorožec	nosorožec
notář	notář
notes	notes
noticka	noticka
notný	notný
novátor	nový
numero	numero
obelisk	obelisk
obojetný	obojetný
obr	obr
ocelot	ocelot
ohař	ohař
ohavný	ohavný
okr	okr
okres	okres
okřát	okřát
okřín	okřín
oktan	oktan
okteto	okteto
olbřím	olbřím
oliva	oliva
opat	opat
opatrný	patřit
opce	opce
oprať	oprať
optativ	optativ
orální	orála
oranžový	oranž
orkán	orkán
orloj	orloj
ornát	ornát
orobinec	orobinec
ortel	ortel
oř	oř
osmahlý	smažit
ošidný	šidit
ošuntělý	ošuntět
pac	pac
pac	pac
pác	pác
pác	pác
pádlo	pádlo
pachole	pachole
pacht	pacht
pajdat	pajdat
pájet	pájet
pajšl	pajšl
pakatel	pakatel
pakl	pakl
pako	pako
pako	pako
pakovat	pakovat
pakt	pakt
palačinka	palačinka
palaš	palaš
palcát	palcát
paleto	paleto
palisáda	palisáda
palma	palma
paluba	paluba
pánev	pánev
papá	papá
papacha	papacha
papat	papat
papila	papila
paprika	paprika
papuče	papuč
papula	papula
pár	pár
pas	pas
pasé	pasé
pastilka	pastilka
paša	paša
pašák	pašák
pašerák	pašovat
pašije	pašije
pašije	pašije
paškál	paškál
paštika	paštika
pat	pat
patoky	patoky
pátrat	pátrat
patrola	patrola
páv	páv
páže	páže
pečárka	pečárka
péče	pečovat
pedel	pedel
pech	pech
pěkný	pěkný
pelest	pelest
pelikán	pelikán
penál	penál
pěnice	pěnice
penis	penis
pěnkava	pět
perena	perena
perkelt	perkelt
perla	perla
perlík	perlík
peřej	peřej
pesticid	pesticid
pestík	pestík
petit	petit
petržel	petržel
píča	píča
piknik	piknik
piky	piky
pilný	píle
pilulka	pilule
pinďour	pinďour
pípa	pípa
piškot	piškot
píštěl	píštěl
pivoňka	pivoň
pižmo	pižmo
plac	plac
plácat	plácnout
plán	plán
plandat	plandat
plát	plát
platan	platan
platýs	platýs
pláž	pláž
plebejec	plebs
plédovat	plédovat
plech	plech
plejáda	plejáda
plezír	plezír
plichta	plichta
plisovaný	plizovat
plus	plus
plus	plus
plyn	plyn
plyš	plyš
podmět	podmět
podroušený	podroušit
pohár	pohár
pochva	pochva
polknout	polknout
polstrovat	polstrovat
polštář	polštář
pomáda	pomáda
pomeranč	pomeranč
pomněnka	pomněnka
poník	poník
ponurý	nořit
popkorn	popkorn
popruh	pruh
porce	porce
porcelán	porcelán
porto	porto
poručík	ruka
pošetilý	pošetilý
pošmourný	šmouha
pošramotit	šramotit
pošta	pošta
pošuk	šukat
potaš	potaš
potkan	potkan
potlach	tlachat
potměchuť	tma
poťouchlý	poťouchlý
potutelný	potutelný
poulit	poulit
pozoun	pozoun
pracka	pracka
pralinka	pralinka
pranostika	pranostika
práskat	práskat
praštit	praštit
pravoslavný	pravoslaví
pré	pré
probošt	probošt
promile	promile
promile	promile
proskurník	proskurník
prospekt	prospekt
prošustrovat	prošustrovat
protežovat	protežovat
provokovat	provokovat
pruderie	prudérní
průmysl	promyslet
prvosenka	prvosenka
pryčna	pryčna
prýskat	prýskat
prýštit	pryštit
předmět	předmět
předseda	sedět
přepona	pnout
převor	převor
přezka	přazka
příčestí	příčestí
příčina	příčina
příjice	příjice
příslovce	slout
přitakat	tak
přítomný	přitom
psanec	psát
pterodaktyl	pterodaktyl
pucovat	pucovat
puč	puč
pudl	pudl
pudr	pudr
pukrle	pukrle
pulec	pulec
pulovr	pulovr
pulpit	pulpit
puma	puma
purkmistr	purkmistr
purkrabí	purkrabí
purpur	purpur
puškvorec	puškvorec
puštík	puštík
putyka	putyka
pytel	pytel
rabat	rabat
rabovat	rab
racek	racek
rada	rada
rada	rada
rafat	rafat
ráhno	ráhno
rajda	rajda
rajtovat	rajtovat
rám	rám
rámus	rámus
rande	rande
rapidní	rapidní
rapír	rapír
rapl	rapl
raport	raport
rarach	rarach
rašelina	rašit
ratlík	ratlík
ráže	ráž
rdesno	rdesno
rdousit	rdousit
rejstřík	rejstřík
rejžák	rýže
robot	robot
rododendron	rododendron
rokle	rokle
roláda	roláda
rolnička	rolnička
rolovat	rolovat
romaneto	romaneto
rorýs	rorýs
rošáda	rošáda
rošt	rošt
roura	roura
rozčilit	čílit
rozšafný	rozšafný
rubín	rubín
ruch	rušit
rukojmí	rukojmí
rukojmí	rukojmí
rukojmí	rukojmí
rukovat	rukovat
ruksak	ruksak
rula	rula
ruláda	ruláda
rum	rum
runa	runa
růž	růže
rybíz	rybíz
rýha	rýha
rychtář	rychta
rým	rým
rýma	rýma
rys	rys
rys	rys
rytíř	rytíř
rýžovat	rýžovat
řehole	řehol
řehtat	řehtat
římsa	římsa
říše	říše
sáček	sak
sádra	sádra
sajrajt	sajrajt
sajrajt	sajrajt
sajtna	sajtna
sako	sako
salám	salám
salaš	salaš
salát	salát
saldo	saldo
salto	salto
salutovat	salut
salva	salva
sámek	sámek
samet	samet
samohláska	samohláska
samovar	samovar
saponát	saponát
saranče	saranče
saranče	saranče
sardel	sardel
sardel	sardel
sarkom	sarkom
sasanka	sasanka
sedan	sedan
sekretář	sekretář
sekretář	sekretář
sekt	sekt
sekvoje	sekvoj
sekýrovat	sekýrovat
semiš	semiš
serenáda	serenáda
sezam	sezam
sichr	sichr
siláž	silo
skalp	skalp
skalpel	skalpel
skeč	skeč
skeč	skeč
skořice	skořice
skreč	skreč
skreč	skreč
skýva	skýva
slabika	slabika
slalom	slalom
sleď	sleď
slída	slída
slipy	slipy
sloka	sloka
slynout	slynout
smečka	smečka
smirek	smirek
smršť	smršť
snob	snob
sob	sob
soda	soda
sokl	sokl
soldateska	soldát
sololit	sololit
sonet	sonet
sopka	sopka
soprán	soprán
sosák	sosat
souhláska	věž
soutěska	těsný
soutěž	soutěž
spár	spár
spára	spára
spinet	spinet
spot	spot
stalaktit	stalaktit
stať	stať
stát	stát
stát	tát
stejk	stejk
stejšn	stejšn
stélka	stéla
sténat	sténat
stetoskop	stetoskop
stodola	stodola
stolice	stůl
storno	storno
story	story
story	story
strakatý	straka
streptomycin	streptomycin
struma	struma
střemhlav	střemhlav
střevle	střevle
stupidní	stupidní
sulc	sulc
supět	supět
suplovat	suplovat
suřík	suřík
sutana	sutana
suvenýr	suvenýr
svetr	svetr
svidřík	svidřík
svor	svor
sýček	sýc
sýkora	sýkora
sysel	sysel
šacovat	šaty
šajtle	šajtle
šakal	šakal
šál	šál
šalmaj	šalmaj
šalmaj	šalmaj
šalotka	šalotka
šalovat	šalovat
šaltovat	šaltovat
šaltr	šaltr
šalupa	šalupa
šalvěj	šalvěj
šamstr	šamstr
šanovat	šanovat
šaráda	šaráda
šarlat	šarlat
šarvátka	šarvátka
šarže	šarže
šasi	šasi
šašlik	šašlik
šatlava	šatlava
šejdrem	šejdrem
šejk	šejk
šek	šek
šelest	šelestit
šerpa	šerpa
šerpa	šerpa
šeřík	šeřík
šibenice	šibenice
šíbovat	šíbovat
šik	šik
šik	šik
šikana	šikana
šikmý	šikmý
šikovný	šikovný
šilhat	šilhat
šiml	šiml
šína	šína
škádlit	škádlit
škála	škála
škamna	škamna
škapulíř	škapulíř
škarpa	škarpa
škeble	škeble
škoda	škoda
škrpál	škrpál
škrtat	škrtat
škrtit	škrtit
šlak	šlak
šlamastyka	šlamastyka
šlapat	šlapat
šlehat	šlehat
šlem	šlem
šlohnout	šlohnout
šlukovat	šluknout
šlus	šlus
šmajdat	šmajdat
šmak	šmak
šmátrat	šmátrat
šmelit	šmelit
šmíra	šmíra
šmírovat	šmírovat
šmudla	šmudla
šmudla	šmudlat
šmuk	šmuk
šnaps	šnaps
šnek	šnek
šnek	šnek
šněrovat	šnůra
šnorchl	šnorch
šnytlík	šnytlík
šohaj	šohaj
šok	šok
šortky	šortky
šos	šos
šot	shot
šotek	šotek
šoupat	šoupat
špachtle	špachtle
špalda	špalda
špalek	špalek
špalír	špalír
špás	špás
špejchar	špýchar
špejle	špejle
špek	špek
špendlík	špendlík
šperhák	šperhák
špice	špice
špicl	špic
špíz	špíz
šponovat	špona
šproch	šproch
špulit	špoulit
špulka	špulka
šraňky	šraňky
šrapnel	šrapnel
šrot	šrot
šroub	šroub
štepovat	štep
štěrk	štěrk
štíhlý	štíhlý
štoček	štok
štola	štola
štolba	štolba
šťopka	šťopka
štorc	štorc
štos	štos
šťouchat	šťouchat
štrádovat	štrádovat
štráchy	štráchy
štrejchnout	štrejchnout
štreka	štreka
štulpna	štulpna
štupovat	štupovat
štych	štych
štymovat	štymovat
šuba	šuba
šup	šup
šupina	šupina
šuple	šuple
šuspajtl	šuspajtl
šutr	šutr
šváb	šváb
švabach	švabach
šveholit	šveholit
švestka	švestka
švihat	švihat
tabatěrka	tabák
taburet	taburet
tác	tác
tajemník	tajemný
tajtrlík	tajtrlík
takt	takt
talár	talár
tamaryšek	tamaryšek
tamtam	tamtam
tančit	tanec
tapeta	tapeta
tapír	tapír
taroky	taroky
tartan	tartan
taška	taška
taverna	taverna
tavolník	tavolník
tejp	tejp
tenkrát	tenkrát
tepich	tepich
tér	tér
terno	terno
teskný	tesknit
též	též
tik	tikat
tiket	tiket
tip	tip
titan	titan
titěrný	titěrný
tleskat	tlesknout
tlumit	tlumit
tmel	tmel
tolar	tolar
tomahavk	tomahavk
topas	topas
torba	torba
torzo	torzo
totožný	totožný
touš	touš
trable	trable
trachom	trachom
trajekt	trajekt
trakař	trakař
traktát	traktát
trám	trám
tramvaj	tramvaj
trasa	trasa
trast	trast
trať	trať
treska	treska
tresť	tresť
tretra	tretra
trolej	trolej
trop	trop
trotl	trotl
truc	truc
truhla	truhla
trychtýř	trychtýř
třasořitka	třasořitka
třeň	třeň
třímat	třímat
tucet	tucet
tuha	tuha
tuha	tuhý
tukan	tukan
tuleň	tulit
tulipán	tulipán
ťulpas	ťulpas
tuňák	tuňák
tuplovaný	tuplovat
turban	turban
turné	turné
turniket	turniket
tuřín	tuřín
tutlat	tutlat
tygr	tygr
tyl	tyl
tyran	týrat
ublížit	blížit
úbor	úbor
udatný	udatný
ulita	ulita
umolousaný	umolousat
unisono	unisono
unisono	unisono
urbář	urbář
urna	urna
úrok	úročit
ústrety	ústrety
ústřice	ústřice
útes	útes
utrejch	utrých
vachrlatý	vachrlatý
vakát	vakát
valach	valach
valčík	valčík
vale	vale
valcha	valcha
vana	vana
vanilka	vanila
varan	varan
varle	varle
vata	vata
vatra	vatra
váza	váza
veka	veka
verbež	verbovat
vercajk	vercajk
verdikt	verdikt
verpánek	verpán
verš	verš
věrtel	věrtel
verva	verva
vestibul	vestibul
věstník	věstit
vibrovat	vibrovat
vidrholec	vidrholec
vikář	vikář
víkend	víkend
vikev	vikev
vikýř	vikýř
vinyl	vinyl
vizmut	vizmut
vkus	vkus
vločka	vločka
vlys	vlys
volej	volat
vorvaň	vorvaň
vrak	vrak
vrhcáby	vrhcáby
vrhcáby	vrhcáby
vrkoč	vrkoč
vrkoč	vrkoč
vrtat	vrtat
vulva	vulva
vzájemný	vzájemný
vzor	vzor
zahálet	zahálet
zájmeno	jméno
zázvor	zázvor
zebra	zebra
zebu	zebu
zemák	zem
zeměžluč	zeměžluč
zenit	zenit
zhurta	zhurta
zurčet	zurčet
žaket	žaket
žárlit	žárlit
žatva	žnout
žehlit	žehlit
žemle	žemle
žervé	žervé
žeton	žeton
židle	židle
žok	žok
žolík	žolík
žolík	žolík
žoržet	žoržet
žralok	žralok
žralok	žralok
žula	žula
žumpa	žumpa
