být	V
mít	V
moci	V
tak	D
rok	N
už	D
jak	D
člověk	N
muset	V
velký	A
chtít	V
říci	V
pak	D
ještě	D
jít	V
vědět	V
také	D
stát	V
nový	A
celý	A
jiný	A
dobrý	A
kde	D
tam	D
dát	V
den	N
doba	N
dítě	N
vidět	V
začít	V
místo	N
malý	A
ruka	N
kdy	D
teď	D
dostat	V
myslet	V
práce	N
svět	N
strana	N
vysoký	A
čas	N
dělat	V
žena	N
muž	N
třeba	D
hlava	N
velmi	D
oko	N
město	N
starý	A
cesta	N
právě	D
tu	D
dům	N
proto	D
věc	N
voda	N
již	D
brzy	D
část	N
chvíle	N
systém	N
proč	D
hodina	N
tady	D
lze	V
nechat	V
problém	N
cena	N
rád	A
řada	N
škola	N
konec	N
hrát	V
firma	N
mladý	A
různý	A
čekat	V
mluvit	V
dlouhý	A
jediný	A
vrátit	V
zase	D
vypadat	V
koruna	N
vzít	V
patřit	V
dveře	N
vést	V
moc	D
oblast	N
potřebovat	V
stejný	A
pozdě	D
milión	N
žít	V
znát	V
tělo	N
stát	N
kniha	N
skupina	N
znovu	D
navíc	D
cítit	V
otec	N
ostatní	A
měsíc	N
především	D
získat	V
matka	N
jednou	D
hned	D
dále	D
jméno	N
projekt	N
znamenat	V
zde	D
auto	N
příliš	D
slyšet	V
nyní	D
co	D
téměř	D
noc	N
síla	N
dost	D
noha	N
program	N
sice	D
rozhodnout	V
hlas	N
film	N
minuta	N
pořád	D
přitom	D
pravda	N
existovat	V
vždy	D
sedět	V
přímo	D
druh	N
jistý	A
stačit	V
potom	D
bílý	A
tehdy	D
plný	A
špatný	A
procento	N
zdát	V
ulice	N
typ	N
černý	A
okno	N
směr	N
zatím	D
platit	V
otevřít	V
spolu	D
stůl	N
opět	D
pán	N
tým	N
trh	N
kraj	N
jednat	V
pan	N
těžký	A
zápas	N
psát	V
držet	V
jet	V
nízký	A
hledat	V
válka	N
cíl	N
dívat	V
pokoj	N
osoba	N
barva	N
základ	N
působit	V
číslo	N
role	N
zdroj	N
nabízet	V
energie	N
krok	N
sociální	A
metr	N
kolo	N
centrum	N
člen	N
kam	D
akce	N
obraz	N
forma	N
mnohem	D
přítel	N
obec	N
proces	N
skoro	D
trvat	V
syn	N
materiál	N
poté	D
vlas	N
sem	D
bůh	N
tvořit	V
model	N
věnovat	V
srdce	N
autor	N
láska	N
dílo	N
strom	N
rád	D
příběh	N
společný	A
klub	N
domů	D
tisíc	N
vzduch	N
úřad	N
teprve	D
síť	N
plán	N
rameno	N
úroveň	N
bát	V
jazyk	N
pole	N
krátký	A
miliarda	N
les	N
najednou	D
pravý	A
prezident	N
číst	V
policie	N
pes	N
soutěž	N
věk	N
široký	A
prst	N
smět	V
půl	N
text	N
postup	N
téma	N
ptát	V
plocha	N
koupit	V
fungovat	V
včera	D
blízký	A
rovněž	D
krev	N
stěna	N
rada	N
červený	A
slunce	N
manžel	N
příští	A
příjemný	A
kvalita	N
rychlý	A
datum	N
dosud	D
tvar	N
takhle	D
zrovna	D
hvězda	N
bratr	N
duch	N
pacient	N
kluk	N
měnit	V
politika	N
prostředek	N
strach	N
péče	N
dcera	N
řešit	V
pustit	V
zelený	A
záda	N
ministr	N
mrtvý	A
metoda	N
poslat	V
přát	V
večer	D
hora	N
list	N
mnohý	A
ráno	D
šance	N
zeď	N
šéf	N
provoz	N
úkol	N
prosit	V
kámen	N
sloužit	V
látka	N
banka	N
hodit	V
docela	D
kuchyně	N
doufat	V
spát	V
znít	V
boj	N
předtím	D
host	N
uvědomit	V
historie	N
sen	N
dít	V
loď	N
moře	N
proud	N
víno	N
bavit	V
příležitost	N
pozice	N
chovat	V
konkrétní	A
čelo	N
týkat	V
půda	N
máma	N
papír	N
řeka	N
trenér	N
večer	N
chybět	V
předmět	N
univerzita	N
stroj	N
kůň	N
příroda	N
podstata	N
rozvoj	N
objekt	N
připomínat	V
kůže	N
vloni	D
desítka	N
ven	D
vlna	N
zvuk	N
léto	N
táta	N
nést	V
deska	N
dolů	D
vrstva	N
sto	N
modrý	A
kamarád	N
čistý	A
chuť	N
doktor	N
těšit	V
vzpomínat	V
štěstí	N
mluvčí	N
růst	V
žák	N
zlatý	A
kontrola	N
styl	N
klient	N
škoda	N
pouhý	A
ústa	N
důsledek	N
teorie	N
verze	N
bydlet	V
pokusit	V
kolega	N
bohatý	A
tlak	N
soubor	N
klid	N
kapitola	N
chystat	V
kancelář	N
muzeum	N
probíhat	V
snaha	N
scéna	N
liga	N
září	N
vítr	N
pevný	A
duše	N
partner	N
produkt	N
struktura	N
technika	N
zima	N
volat	V
zavřít	V
dolar	N
park	N
kostel	N
předseda	N
určit	V
pryč	D
drahý	A
vznikat	V
svatý	A
gól	N
kategorie	N
všude	D
maso	N
učit	V
ucho	N
cizí	A
střecha	N
obr	N
zkusit	V
řídit	V
takto	D
krk	N
krize	N
hotel	N
prázdný	A
motor	N
praxe	N
předchozí	A
bránit	V
režim	N
tušit	V
sport	N
karta	N
mozek	N
smát	V
titul	N
ret	N
nejprve	D
zbraň	N
sobota	N
dokument	N
paměť	N
správa	N
král	N
stopa	N
horní	A
kontakt	N
soukromý	A
zpět	D
šaty	N
riziko	N
tolik	D
běžet	V
analýza	N
konat	V
lehký	A
vadit	V
svoboda	N
zub	N
zdravý	A
opakovat	V
rána	N
stín	N
osud	N
bota	N
elektrický	A
plyn	N
snadný	A
nalézt	V
euro	N
dřevo	N
princip	N
armáda	N
fond	N
útok	N
seznam	N
ostrov	N
fáze	N
hezký	A
most	N
příčina	N
věta	N
chlap	N
tma	N
přední	A
účel	N
čin	N
tvrdý	A
jíst	V
slabý	A
nebe	N
sníh	N
židle	N
oběť	N
přesný	A
těžko	D
nedostatek	N
poněkud	D
obvyklý	A
dařit	V
přičemž	D
trest	N
test	N
daň	N
atmosféra	N
koncert	N
dlaň	N
sklo	N
loňský	A
ryba	N
médium	N
sotva	D
překvapit	V
orgán	N
buňka	N
dráha	N
pěkný	A
komise	N
teplý	A
viz	V
pít	V
navštívit	V
region	N
kapsa	N
křídlo	N
díl	N
starat	V
roh	N
oheň	N
varianta	N
levý	A
potíž	N
soupeř	N
festival	N
žádat	V
pozemek	N
aktivní	A
alkohol	N
brána	N
objem	N
kočka	N
koleno	N
nos	N
kariéra	N
víkend	N
žlutý	A
román	N
víra	N
areál	N
touha	N
lék	N
olej	N
trpět	V
bok	N
jemný	A
zpívat	V
led	N
tábor	N
déšť	N
potřeba	D
vůně	N
termín	N
chránit	V
fotbal	N
vesmír	N
paže	N
častý	A
břeh	N
klást	V
tón	N
káva	N
prosinec	N
agentura	N
smích	N
manažer	N
kost	N
patro	N
čerstvý	A
zboží	N
zítra	D
charakter	N
ostrý	A
hotový	A
vzájemný	A
reálný	A
církev	N
též	D
pokaždé	D
domnívat	V
mapa	N
faktor	N
spočívat	V
studovat	V
pták	N
účinek	N
lišit	V
aktuální	A
hmota	N
levný	A
informovat	V
hledět	V
únor	N
milý	A
instituce	N
adresa	N
původ	N
vůle	N
zas	D
odmítat	V
předpoklad	N
pátek	N
obvod	N
vteřina	N
účet	N
spor	N
kruh	N
takzvaný	A
mléko	N
krása	N
pozitivní	A
zlý	A
kapitán	N
chytit	V
dávný	A
finance	N
fyzický	A
unie	N
studený	A
pozdní	A
křeslo	N
série	N
viset	V
hala	N
slza	N
tráva	N
nárok	N
pozor	N
kurs	N
odkud	D
stanovit	V
kapela	N
sál	N
detail	N
tichý	A
jinde	D
vítěz	N
přítomný	A
trať	N
fakulta	N
dno	N
horký	A
kapacita	N
hodlat	V
blížit	V
vina	N
čaj	N
nadále	D
populace	N
obrana	N
cukr	N
signál	N
dvůr	N
květ	N
padat	V
zvlášť	D
displej	N
jádro	N
premiér	N
vzor	N
trend	N
věž	N
slečna	N
norma	N
nebezpečí	N
tenkrát	D
moment	N
turnaj	N
větev	N
cigareta	N
mobil	N
sůl	N
předem	D
blok	N
kamera	N
dáma	N
klíč	N
nutit	V
design	N
diskuse	N
suchý	A
pár	N
strategie	N
hnědý	A
soused	N
kopec	N
trasa	N
kdykoli	D
díra	N
břicho	N
komora	N
váha	N
podpořit	V
planeta	N
symbol	N
náhodou	D
košile	N
prach	N
volit	V
šedý	A
interiér	N
údolí	N
strop	N
jezero	N
míč	N
skála	N
bolet	V
střed	N
konference	N
hrůza	N
svědek	N
chytrý	A
nůž	N
koukat	V
gen	N
mířit	V
mír	N
teda	D
oběd	N
tenký	A
rovný	A
dvojice	N
chléb	N
houba	N
mlčet	V
oficiální	A
dole	D
vzhůru	D
kouč	N
dluh	N
stoupat	V
kino	N
efekt	N
trávit	V
vzácný	A
trápit	V
kalhoty	N
rudý	A
galerie	N
málem	D
motiv	N
povinný	A
kov	N
ihned	D
zóna	N
konstatovat	V
budoucno	N
rys	N
kampaň	N
prostý	A
písek	N
bar	N
smutný	A
top	A
taška	N
negativní	A
jih	N
kořen	N
hustý	A
finále	N
kmen	N
chudý	A
dopředu	D
sever	N
hodný	A
úloha	N
revoluce	N
linie	N
disk	N
kritika	N
jeskyně	N
server	N
sex	N
start	N
měkký	A
pás	N
úhel	N
následný	A
dav	N
zírat	V
najevo	D
kanál	N
ovoce	N
fronta	N
měřit	V
kandidát	N
úsilí	N
sval	N
letět	V
bazén	N
říše	N
konflikt	N
reklama	N
pusa	N
emoce	N
vejce	N
plakat	V
populární	A
panel	N
znamení	N
vedoucí	N
varovat	V
pořad	N
brýle	N
hrubý	A
skříň	N
socha	N
zdaleka	D
klesat	V
láhev	N
sezóna	N
cyklus	N
parlament	N
premiéra	N
stěžovat	V
hospoda	N
reforma	N
sladký	A
nemovitost	N
dýchat	V
kněz	N
čtvrtek	N
terén	N
zázrak	N
hromada	N
zásoba	N
jevit	V
zpočátku	D
palác	N
tunel	N
osa	N
plášť	N
tlustý	A
odvaha	N
dohodnout	V
minimální	A
agent	N
dík	N
báseň	N
mohutný	A
prospěch	N
pláž	N
lid	N
soudit	V
stadión	N
tip	N
slavit	V
přísný	A
zvedat	V
droga	N
kříž	N
hovor	N
pohár	N
hlad	N
gesto	N
investovat	V
teta	N
talíř	N
hřbitov	N
maska	N
krabice	N
cestující	N
pošta	N
heslo	N
kabát	N
standard	N
profil	N
podobat	V
tvářit	V
hluk	N
kout	N
svítit	V
koberec	N
intenzívní	A
tuna	N
akademie	N
pomalý	A
šetřit	V
rádio	N
tanec	N
odstín	N
litr	N
čtvrt	N
pas	N
skočit	V
nahý	A
kritérium	N
generál	N
souhlas	N
žaludek	N
akcie	N
náměstek	N
album	N
definovat	V
lžíce	N
paprsek	N
experiment	N
lákat	V
terasa	N
klobouk	N
pauza	N
etapa	N
klášter	N
písmeno	N
požár	N
pruh	N
podezření	N
příbuzný	N
tempo	N
medaile	N
tuk	N
absolvovat	V
kolej	N
stabilní	A
máslo	N
software	N
archiv	N
louka	N
debata	N
kapka	N
koncept	N
čára	N
jakoby	D
úterý	N
laboratoř	N
publikum	N
nula	N
skvrna	N
legenda	N
líto	D
takřka	D
talent	N
koalice	N
frekvence	N
absolutní	A
argument	N
důraz	N
lampa	N
chrám	N
nádoba	N
video	N
přimět	V
veselý	A
expert	N
roztok	N
aspekt	N
duel	N
hloupý	A
lahev	N
kabina	N
intenzita	N
živit	V
vila	N
lídr	N
dotýkat	V
strčit	V
disciplína	N
hlídat	V
hokej	N
kontext	N
včela	N
kauza	N
poměry	N
základna	N
pilot	N
tendence	N
kouzlo	N
pozoruhodný	A
pleť	N
výrok	N
oceán	N
baterie	N
doopravdy	D
pěst	N
bezpečí	N
koule	N
útvar	N
senior	N
podzemní	A
vrah	N
inspirovat	V
trocha	N
hruď	N
zapomínat	V
komplex	N
kufr	N
nerv	N
recept	N
rekord	N
hornina	N
mínit	V
brada	N
anděl	N
mlha	N
myš	N
stezka	N
provázet	V
komentovat	V
sklep	N
statistika	N
vítat	V
sýr	N
předek	N
mrak	N
mráz	N
třást	V
trefit	V
kouř	N
papež	N
růže	N
fórum	N
primátor	N
peklo	N
komunita	N
pistole	N
polévka	N
gymnázium	N
plátno	N
pytel	N
shoda	N
sloup	N
mizet	V
kloub	N
posléze	D
pánev	N
medicína	N
strýc	N
všímat	V
plíce	N
post	N
mzda	N
trénovat	V
atom	N
daleký	A
respektive	D
vztek	N
šťáva	N
kód	N
beton	N
císař	N
lavice	N
koza	N
lokální	A
hrana	N
chalupa	N
mrzet	V
koš	N
téci	V
sahat	V
důl	N
molekula	N
sekunda	N
stres	N
kabel	N
ráj	N
nápoj	N
klín	N
pult	N
prezentovat	V
zákoník	N
pero	N
hádat	V
pata	N
nato	D
kráva	N
úcta	N
drama	N
management	N
báze	N
vlákno	N
polštář	N
limit	N
kaple	N
šok	N
hlína	N
palec	N
fantazie	N
ropa	N
korupce	N
štíhlý	A
lež	N
střídat	V
podnět	N
obočí	N
hřbet	N
katastrofa	N
paluba	N
náhlý	A
humor	N
pohovka	N
vize	N
drsný	A
samota	N
rám	N
síň	N
nehet	N
pot	N
mouka	N
volant	N
tyč	N
jednička	N
hrdlo	N
móda	N
komedie	N
modul	N
blesk	N
keř	N
blázen	N
jablko	N
bouře	N
meč	N
spravedlivý	A
těsný	A
med	N
bledý	A
holý	A
budovat	V
priorita	N
fasáda	N
terapie	N
uplatnit	V
ložisko	N
vojsko	N
modlit	V
novela	N
žánr	N
slepý	A
neustálý	A
hnát	V
odstup	N
profese	N
pátrat	V
medvěd	N
těsto	N
stehno	N
krystal	N
štít	N
vášeň	N
protest	N
poezie	N
monitor	N
hmyz	N
sféra	N
portrét	N
mince	N
žíla	N
raný	A
odhadnout	V
tragedie	N
salát	N
krutý	A
divize	N
zvát	V
pach	N
železo	N
trouba	N
spěchat	V
had	N
kůra	N
éra	N
křižovatka	N
pestrý	A
vtip	N
kolekce	N
vázat	V
pálit	V
dbát	V
vlk	N
disponovat	V
garáž	N
ateliér	N
biskup	N
seminář	N
rozhraní	N
legrace	N
tramvaj	N
inteligence	N
půlnoc	N
lézt	V
institut	N
radovat	V
cibule	N
drát	N
vtom	D
senát	N
autorita	N
spektrum	N
dozadu	D
spoléhat	V
komunikovat	V
advokát	N
akorát	D
rozhodčí	N
hrabě	N
emise	N
fenomén	N
čokoláda	N
křehký	A
show	N
vana	N
plavat	V
postupný	A
schéma	N
mlčky	D
dres	N
loket	N
deprese	N
režie	N
kotel	N
prevence	N
vrch	N
prvý	A
vonět	V
bomba	N
náruč	N
alternativa	N
vlast	N
okres	N
kopie	N
půjčit	V
oxid	N
platforma	N
zhluboka	D
nezaměstnanost	N
práh	N
rodit	V
farma	N
stříbro	N
udeřit	V
čert	N
šperk	N
ves	N
opora	N
tabule	N
mýlit	V
odvětví	N
plést	V
inženýr	N
horizont	N
chata	N
hnízdo	N
česnek	N
matematika	N
lev	N
idea	N
tableta	N
prase	N
nadace	N
verš	N
chlad	N
tuhý	A
maximum	N
foto	N
čerpat	V
hůl	N
minerál	N
okamžitý	A
kontinent	N
ulevit	V
pronikat	V
kladný	A
hoch	N
záhy	D
šeptat	V
personál	N
mez	N
odsud	D
naplno	D
vitamín	N
klima	N
box	N
malovat	V
muzika	N
ignorovat	V
salón	N
suma	N
vedle	D
balík	N
lov	N
nejistota	N
člun	N
bakterie	N
detektiv	N
bunda	N
zmocnit	V
matčin	A
univerzální	A
slušet	V
tajemný	A
princ	N
kilo	N
logika	N
vyslat	V
krém	N
perspektiva	N
křik	N
respekt	N
jednota	N
obřad	N
hřích	N
identifikovat	V
rezerva	N
tiskárna	N
faktum	N
pára	N
krb	N
pódium	N
škála	N
akt	N
končetina	N
zdobit	V
plast	N
komín	N
vektor	N
iniciativa	N
hrnec	N
trojice	N
deka	N
sako	N
rytíř	N
kompetence	N
pasivní	A
klinika	N
zakládat	V
aplikovat	V
uprostřed	D
ocel	N
respondent	N
solární	A
hit	N
lhůta	N
metro	N
pláč	N
pochyba	N
zábradlí	N
sekvence	N
zvolna	D
znova	D
cvičit	V
organizovat	V
partie	N
šikovný	A
karlovarský	A
pilíř	N
ruch	N
řetěz	N
chaos	N
primární	A
iluze	N
tahat	V
android	N
ikona	N
řvát	V
plech	N
favorit	N
odvětit	V
sekce	N
mříž	N
past	N
průvod	N
líbat	V
externí	A
bít	V
nevýhoda	N
oblak	N
stadium	N
nitro	N
absence	N
super	A
nezávislost	N
cela	N
orchestr	N
drak	N
mýtus	N
hrdý	A
stáj	N
všední	A
skromný	A
vyhlídka	N
samec	N
ideál	N
hladit	V
mezera	N
filtr	N
ambice	N
publikovat	V
parta	N
opak	N
radní	N
licence	N
prkno	N
napřed	D
jed	N
protokol	N
štědrý	A
pouto	N
anketa	N
jinam	D
vinný	A
kombinovat	V
jakkoli	D
brečet	V
tank	N
protein	N
uzel	N
nouze	N
kořist	N
ubohý	A
mávat	V
posvátný	A
stěží	D
klika	N
popel	N
konto	N
pepř	N
bezprostřední	A
sídlit	V
štáb	N
pouť	N
vrhat	V
krást	V
moudrý	A
dimenze	N
odpovědný	A
trik	N
mise	N
infekce	N
barák	N
index	N
batoh	N
orientovat	V
porce	N
koláč	N
lano	N
ošklivý	A
vézt	V
pouzdro	N
lineární	A
hnout	V
evoluce	N
ničit	V
segment	N
kapitál	N
robot	N
sourozenec	N
míjet	V
klec	N
police	N
sankce	N
vrata	N
ocas	N
mil	N
rozpaky	N
cihla	N
ovce	N
impuls	N
odpočívat	V
mše	N
místy	D
citovat	V
kroutit	V
řasa	N
sběr	N
hájit	V
raketa	N
plus	N
těžit	V
fólie	N
obývák	N
vykročit	V
kostým	N
soudruh	N
balkón	N
semeno	N
kopat	V
libra	N
graf	N
granát	N
kamna	N
péci	V
dokládat	V
puška	N
triumf	N
benzín	N
vpřed	D
vir	N
dioda	N
řemeslo	N
úkon	N
mnich	N
pěna	N
klavír	N
rakev	N
cup	N
skandál	N
motýl	N
konzervativní	A
burza	N
prát	V
smůla	N
podnikat	V
menu	N
chvět	V
zčásti	D
vcelku	D
legislativa	N
těhotný	A
kotník	N
ala	N
rázem	D
panika	N
originál	N
oltář	N
svetr	N
nanejvýš	D
rýže	N
nepříliš	D
legální	A
jáma	N
absurdní	A
bilance	N
blbý	A
plakát	N
porota	N
šátek	N
polní	A
proudit	V
dort	N
zvon	N
tenis	N
elita	N
smetana	N
rozpad	N
hráz	N
ojedinělý	A
námět	N
šňůra	N
pásek	N
chemie	N
vkus	N
racionální	A
záře	N
načež	D
kupodivu	D
kompromis	N
kontrast	N
kolonie	N
míle	N
instalovat	V
jen	D
vedro	N
morálka	N
syndrom	N
ústava	N
páteř	N
dieta	N
kardinál	N
lyže	N
katalog	N
pasáž	N
tečka	N
sonda	N
marketing	N
doprovodit	V
bible	N
pohřbít	V
jehla	N
otrok	N
pec	N
hlubina	N
mandát	N
bedna	N
bariéra	N
ořech	N
počít	V
fotit	V
kongres	N
kreslit	V
komunismus	N
sada	N
bušit	V
komfort	N
vskutku	D
toaleta	N
vzdálit	V
brzda	N
stíhat	V
inflace	N
dub	N
aktér	N
trůn	N
kádr	N
lípa	N
odolat	V
vdova	N
stěhovat	V
katedra	N
kudy	D
souprava	N
kdekoli	D
kontejner	N
tablet	N
aréna	N
plout	V
obdiv	N
odjakživa	D
promítat	V
tranzistor	N
zvěř	N
neschopnost	N
čirý	A
formulovat	V
kytara	N
ďábel	N
lekce	N
důstojný	A
zavazadlo	N
bezmála	D
nádech	N
trapný	A
grafika	N
galaxie	N
černobílý	A
profesionál	N
skóre	N
vůl	N
aparát	N
perfektní	A
dodatečný	A
menšina	N
můra	N
zastoupit	V
rozmanitý	A
designer	N
elektronika	N
krmit	V
zima	D
odezva	N
interní	A
moucha	N
recenze	N
neúspěch	N
veranda	N
plachta	N
zprvu	D
čočka	N
kočár	N
nevěsta	N
krýt	V
nářadí	N
džíny	N
video	A
záblesk	N
praštit	V
huba	N
resort	N
rozkládat	V
střevo	N
prvotní	A
konektor	N
rosa	N
kaše	N
zvonek	N
valit	V
šelma	N
akutní	A
hormon	N
formulář	N
kupředu	D
aféra	N
slon	N
vagón	N
naživu	D
játra	N
derby	N
masáž	N
kondice	N
stádo	N
havárie	N
pracující	N
protější	A
muslim	N
příbuzný	A
unikat	V
lord	N
angažmá	N
dusit	V
knoflík	N
opice	N
odpůrce	N
úrok	N
vynikat	V
kyselý	A
strmý	A
potichu	D
alej	N
prapor	N
kamión	N
zanedlouho	D
klávesa	N
hořký	A
jack	N
stručný	A
nuda	N
reportáž	N
muzikál	N
pitomý	A
on-line	A
chlubit	V
jizva	N
shora	D
šlapat	V
kolektiv	N
lesknout	V
moč	N
ohlas	N
svěží	A
recepce	N
spekulace	N
frank	N
pohltit	V
nepřítomnost	N
starý	N
klouzat	V
srst	N
pavilon	N
lak	N
působnost	N
islám	N
nafta	N
inspekce	N
registr	N
gauč	N
dělo	N
trčet	V
redukce	N
zvenčí	D
veterán	N
whisky	N
okupace	N
vymezit	V
vzestup	N
špína	N
magazín	N
sponzor	N
primitivní	A
útes	N
popřípadě	D
studio	N
terminál	N
řídký	A
bláto	N
fascinovat	V
socialismus	N
komplikovat	V
konstanta	N
aukce	N
figura	N
sir	N
nedůvěra	N
kandidovat	V
bylina	N
trpaslík	N
praktika	N
pružný	A
údiv	N
zaměstnat	V
plemeno	N
intimní	A
víko	N
naposled	D
tendr	N
výjev	N
hektar	N
pomník	N
vnuk	N
šíp	N
lázeň	N
klasika	N
šachta	N
tíha	N
koncern	N
řítit	V
tudy	D
krysa	N
bahno	N
paradox	N
kurva	N
tygr	N
remíza	N
major	N
osel	N
prs	N
taktika	N
element	N
bída	N
sluha	N
terč	N
hradit	V
trhat	V
světlo	D
míchat	V
perla	N
výčet	N
krčit	V
fragment	N
varhany	N
přemítat	V
vrtět	V
regulovat	V
žízeň	N
housenka	N
preferovat	V
verdikt	N
povel	N
podstoupit	V
rasa	N
pyramida	N
žebro	N
jazz	N
vznešený	A
nakolik	D
zblízka	D
hejno	N
objasnit	V
instinkt	N
set	N
tucet	N
jas	N
abstraktní	A
démon	N
účes	N
husa	N
enzym	N
keramika	N
teze	N
útěcha	N
autentický	A
petice	N
pila	N
akceptovat	V
kulisa	N
senzor	N
projekce	N
procedura	N
lhostejný	A
výpadek	N
penze	N
svislý	A
trup	N
sortiment	N
hrst	N
rezignovat	V
pozemský	A
struna	N
roztomilý	A
portfolio	N
logo	N
madam	N
obdoba	N
vpředu	D
orel	N
křeč	N
lišta	N
turné	N
háj	N
rozkoš	N
etika	N
hajzl	N
kravata	N
diamant	N
vousy	N
naproti	D
statečný	A
kometa	N
dým	N
akvárium	N
export	N
loutka	N
repertoár	N
referendum	N
infarkt	N
nehybný	A
úkor	N
loučit	V
skutek	N
rubrika	N
balon	N
bonus	N
paprika	N
status	N
stodola	N
jeřáb	N
balvan	N
reflex	N
mechanika	N
mělký	A
bouda	N
hrot	N
tlouci	V
čip	N
ironie	N
sud	N
špetka	N
penalta	N
chopit	V
magie	N
trám	N
plíseň	N
odeslat	V
rock	N
edice	N
injekce	N
fajn	D
harmonie	N
centr	N
nit	N
klepat	V
totální	A
agenda	N
fráze	N
korespondence	N
ňadro	N
zničehonic	D
reprodukce	N
luxus	N
zelí	N
bronz	N
diplomat	N
barbar	N
postranní	A
sláma	N
želva	N
šikmý	A
dozor	N
ladit	V
štvát	V
pocta	N
spára	N
konkurs	N
namítat	V
lepit	V
předsudek	N
seno	N
výtisk	N
plodina	N
doména	N
koeficient	N
váza	N
business	N
džungle	N
asfalt	N
patent	N
lávka	N
syrový	A
živel	N
deficit	N
sága	N
pól	N
věnec	N
zabezpečit	V
rota	N
elektroda	N
sekundární	A
emocionální	A
próza	N
golf	N
rozchod	N
mravenec	N
guvernér	N
hrnout	V
pýcha	N
kazit	V
chřipka	N
velet	V
recese	N
zrno	N
nečistota	N
lady	N
býk	N
kronika	N
vír	N
lokomotiva	N
kmitočet	N
rejstřík	N
rozklad	N
vléci	V
pěší	A
chlup	N
břemeno	N
expanze	N
brutální	A
žal	N
jelen	N
charita	N
širý	A
obohatit	V
specifikum	N
evidovat	V
pirát	N
němý	A
mrkev	N
měď	N
kachna	N
brouk	N
mozaika	N
totožný	A
žába	N
brigáda	N
zaslat	V
fandit	V
šampion	N
gram	N
přízeň	N
balit	V
regál	N
koryto	N
penis	N
nota	N
žár	N
pozvolna	D
spontánní	A
vesta	N
rum	N
vločka	N
membrána	N
neklid	N
sediment	N
slina	N
sklonek	N
audit	N
parfém	N
impérium	N
úroda	N
kreativní	A
silueta	N
obilí	N
jiskra	N
kognitivní	A
fikce	N
bizarní	A
tupý	A
cirkus	N
ocet	N
dvojka	N
eliminovat	V
čepel	N
jakkoliv	D
reliéf	N
zdolat	V
záminka	N
paleta	N
exemplář	N
demonstrovat	V
exploze	N
invaze	N
kužel	N
kukuřice	N
pavouk	N
korekce	N
příď	N
mísit	V
prorok	N
hadr	N
iont	N
génius	N
vděčit	V
ječet	V
vosk	N
sestoupit	V
borec	N
laser	N
operovat	V
substrát	N
konkurovat	V
molo	N
kapr	N
guma	N
katastr	N
stud	N
desky	N
donedávna	D
sopka	N
průřez	N
zuřit	V
beseda	N
cedule	N
sled	N
podloží	N
atentát	N
foukat	V
syntéza	N
citron	N
robustní	A
jogurt	N
lem	N
prostřední	A
pustý	A
masa	N
psychika	N
labyrint	N
kelímek	N
rvát	V
stráň	N
římsa	N
žert	N
útulek	N
siréna	N
útlý	A
exponát	N
koktejl	N
ústup	N
vápno	N
troufat	V
dokořán	D
trio	N
závada	N
vlídný	A
tabák	N
půvab	N
zajíc	N
kolaps	N
knedlík	N
červ	N
kolona	N
zlehka	D
líný	A
takt	N
trofej	N
závoj	N
katolík	N
děkan	N
navenek	D
antibiotikum	N
číhat	V
dekáda	N
jahoda	N
penzión	N
tapeta	N
gel	N
dekret	N
marka	N
ilustrovat	V
vojna	N
župan	N
prognóza	N
pluk	N
mýt	V
dřez	N
civět	V
rozptýlit	V
dozorce	N
nabádat	V
seriózní	A
krám	N
okurka	N
hrozen	N
algoritmus	N
úl	N
nádhera	N
nadřízený	N
extra	A
furt	D
střežit	V
gril	N
kohout	N
důsledný	A
pospíšit	V
anténa	N
elegance	N
desetiletý	A
domácí	N
administrativa	N
liška	N
redukovat	V
val	N
proton	N
prchat	V
četa	N
mlátit	V
smrdět	V
hloub	N
hovno	N
zápal	N
ghetto	N
faktura	N
adekvátní	A
pumpa	N
sauna	N
čeleď	N
šach	N
odněkud	D
developer	N
karosérie	N
eso	N
hedvábí	N
grant	N
manipulovat	V
junior	N
hlesnout	V
nespokojenost	N
tyčit	V
los	N
cpát	V
replika	N
útroby	N
štěrk	N
banán	N
mech	N
popředí	N
holub	N
helma	N
skýtat	V
přilba	N
bilión	N
céva	N
paráda	N
šofér	N
rival	N
bystrý	A
sypat	V
nerovnost	N
facka	N
značit	V
esej	N
kmotr	N
integrovat	V
komár	N
tleskat	V
chvála	N
trauma	N
port	N
potlesk	N
prestiž	N
lítat	V
charta	N
nájemce	N
tarif	N
riskantní	A
lít	V
přísun	N
laik	N
larva	N
upír	N
kras	N
půdorys	N
stonek	N
hovězí	A
vak	N
inzerát	N
mail	N
kult	N
punčocha	N
blog	N
tlama	N
masiv	N
exekuce	N
přízrak	N
mumlat	V
kdepak	D
zlatý	N
foton	N
kytka	N
postřehnout	V
trojka	N
puberta	N
mramor	N
zdatný	A
banální	A
šroub	N
kašel	N
napodobit	V
střep	N
neskutečno	N
sekera	N
gigant	N
image	N
ekologie	N
zamezit	V
ingredience	N
lopata	N
rub	N
žasnout	V
žláza	N
fosilní	A
realismus	N
parcela	N
bankrot	N
prut	N
čtveřice	N
zklidnit	V
doprava	D
pasta	N
sendvič	N
troska	N
komodita	N
drát	V
dřina	N
hrabat	V
bunkr	N
kotouč	N
propagovat	V
matice	N
žrát	V
tematika	N
obydlí	N
euforie	N
bonbón	N
zvenku	D
palma	N
byte	N
praskat	V
tolerovat	V
střízlivý	A
step	N
úchvatný	A
buben	N
smartphone	N
branže	N
pojit	V
záložka	N
zákulisí	N
porcelán	N
justice	N
klečet	V
taktéž	D
dráždit	V
kolotoč	N
šplhat	V
ben	N
krach	N
šunka	N
nadání	N
tác	N
ohřev	N
támhle	D
pospíchat	V
pohroma	N
průjezd	N
meta	N
miss	N
přitakat	V
parazit	N
kopyto	N
kompenzovat	V
arch	N
izolovat	V
smrk	N
podivuhodný	A
teritorium	N
stoper	N
konzervatoř	N
pizza	N
stotisíc	N
víla	N
likvidovat	V
dilema	N
stuha	N
malina	N
sudí	N
adrenalin	N
pokora	N
brusle	N
škodovka	N
summit	N
štěně	N
hřát	V
olovo	N
úsudek	N
polykat	V
spirála	N
tamhle	D
hardware	N
mimo	D
dekor	N
tkvět	V
dřít	V
sprostý	A
dynastie	N
pytlík	N
plazit	V
ubrus	N
bloudit	V
exil	N
environmentální	A
kamkoli	D
zpřístupnit	V
masakr	N
zátoka	N
zletilý	A
temeno	N
handicap	N
šít	V
toxický	A
vstříc	D
motat	V
šíje	N
korporace	N
tis	N
kodex	N
drink	N
fúze	N
újma	N
kupní	A
diplom	N
řezat	V
marihuana	N
gay	N
plastika	N
kapota	N
žárlit	V
kanonýr	N
magnet	N
rezidence	N
dravý	A
krokodýl	N
kasárna	N
hazard	N
konzerva	N
stipendium	N
ocitat	V
promile	N
alergie	N
pedál	N
provizorní	A
destinace	N
netopýr	N
pomeranč	N
průčelí	N
mandle	N
servírka	N
dějství	N
rokle	N
smíchy	D
mazat	V
zákoutí	N
ztěžka	D
limonáda	N
kosmetika	N
příměs	N
akvizice	N
protivný	A
provždy	D
těžiště	N
razit	V
turbína	N
monsieur	N
svačina	N
nikterak	D
čtyřletý	A
trosky	N
tuhle	D
munice	N
freska	N
ptáček	N
výběžek	N
honorář	N
satelit	N
luk	N
padesátka	N
extrém	N
třídit	V
kupa	N
hybrid	N
baron	N
inkoust	N
kousat	V
kontinuita	N
unavit	V
atribut	N
doušek	N
tep	N
music	N
povědomý	A
vízum	N
poblíž	D
ryzí	A
renezance	N
duo	N
rezistor	N
šuplík	N
rande	N
rallye	N
vkročit	V
úctyhodný	A
výtečný	A
křest	N
cyklistika	N
kasa	N
koridor	N
servírovat	V
závan	N
vývojář	N
strukturální	A
nominovat	V
mini	A
kazeta	N
zvykat	V
žralok	N
bába	N
revolver	N
bill	N
evangelium	N
síra	N
plácat	V
epocha	N
octnout	V
etiketa	N
dýka	N
rohlík	N
symetrie	N
vakuum	N
trn	N
vrba	N
džus	N
hemžit	V
kbelík	N
mák	N
inzulín	N
brašna	N
svrchní	A
něha	N
mina	N
piano	N
střelit	V
relace	N
fara	N
shluk	N
šála	N
minus	N
intuice	N
plazma	N
kotva	N
pochodeň	N
zip	N
pecka	N
gang	N
agrární	A
ventil	N
hučet	V
podnos	N
předčit	V
kývat	V
identický	A
ústrojí	N
dráp	N
protagonista	N
přívětivý	A
sekta	N
cloud	N
legitimní	A
komiks	N
džbán	N
vernisáž	N
triko	N
ego	N
úlovek	N
halda	N
docent	N
radikál	N
star	N
převléknout	V
lýtko	N
šablona	N
entropie	N
pyžamo	N
sprej	N
švestka	N
pór	N
mix	N
útulný	A
reflektovat	V
fazole	N
horor	N
šept	N
boom	N
znemožnit	V
balet	N
ambasáda	N
roleta	N
výklenek	N
impozantní	A
latina	N
úd	N
šek	N
jíl	N
rošt	N
gestapo	N
strohý	A
vymanit	V
zpravodaj	N
pokraj	N
flexibilní	A
vlažný	A
kráter	N
optika	N
sněm	N
bio	N
generovat	V
škrábat	V
zdánlivý	A
parapet	N
závěť	N
nekonečno	N
urna	N
parkovat	V
hruška	N
obdivuhodný	A
madame	N
staveniště	N
výběh	N
svině	N
třít	V
klišé	N
uchvátit	V
tvrz	N
roucho	N
šimpanz	N
vrtat	V
konzultovat	V
drtit	V
movitý	A
uzda	N
provokovat	V
jóga	N
rampa	N
mačkat	V
sytý	A
náběh	N
třpytit	V
držák	N
bob	N
rukojmí	N
lustr	N
labuť	N
fontána	N
cement	N
eroze	N
koňak	N
vydatný	A
alela	N
skladiště	N
komnata	N
faul	N
pískat	V
seržant	N
loterie	N
pahorek	N
děs	N
bordel	N
drzý	A
stop	N
nezájem	N
bezproblémový	A
bližní	N
klenot	N
kaštan	N
duchovní	N
narychlo	D
drůbež	N
půlhodina	N
mlít	V
knír	N
maják	N
sparta	N
excelence	N
konzole	N
surový	A
mafie	N
hlouček	N
kůl	N
individuum	N
frakce	N
country	N
losos	N
bek	N
aliance	N
navléknout	V
klan	N
pšenice	N
okázalý	A
čtyřka	N
boss	N
guláš	N
slogan	N
avenue	N
nepříjemnost	N
holt	D
speciál	N
konopí	N
sekretář	N
fabrika	N
opar	N
rýha	N
volejbal	N
letmo	D
lucerna	N
delta	N
mešita	N
vrána	N
racek	N
skořice	N
doteď	D
makat	V
vybízet	V
štěrbina	N
navěky	D
předloni	D
boson	N
máť	N
žaluzie	N
mrakodrap	N
gratulovat	V
idol	N
děloha	N
muka	N
pikantní	A
monstrum	N
homo	N
flek	N
workshop	N
vězet	V
dýně	N
vraždit	V
impedance	N
letopočet	N
toulat	V
klaun	N
konvence	N
čína	N
hluchý	A
koloniální	A
rtuť	N
suterén	N
tlumit	V
trajektorie	N
sandál	N
primát	N
radar	N
mušle	N
sádra	N
trakt	N
wellness	A
fatální	A
ponurý	A
kotlina	N
dezert	N
pást	V
hák	N
příkrý	A
pyl	N
stéblo	N
hospodář	N
živobytí	N
kat	N
manuál	N
kutný	A
ubíhat	V
proporce	N
linda	N
koleda	N
estetika	N
předčítat	V
steak	N
statný	A
velbloud	N
jásat	V
hrom	N
křída	N
slast	N
marina	N
sirup	N
rétorika	N
bříza	N
prémie	N
hebký	A
deklarovat	V
vyslýchat	V
uhodnout	V
vzrůst	N
neuron	N
semafor	N
kokain	N
nadobro	D
chirurgie	N
baráž	N
min	N
křemen	N
zvýraznit	V
clona	N
romantika	N
donekonečna	D
marmeláda	N
tvaroh	N
neutron	N
stacionární	A
synonymum	N
dan	N
korektní	A
emigrovat	V
rázný	A
debut	N
potaz	N
mikroorganismus	N
kopí	N
kaluž	N
kázat	V
info	N
tango	N
kukla	N
cíp	N
máj	N
kormidlo	N
fajn	A
stáž	N
plát	N
plachý	A
škvíra	N
potvora	N
jarmark	N
kamsi	D
skořápka	N
kecat	V
polemika	N
potažmo	D
selekce	N
hroutit	V
choť	N
mítink	N
diář	N
embryo	N
kasino	N
stimulovat	V
lavina	N
zdlouhavý	A
dorost	N
štola	N
civil	N
přít	V
zanikat	V
zbrusu	D
půst	N
vzlykat	V
exkurze	N
kalich	N
tele	N
trezor	N
znenadání	D
flétna	N
zet	V
úryvek	N
amplituda	N
sokol	N
dočista	D
kalorie	N
natrvalo	D
hody	N
blues	N
imaginární	A
klacek	N
motto	N
javor	N
kra	N
oblý	A
prvotřídní	A
kakao	N
korespondovat	V
cédéčko	N
dvacítka	N
vrak	N
kšeft	N
skot	N
hattrick	N
thriller	N
špenát	N
amnestie	N
konfrontovat	V
štěkat	V
kočí	N
rutina	N
trs	N
kantor	N
kartáč	N
žvýkat	V
srát	V
podezírat	V
opláchnout	V
pečeť	N
zpříma	D
vata	N
nablízku	D
teenager	N
fitness	A
nesnáz	N
alfa	N
postarší	A
kancléř	N
amatér	N
symptom	N
atletika	N
klíště	N
posmrtný	A
světnice	N
cop	N
stať	N
parchant	N
líc	N
oliva	N
mejdan	N
son	N
cent	N
hnůj	N
řepa	N
tabu	N
garda	N
nesčetný	A
kleště	N
bezpočet	N
klip	N
příměří	N
chabý	A
cenzura	N
kompost	N
cejtit	V
cár	N
buk	N
klapat	V
azyl	N
rozkvět	N
švagr	N
sunout	V
diktovat	V
svůdný	A
karikatura	N
atlas	N
pozadu	D
boxer	N
textil	N
router	N
jakost	N
zármutek	N
fauna	N
mrav	N
načase	D
spermie	N
nudle	N
suvenýr	N
adept	N
substance	N
milý	N
karton	N
patron	N
zákeřný	A
lukrativní	A
prosperita	N
drastický	A
šupina	N
sekat	V
terorismus	N
štafeta	N
výsada	N
diskrétní	A
strachy	D
gramatika	N
předkolo	N
inspirativní	A
ruina	N
limuzína	N
anatomie	N
blond	A
brázda	N
kantáta	N
rozmar	N
vzteky	D
průvan	N
nebohý	A
tlupa	N
jeptiška	N
chrlit	V
zrzavý	A
plac	N
slabika	N
