dimethylthiambuten	NOUN	-di-.methyl.-thi-.ambuten
stodvaatřicetičlenný	ADJ	sto.dva.třicet.člen
metylfosfonyldifluorid	NOUN	metyl.fosfonyl.-di-.fluorid
třísetpadesátikilometrový	ADJ	tři.sto.padesát.kilometrový
dvousetosmdesátikoňový	ADJ	dvě.sto.osmdesát.kůň
stodvacetipětiletý	ADJ	sto.dvacet.pět.léto
stopětatřicetiletý	ADJ	sto.pět.třicet.léto
dvousetosmimilionový	ADJ	dvě.sto.osm.milionový
třísetdvanáctistránkový	ADJ	tři.sto.dvanáct.stránkový
třistašedesátistránkový	ADJ	tři.sto.šedesát.stránkový
tetrapropylenbenzensulfonan	NOUN	-tetra-.propylen.benzen.sulfonan
devítiapůlakrový	ADJ	devět.půl.akrový
butylhydroxyanisol	NOUN	butyl.-hydroxy-.anisol
dvousetbodový	ADJ	dvě.sto.bodový
stopadesáticentimetrový	ADJ	sto.padesát.centimetrový
stošedesáticentimetrový	ADJ	sto.šedesát.centimetrový
červenozelenočerný	ADJ	červený.zelený.černý
zelenorůžovočerný	ADJ	zelený.růžový.červený
padesátitříčlenný	ADJ	padesát.tři.člen
čtyřicetidvoudenní	ADJ	čtyřicet.dva.denní
casterbridgeský	ADJ	caster.bridgeský
šestisetdolarový	ADJ	šest.sto.dolarový
středovýchodoevropský	ADJ	střed.východ.evropský
červenožlutofialový	ADJ	červený.žlutý.fialový
hnědošedofialový	ADJ	hnědý.šedý.fialový
stopatnáctigramový	ADJ	sto.patnáct.gramový
osmapůlhektarový	ADJ	osm.půl.hektarový
stosedmdesátihektarový	ADJ	sto.sedmdesát.hektarový
šedesátipětihektarový	ADJ	šedesát.pět.hektarový
dvousethektolitrový	ADJ	dvě.sto.hektolitrový
padesátitisícihlavý	ADJ	padesát.tisíc.hlava
dvacetipětikilový	ADJ	dvacet.pět.kilový
stopatnáctikilový	ADJ	sto.patnáct.kilový
dvaačtvrtkilogramový	ADJ	dva.čtvrt.kilogramový
čtyřicetisedmikilometrový	ADJ	čtyřicet.sedm.kilometrový
padesátišestikilometrový	ADJ	padesát.šest.kilometrový
stodvacetikilometrový	ADJ	sto.dvacet.kilometrový
stoosmdesátikilometrový	ADJ	sto.osmdesát.kilometrový
stosedmdesátilometrový	ADJ	sto.sedmdesát.kilometrový
stopětikilometrový	ADJ	sto.pět.kilometrový
devadesátidvouletý	ADJ	devadesát.dva.léto
osmdesátiosmiletý	ADJ	osmdesát.osm.léto
osmdesátitříletý	ADJ	osmdesát.tři.léto
padesátijednaletý	ADJ	padesát.jedna.léto
stočtrnáctiletý	ADJ	sto.čtrnáct.léto
třísetletý	ADJ	tři.sto.léto
čtyřsetlitrový	ADJ	čtyři.sto.litrový
betacetylmethadol	NOUN	beta.acetyl.methadol
osmiapůlmiliardový	ADJ	osm.půl.miliardový
stopadesátimiliardový	ADJ	sto.padesát.miliardový
stopadesátimilimetrový	ADJ	sto.padesát.milimetrový
čtyřsetmilionový	ADJ	čtyři.sto.miliónový
stosedmdesátimiliónový	ADJ	sto.sedmdesát.miliónový
stosedmdesátimilionový	ADJ	sto.sedmdesát.miliónový
stoosmdesátiminutový	ADJ	sto.osmdesát.minutový
stotřicetimutový	ADJ	sto.třicet.minutový
bíločernomodrý	ADJ	bílý.černý.modrý
stopadesátinásobek	NOUN	sto.padesát.násobek
stošedesátinásobek	NOUN	sto.šedesát.násobek
dvacetidevítinásobný	ADJ	dvacet.devět.násobný
stoosmnáctinásobný	ADJ	sto.osmnáct.násobný
trojapůlnásobný	ADJ	tři.půl.násobný
tetraetylolovo	NOUN	-tetra-.etyl.olovo
tetramethylolovo	NOUN	-tetra-.methyl.olovo
čtyřistaosmdesátšestka	NOUN	čtyři.sto.osmdesát+šest
třistapadesátiletý	ADJ	tři.sto.padesát
jedenáctsetpadesátka	NOUN	jedenáct.sto.padesátka
dvacetišestipatrový	ADJ	dvacet.šest.patrový
tetraethylplumbium	NOUN	-tetra-.-ethyl-.plumbum
čtyřicetidevítiprocentní	ADJ	čtyřicet.devět.procentní
dvacetitříprocentní	ADJ	dvacet.tři.procentní
stodesetiprocentní	ADJ	sto.deset.procentní
stopadesátiprocentní	ADJ	sto.padesát.procentní
trihydroxypyrimidin	NOUN	-tri-.-hydroxy-.pyrimidin
dvaapůlroční	ADJ	dva.půl.roční
dvousetstránkový	ADJ	dvě.sto.stránkový
čtyřiapůltisícový	ADJ	čtyři.půl.tisícový
stopadesátitisícový	ADJ	sto.padesát.tisícový
dvaačtvrttunový	ADJ	dva.čtvrt.tunový
černozelenožlutý	ADJ	černý.zelený.žlutý
hlinitoborokřemičitan	NOUN	hliník.bor.křemičitan
dvoušuplíkový	ADJ	dva.šuplíkový
dvouwattový	ADJ	dva.wattový
jedenasedmdesáticentimetrový	ADJ	jedenasedmdesát.centimetrový
stodevětapadesátka	NOUN	sto.devět.padesát
aeroakrobacie	NOUN	-aer-.akrobacie
angiokardiografie	NOUN	-angi-.kardiografie
astrokartografie	NOUN	-astr-.kartografie
bioklimatologie	NOUN	-bio-.klimatologie
bionanotechnologie	NOUN	-bio-.nanotechnologie
Cyanoprokaryonta	NOUN	-cyan-.prokaryonta
elektrovelkoobchod	NOUN	-elektr-.velkoobchod
exmístopředseda	NOUN	-ex-.místopředseda
fytopaleontologie	NOUN	-fyt-.paleontologie
hydrochlorothiazid	NOUN	-hydr-.chlorothiazid
cholangiografie	NOUN	-chol-.angiografie
meningoencefalitida	NOUN	-mening-.encefalitida
monoizotopický	ADJ	-mon-.izotopický
multidatabázový	ADJ	-multi-.databázový
neuroradiologie	NOUN	-neur-.radiologie
onkohematologie	NOUN	-onk-.hematologie
oxyhemoglobin	NOUN	-oxy-.hemoglobin
paleogeografie	NOUN	-palai-.geografie
pericholecystitida	NOUN	-peri-.cholecystitida
psychopatologie	NOUN	-psych-.patologie
trimetylolpropan	NOUN	-tri-.metylpropan
adeninribonukleotid	NOUN	adenin.ribonukleotid
aminopolykarboxylový	ADJ	amin.polykarboxylový
aminoundekanový	ADJ	amin.undekanový
arylcyklohexylamin	NOUN	aryl.cyklohexylamin
čtyřiadvacetijehličkový	ADJ	čtyřiadvacet.jehličkový
čtyřiadvacetisnímkový	ADJ	čtyřiadvacet.snímkový
čtyřiapadesátistupňový	ADJ	čtyřiapadesát.stupňový
čtyřiasedmdesátinásobek	NOUN	čtyřiasedmdesát.násobek
čtyřiašedesátiletý	ADJ	čtyřiašedesát.léto
devětadvacetitrackový	ADJ	devětadvacet.track
devětapadesátiletý	ADJ	devětapadesát.léto
devětatřicetinásobek	NOUN	devětatřicet.násobek
dvaačtyřicetipodlažní	ADJ	dvaačtyřicet.podlažní
dvaačtyřicetistupňový	ADJ	dvaačtyřicet.stupňový
dvaadevadesátiprocentní	ADJ	dvaadevadesát.procentní
dvaadvacetietapový	ADJ	dvaadvacet.etapový
dvaaosmdesátiprocentní	ADJ	dvaaosmdesát.procentní
dvaapadesátipalcový	ADJ	dvaapadesát.palcový
dvaatřicetisvazkový	ADJ	dvaatřicet.svazkový
dvacetimegabitový	ADJ	dvacet.megabitový
dvojnekrolog	NOUN	dvě.nekrolog
erotickosymbolický	ADJ	erotika.symbol
etylchlorvinol	NOUN	etyl.chlorvinol
Chordopoxvirinae	NOUN	Chordopox.virinae
jedenačtyřicetitisícový	ADJ	jedenačtyřicet.tisícový
jedenadvacetikolíkový	ADJ	jedenadvacet.kolíkový
jedenaosmdesátiprocentní	ADJ	jedenaosmdesát.procentní
jednašedesátiletý	ADJ	jedenašedesát.léto
jednadevadesátiletý	ADJ	jednadevadesát.léto
mechanickobiologický	ADJ	mechanický.biologický
mikrowatthodina	NOUN	mikrowatt.hodina
mnohasetmetrový	ADJ	mnoho+sto.metrový
modrožlutočerný	ADJ	modrý.žlutočerný
naturfilozofie	NOUN	natur.filozofie
osmadvacetikilometrový	ADJ	osmadvacet.kilometrový
osmaosmdesátiprocentní	ADJ	osmaosmdesát.procentní
osmašedesátihektarový	ADJ	osmašedesát.hektarový
osmdesátimilimetrový	ADJ	osmdesát.milimetrový
pětačtyřicetimiliónový	ADJ	pětačtyřicet.miliónový
pětačtyřicetistupňový	ADJ	pětačtyřicet.stupňový
pětadvacetikilometrový	ADJ	pětadvacet.kilometrový
pětadvacetistupňový	ADJ	pětadvacet.stupňový
pětašedesátimiliónový	ADJ	pětašedesát.miliónový
pětatřicetilitrový	ADJ	pětatřicet.litrový
protičeskoslovenský	ADJ	proti.československý
půldruhastoletý	ADJ	půldruhý.stoletý
sedmadvacetitisícový	ADJ	sedmadvacet.tisícový
sedmapadesátikilometrový	ADJ	sedmapadesát.kilometrový
severoseverozápad	NOUN	sever.severozápad
sociálněpedagogický	ADJ	sociálně.pedagogický
setsakramentský	ADJ	sto.sakramentský
šestimilimetrový	ADJ	šest.milimetrový
šestačtyřicetiletý	ADJ	šestačtyřicet.léto
šestatřicetiprocentní	ADJ	šestatřicet.procentní
tmavomodrozelený	ADJ	tmavý.modrozelený
třiaosmdesátiletý	ADJ	třiaosmdesát.léto
třicetipětitisícový	ADJ	třicet.pět.tisícový
videomikrografie	NOUN	video.mikrografie
zelenočernočervený	ADJ	zelený.černočervený
zlatozelenohnědý	ADJ	zlatý.zelenohnědý
žlutooranžovorůžový	ADJ	žlutý.oranžovorůžový
adenomyóza	NOUN	-aden-.myóza
alogamie	NOUN	-al-.-gam-
algologie	NOUN	-alg-.-log-
anageneze	NOUN	-ana-.geneze
andragogika	NOUN	-andr-.-agog-
anglofil	NOUN	-angl-.-fil-
Angloameričan	NOUN	-angl-.Američan
antropozofie	NOUN	-anthrop-.-sof-
antropozoikum	NOUN	-anthrop-.-zo-
arcičaroděj	NOUN	-arci-.čaroděj
arcičíšník	NOUN	-arci-.číšník
arcipresbyter	NOUN	-arci-.presbyter
architektura	NOUN	-arch-.-tekt-
archetyp	NOUN	-arch-.typ
astrometrie	NOUN	-astr-.-metr-
astromedicína	NOUN	-astr-.medicína
audiostudio	NOUN	-audi-.studio
autoregresní	ADJ	-aut-.regrese
bifida	NOUN	-bi-.-fid-
bipolární	ADJ	-bi-.polární
biréma	NOUN	-bi-.réma
bioarcheologie	NOUN	-bio-.archeologie
bioberan	NOUN	-bio-.beran
biočistička	NOUN	-bio-.čistička
biodoplněk	NOUN	-bio-.doplněk
biodožínky	NOUN	-bio-.dožínky
bioeidam	NOUN	-bio-.eidam
biofarmacie	NOUN	-bio-.farmacie
bioforma	NOUN	-bio-.forma
biogranule	NOUN	-bio-.granule
biohrnec	NOUN	-bio-.hrnec
biochemie	NOUN	-bio-.chemie
biochlapeček	NOUN	-bio-.chlapeček
biokoenzym	NOUN	-bio-.koenzym
biokoridor	NOUN	-bio-.koridor
biokybernetika	NOUN	-bio-.kybernetika
biolékořice	NOUN	-bio-.lékořice
biomasa	NOUN	-bio-.masa
bionafta	NOUN	-bio-.nafta
bionávyk	NOUN	-bio-.návyk
bionosič	NOUN	-bio-.nosič
bioolympiáda	NOUN	-bio-.olympiáda
bioplínka	NOUN	-bio-.plínka
biopočítač	NOUN	-bio-.počítač
biopohanka	NOUN	-bio-.pohanka
biopříkrm	NOUN	-bio-.příkrm
bioptákovina	NOUN	-bio-.ptákovina
biosedlák	NOUN	-bio-.sedlák
biosexy	ADJ	-bio-.sexy
biostabilizační	ADJ	-bio-.stabilizační
biostandard	NOUN	-bio-.standard
biostanice	NOUN	-bio-.stanice
biotvaroh	NOUN	-bio-.tvaroh
biotým	NOUN	-bio-.tým
biovlna	NOUN	-bio-.vlna
biovložka	NOUN	-bio-.vložka
biovodík	NOUN	-bio-.vodík
biozelí	NOUN	-bio-.zelí
biozrní	NOUN	-bio-.zrní
blankoakceptant	NOUN	-blank-.akceptant
bradykinéza	NOUN	-brady-.-kinet-
bronchologie	NOUN	-bronch-.-log-
centrifuga	NOUN	-centr-.-fug-
cervikoobturatorní	ADJ	-cervik-.obturatorní
cirkumpolární	ADJ	-circum-.polární
cyklodelegace	NOUN	-cykl-.delegace
cyklochata	NOUN	-cykl-.chata
cyklooáza	NOUN	-cykl-.oáza
cykloopravář	NOUN	-cykl-.opravář
cyklooř	NOUN	-cykl-.oř
cyklooxygenáza	NOUN	-cykl-.oxygenáza
cyklopodjezd	NOUN	-cykl-.podjezd
cykloprotest	NOUN	-cykl-.protest
cyklopřilba	NOUN	-cykl-.přilba
cyklopřívěs	NOUN	-cykl-.přívěs
cyklorozcestník	NOUN	-cykl-.rozcestník
cyklosezóna	NOUN	-cykl-.sezóna
cykloshow	NOUN	-cykl-.šou
cykloskelet	NOUN	-cykl-.skelet
cyklostav	NOUN	-cykl-.stav
cyklotrialistický	ADJ	-cykl-.trialismus
cykloubytovna	NOUN	-cykl-.ubytovna
cykloúčastník	NOUN	-cykl-.účastník
cyklovak	NOUN	-cykl-.vak
cyklovětšina	NOUN	-cykl-.většina
cytopenie	NOUN	-cyt-.-pen-
cytokineze	NOUN	-cyt-.kineze
Deinotherium	NOUN	-dein-.-ther-
diacetyl	NOUN	-di-.acetyl
diaminotoluen	NOUN	-di-.amintoluen
dipól	NOUN	-di-.pól
diashow	NOUN	-dia-.show
ekopodnikatel	NOUN	-eko-.podnikatel
ekotoxikologie	NOUN	-eko-.toxikologie
ektogenní	ADJ	-ekt-.-gen-
ektotermie	NOUN	-ekt-.-term-
elektrofonický	ADJ	-elektr-.-fon-
elektrokapilární	ADJ	-elektr-.kapilární
elektrosmog	NOUN	-elektr-.smog
elektospotřebič	NOUN	-elektr-.spotřebič
elektrošrot	NOUN	-elektr-.šrot
enantiometrie	NOUN	-enanti-.-metr-
endobronchiální	ADJ	-end-.bronchiální
entoderm	NOUN	-ent-.-derm-
enteroskopie	NOUN	-enter-.-skop-
etnografie	NOUN	-ethn-.-graf-
eurokarta	NOUN	-eur-.karta
eurokraj	NOUN	-eur-.kraj
europrodukt	NOUN	-eur-.produkt
euroskepse	NOUN	-eur-.skepse
eurozásuvka	NOUN	-eur-.zásuvka
exkarvinský	ADJ	-ex-.karvinský
exmistr	NOUN	-ex-.mistr
exmonarcha	NOUN	-ex-.monarcha
exsevillský	ADJ	-ex-.sevillský
extřetiligový	ADJ	-ex-.třetiligový
exoparazit	NOUN	-ex-.parazit
felinoterapie	NOUN	-felin-.terapie
ferroslitina	NOUN	-ferr-.slitina
ferotapiolit	NOUN	-ferr-.tapiolit
filantropie	NOUN	-fil-.-anthrop-
florigen	NOUN	-flori-.-gen-
fonometrie	NOUN	-fon-.-metr-
fotodeska	NOUN	-fot-.deska
fotodynamický	ADJ	-fot-.dynamický
fotoefekt	NOUN	-fot-.efekt
fotokvíz	NOUN	-fot-.kvíz
fotonávod	NOUN	-fot-.návod
fotopapír	NOUN	-fot-.papír
fotopublikace	NOUN	-fot-.publikace
fotoreportáž	NOUN	-fot-.reportáž
fototyp	NOUN	-fot-.typ
gastronomie	NOUN	-gastr-.-nom-
gastroenteritida	NOUN	-gastr-.enteritida
gastrovaskulární	ADJ	-gastr-.vaskulární
geografie	NOUN	-gé-.-graf-
geoautochor	NOUN	-gé-.autochor
geochemie	NOUN	-gé-.chemie
geopotenciál	NOUN	-gé-.potenciál
geotechnika	NOUN	-gé-.technika
gestaltpsychologie	NOUN	-gestalt-.psychologie
gnoseologie	NOUN	-gnos-.-log-
gonokok	NOUN	-gon-.kok
gramofon	NOUN	-graf-.-fon-
grafogram	NOUN	-graf-.-gram-
hepatomegalie	NOUN	-hepat-.megalos
holoenzym	NOUN	-hol-.enzym
holokrystalický	ADJ	-hol-.krystalický
holotyp	NOUN	-hol-.typ
hydromagnetický	ADJ	-hydr-.magnetický
hydromorfní	ADJ	-hydr-.morfos
hygrograf	NOUN	-hygr-.-graf-
hygrometr	NOUN	-hygr-.metr
hyperkomplexní	ADJ	-hyper-.komplexní
hypertenze	NOUN	-hyper-.tenze
hypokortikalismus	NOUN	-hypo-.-kortik-
hypoestrinní	ADJ	-hypo-.estrinní
cholelithiáza	NOUN	-chol-.-lit-
chondroklast	NOUN	-chondr-.-klast-
chordofon	NOUN	-chord-.-fon-
idiotyp	NOUN	-idio-.typ
infrapaprsek	NOUN	-infra-.paprsek
interdentála	NOUN	-inter-.dentála
interfix	NOUN	-inter-.fix
interkondylický	ADJ	-inter-.kondyla
interoperabilní	ADJ	-inter-.operabilní
interprizmatický	ADJ	-inter-.prizmatický
intramuskulární	ADJ	-intra-.muskulární
izomorfie	NOUN	-iso-.morf
izotyp	NOUN	-iso-.typ
karpologie	NOUN	-karp-.-log-
Kryocentrum	NOUN	-kry-.centrum
kryosféra	NOUN	-kry-.sféra
kryptobolševik	NOUN	-krypt-.bolševik
kvadrofonie	NOUN	-kvadr-.-fon-
kvaziekologický	ADJ	-kvazi-.ekologický
kvazispolečenství	NOUN	-kvazi-.společenství
kvazizednářský	ADJ	-kvazi-.zednářský
laliofobie	NOUN	-chemo-.-fob-
laryngofaryngitida	NOUN	-laryng-.faryngitida
leukosafír	NOUN	-leuk-.safír
makrocyt	NOUN	-makr-.-cyt-
makroglobální	ADJ	-makr-.globální
makrolid	NOUN	-makr-.lid
makroobjektiv	NOUN	-makr-.objektiv
mammologie	NOUN	-mamm-.-log-
maxipes	NOUN	-max-.pes
meditéka	NOUN	-medi-.-téka-
megabit	NOUN	-mega-.bit
megajachta	NOUN	-mega-.jachta
megamarket	NOUN	-mega-.market
megatrh	NOUN	-mega-.trh
metalingva	NOUN	-meta-.lingva
metrologie	NOUN	-metro-.-log-
midibus	NOUN	-midi-.bus
mikrofon	NOUN	-mikr-.-fon-
milimetr	NOUN	-mili-.metr
miniauto	NOUN	-mini-.auto
minidebata	NOUN	-mini-.debata
miniflaštička	NOUN	-mini-.flaštička
minihnutí	NOUN	-mini-.hnutí
minihospůdka	NOUN	-mini-.hospůdka
minikancelář	NOUN	-mini-.kancelář
minikód	NOUN	-mini-.kód
minikonflikt	NOUN	-mini-.konflikt
minimistr	NOUN	-mini-.mistr
miniportrét	NOUN	-mini-.portrét
minisafari	NOUN	-mini-.safari
ministáteček	NOUN	-mini-.státeček
miniškola	NOUN	-mini-.škola
minitlumič	NOUN	-mini-.tlumič
minitraktor	NOUN	-mini-.traktor
minitriatlon	NOUN	-mini-.triatlon
minivrt	NOUN	-mini-.vrt
minivýstava	NOUN	-mini-.výstava
monoklinální	ADJ	-mon-.-klin-
monopol	NOUN	-mon-.-poli-
monodisplej	NOUN	-mon-.displej
monoklonální	ADJ	-mon-.klonální
monolyžař	NOUN	-mon-.lyžař
monokulár	NOUN	-mon-.okulár
monoprogramový	ADJ	-mon-.programový
monoterpen	NOUN	-mon-.terpen
motocykl	NOUN	-moto-.-cykl-
multifokální	ADJ	-multi-.fokální
multilaterální	ADJ	-multi-.laterální
multimilionář	NOUN	-multi-.milionář
multimixér	NOUN	-multi-.mixér
multividový	ADJ	-multi-.vidový
myocard	NOUN	-my-.-kardi-
myofibrila	NOUN	-my-.fibrila
nanovlákenný	ADJ	-nan-.vlákenný
neobaroko	NOUN	-neo-.baroko
neopozitivizmus	NOUN	-neo-.pozitivizmus
neoveristický	ADJ	-neo-.veristický
neuropřenašeč	NOUN	-neur-.přenašeč
nitrocementace	NOUN	-nitr-.cementace
nitrofen	NOUN	-nitr-.fen
nitrofurantoin	NOUN	-nitr-.furantoin
nitroglykol	NOUN	-nitr-.glykol
nitrotoluen	NOUN	-nitr-.toluen
ochlokracie	NOUN	-ochl-.-krat-
ortostatický	ADJ	-orth-.statický
osteopatie	NOUN	-oste-.-pat-
paleosom	NOUN	-palai-.-som-
palilogie	NOUN	-pali-.-log-
panotypie	NOUN	-pan-.-typ-
pansexualizmus	NOUN	-pan-.sexualizmus
pantomima	NOUN	-pant-.-mim-
pedochemický	ADJ	-ped-.chemický
perigeum	NOUN	-peri-.-gé-
peripetie	NOUN	-peri-.-pet-
perianální	ADJ	-peri-.anální
perisperm	NOUN	-peri-.-sperm-
perityflitida	NOUN	-peri-.tyflitida
petrografie	NOUN	-petr-.-graf-
petrogeneze	NOUN	-petr-.geneze
pidikoupelna	NOUN	-pidi-.koupelna
piktograf	NOUN	-pikt-.-graf-
pneumatolýza	NOUN	-pneu-.-ly-
polygynie	NOUN	-poly-.-gyn-
polyaromatický	ADJ	-poly-.aromatický
polycistronický	ADJ	-poly-.cistronický
polyester	NOUN	-poly-.ester
polygenetický	ADJ	-poly-.genetický
polykarbamát	NOUN	-poly-.karbamát
polyreakce	NOUN	-poly-.reakce
polysylogizmus	NOUN	-poly-.sylogizmus
polytetrafluorethylen	NOUN	-poly-.tetrafluorethylen
pomologie	NOUN	-pom-.-log-
postsaddámovský	ADJ	-post-.sadámovský
postváchalovský	ADJ	-post-.váchalovský
profifotbalista	NOUN	-profi-.fotbalista
profitenis	NOUN	-profi-.tenis
protohvězda	NOUN	-prot-.hvězda
protonotář	NOUN	-prot-.notář
psychotropní	ADJ	-psych-.-trep-
psychoanalitický	ADJ	-psych-.analytický
psychothriller	NOUN	-psych-.thriller
pyrovůz	NOUN	-pyr-.vůz
retroohlédnutí	NOUN	-retr-.ohlédnutí
scintigrafie	NOUN	-scinti-.-graf-
semiaktivní	ADJ	-semi-.aktivní
sémiologie	NOUN	-sém-.-log-
semitologie	NOUN	-semit-.-log-
silikotuberkulóza	NOUN	-silik-.tuberkulóza
sinovietnamský	ADJ	-sin-.vietnamský
sosiekologie	NOUN	-sosi-.ekologie
stereobrýle	NOUN	-stereo-.brýle
subvirový	ADJ	-sub-.virový
sympatomimetikum	NOUN	-sympath-.mimetikum
tachypnoe	NOUN	-tachy-.-pneu-
technodiktatura	NOUN	-techn-.diktatura
tektogramatický	ADJ	-tekt-.-gram-
telemetrie	NOUN	-tel-.-metr-
telepatie	NOUN	-tel-.-pat-
telekineze	NOUN	-tel-.kineze
telekonto	NOUN	-tel-.konto
telemagnát	NOUN	-tel-.magnát
televarieté	NOUN	-tel-.varieté
termostabilní	ADJ	-therm-.stabilní
termoventilátor	NOUN	-therm-.ventilátor
thiosiřičitan	NOUN	-thi-.siřičitan
transavantgarda	NOUN	-trans-.avantgarda
transdisciplinární	ADJ	-trans-.disciplinární
tremolit	NOUN	-trem-.-lit-
trikarboxylový	ADJ	-tri-.karboxylový
tribologie	NOUN	-trib-.-log-
trochanterion	NOUN	-troch-.-anter-
trombolýza	NOUN	-tromb-.-ly-
turbokartáč	NOUN	-turb-.kartáč
turbosféra	NOUN	-turb-.sféra
ultramontánský	ADJ	-ultra-.montánský
ultramoravista	NOUN	-ultra-.moravista
ultraodstředivka	NOUN	-ultra-.odstředivka
ultraparodie	NOUN	-ultra-.parodie
ultrapokrokový	ADJ	-ultra-.pokrokový
ultrapravý	ADJ	-ultra-.pravý
videozařízení	NOUN	-video-.zařízení
vitelogeneze	NOUN	-vitel-.geneze
adolescentofilie	NOUN	adolescent.-fil-
alergotoxický	ADJ	alergický.toxický
aminocukr	NOUN	amin.cukr
aortokoronární	ADJ	aorta.koronární
aromaterapie	NOUN	aroma.terapie
artdecový	ADJ	art.decový
artrock	NOUN	art.rock
audioprůvodce	NOUN	audio.průvodce
autoanténa	NOUN	auto.anténa
autodráha	NOUN	auto.dráha
autochemie	NOUN	auto.chemie
autachtivý	ADJ	auto.chtivý
autoolej	NOUN	auto.olej
autopojištění	NOUN	auto.pojištění
autopřehlídka	NOUN	auto.přehlídka
autorelativní	ADJ	auto.relativní
autoštěp	NOUN	auto.štěp
autotrenažér	NOUN	auto.trenažér
autožárovka	NOUN	auto.žárovka
balkanolog	NOUN	Balkán.-log-
barograf	NOUN	bar.-graf-
barometr	NOUN	bar.metr
bassreflex	NOUN	bas.reflex
bezpečnostněpolitický	ADJ	bezpečnostní.politický
béžovooranžový	ADJ	béžový.oranžový
béžovoterakotový	ADJ	béžový.terakotový
bílooranžovo	NOUN	bílý.oranžový
biovajíčko	NOUN	bio.vajíčko
bitstreamový	ADJ	bit.streamový
blahočet	NOUN	blaho.čítat
blahodějný	ADJ	blaho.dějný
hornoblatenský	ADJ	blatenský.blatenský
bojeschopný	ADJ	boj.schopný
brandýskoboleslavský	ADJ	brandýský.boleslavský
hornobránský	ADJ	bránský.bránský
branněvýchovný	ADJ	branný.výchovný
broadcasting	NOUN	broad.casting
bulvárumilovný	ADJ	bulvár.milovný
celněprávní	ADJ	celní.právní
celostat	NOUN	celý.-stat-
celoarabský	ADJ	celý.arabský
celodrážní	ADJ	celý.drážní
celoperuánský	ADJ	celý.peruánský
celoškolní	ADJ	celý.školní
celotáborový	ADJ	celý.táborový
celovečerní	ADJ	celý.večerní
Cestománie	NOUN	cesta.mánie
čajechtivý	ADJ	čaj.chtivý
čarověník	NOUN	čára.věník
černoděrový	ADJ	černý.děrový
černokabátník	NOUN	černý.kabátník
černokaspický	ADJ	černý.kaspický
černokněžnění	NOUN	černý.kněžnění
černoprachý	ADJ	černý.prach
černoprdelnice	NOUN	černý.prdel
černošedobílý	ADJ	černý.šedobílý
červenohrdlý	ADJ	červený.hrdlo
červenoknihovní	ADJ	červený.knihovní
červenokřivolaký	ADJ	červený.křivolaký
červenonohý	ADJ	červený.noha
červenopomerančový	ADJ	červený.pomerančový
červenošedý	ADJ	červený.šedý
červenovláska	NOUN	červený.vlas
Českotřebovsko	NOUN	český.třebovsko
českobavorský	ADJ	Česko.Bavorsko
čtrnáctibytový	ADJ	čtrnáct.byte
čtrnáctietapový	ADJ	čtrnáct.etapový
čtrnáctimiliónový	ADJ	čtrnáct.miliónový
čtvrtkilogramový	ADJ	čtvrt.kilogramový
čtvrtkilometrový	ADJ	čtvrt.kilometrový
čtyřbuněčný	ADJ	čtyři.buněčný
čtyřcentový	ADJ	čtyři.centový
čtyřčárkovaný	ADJ	čtyři.čárkovaný
čtyřdílný	ADJ	čtyři.dílný
čtyřdimenzionální	ADJ	čtyři.dimenzionální
čtyřhodinný	ADJ	čtyři.hodinný
čtyřhran	NOUN	čtyři.hrana
čtyřkánoe	NOUN	čtyři.kánoe
čtyřliberní	ADJ	čtyři.liberní
čtyřlom	NOUN	čtyři.lom
čtyřmotorový	ADJ	čtyři.motorový
čtvermonohý	ADJ	čtyři.noha
čtyřobrázkový	ADJ	čtyři.obrázkový
čtyřokresní	ADJ	čtyři.okresní
čtyřoktávový	ADJ	čtyři.oktávový
čtyřoperátorový	ADJ	čtyři.operátorový
čtyřiprocentní	ADJ	čtyři.procentní
čtyřprocentní	ADJ	čtyři.procentní
čtyřprostorový	ADJ	čtyři.prostorový
čtyřsvazek	NOUN	čtyři.svazek
čtyřsystémový	ADJ	čtyři.systémový
čtyřiatřicítka	NOUN	čtyři.třicítka
čtyřistahlavý	ADJ	čtyři.sto.hlava
čtyřiadvacetistránkový	ADJ	čtyřiadvacet.stránkový
čtyřicetihlavý	ADJ	čtyřicet.hlava
čtyřicítihodinový	ADJ	čtyřicet.hodinový
čtyřicetisekundový	ADJ	čtyřicet.sekundový
datasystém	NOUN	data.systém
dědickoprávní	ADJ	dědic.právní
desetigólový	ADJ	deset.gólový
desetihaléř	NOUN	deset.haléř
desetilůžkový	ADJ	deset.lůžkový
desetinásobek	NOUN	deset.násobek
desetipísňový	ADJ	deset.písňový
desetipokojový	ADJ	deset.pokojový
desetiskok	NOUN	deset.skok
desetitunový	ADJ	deset.tunový
desetiúrovňový	ADJ	deset.úrovňový
desetivozový	ADJ	deset.vozový
devadesátikoruna	NOUN	devadesát.koruna
devadesátivozový	ADJ	devadesát.vozový
devítiargumentový	ADJ	devět.argumentový
devítikusový	ADJ	devět.kusový
devítilopatový	ADJ	devět.lopatový
devítistěžňový	ADJ	devět.stěžňový
devítistranný	ADJ	devět.strana
devítitisícový	ADJ	devět.tisícový
diskokostým	NOUN	disko.kostým
diskokrál	NOUN	disko.král
diskometalový	ADJ	disko.metalový
diskoodpoledne	NOUN	disko.odpoledne
diskoretro	NOUN	disko.retro
diskorytmus	NOUN	disko.rytmus
dithiouhličitan	NOUN	dithium.uhličitan
dlouhohořící	ADJ	dlouho.hořet
dolnolutyňský	ADJ	dolní.lutyňský
dolnoněmecký	ADJ	dolní.německý
dolnopanonský	ADJ	dolní.panonský
draselnoživcový	ADJ	draslík.živcový
drobnohled	NOUN	drobný.hledět
drobnokresba	NOUN	drobný.kresba
drogchtivý	ADJ	droga.chtít
drsnokřídlec	NOUN	drsný.křídlo
druhoplánový	ADJ	druhý.plánový
druhoválečný	ADJ	druhý.válečný
dřevomorka	NOUN	dřevo.mořit
dřevomozaika	NOUN	dřevo.mozaika
dřevosochař	NOUN	dřevo.sochař
Dřevostavba	NOUN	dřevo.stavba
dřevovýrobek	NOUN	dřevo.výrobek
dřevozávod	NOUN	dřevo.závod
důlnětechnický	ADJ	důl.technický
dvaapadesátka	NOUN	dva.padesátka
dvaceticédéčkový	ADJ	dvacet.cédéčkový
dvacetidenní	ADJ	dvacet.denní
dvacetikanálový	ADJ	dvacet.kanálový
dvacetikarátový	ADJ	dvacet.karátový
dvacetimilimetrový	ADJ	dvacet.milimetrový
dvacetiotázkový	ADJ	dvacet.otázkový
dvacetipokojový	ADJ	dvacet.pokojový
dvacetistranový	ADJ	dvacet.stranový
dvacetitisícový	ADJ	dvacet.tisícový
dvacetivárkový	ADJ	dvacet.várkový
dvanáctidiskový	ADJ	dvanáct.diskový
dvanáctilitrový	ADJ	dvanáct.litrový
dvanáctipólový	ADJ	dvanáct.pólový
dvanáctislabikový	ADJ	dvanáct.slabikový
dvanáctistupňový	ADJ	dvanáct.stupňový
dvanáctivoltový	ADJ	dvanáct.voltový
dvojaut	NOUN	dvě.aut
dvojbabka	NOUN	dvě.babka
dvoubuněčný	ADJ	dvě.buněčný
dvojcestný	ADJ	dvě.cesta
dvoučipový	ADJ	dvě.čipový
dvaačtyřicátník	NOUN	dvě.čtyřicátník
dvojdepo	NOUN	dvě.depo
dvojdeska	NOUN	dvě.deska
dvouděrový	ADJ	dvě.děrový
dvojdomý	ADJ	dvě.dům
dvoufalcový	ADJ	dvě.falcový
dvoufinancování	NOUN	dvě.financování
dvojgenerační	ADJ	dvě.generační
dvojhora	NOUN	dvě.hora
dvojhrana	NOUN	dvě.hrana
dvojkanálový	ADJ	dvě.kanálový
dvojkavárna	NOUN	dvě.kavárna
dvojkolejnice	NOUN	dvě.kolejnice
dvoukoncový	ADJ	dvě.koncový
dvojkruží	NOUN	dvě.kruh
dvoukurtový	ADJ	dvě.kurt
dvoulaločný	ADJ	dvě.laločný
dvoumódový	ADJ	dvě.módový
dvounásobný	ADJ	dvě.násobný
dvojobvod	NOUN	dvě.obvod
dvouoscarový	ADJ	dvě.oscarový
dvojpíseň	NOUN	dvě.píseň
dvojpísmenový	ADJ	dvě.písmenový
dvouplovákový	ADJ	dvě.plovákový
dvojpodlažní	ADJ	dvě.podlažní
dvojportí	NOUN	dvě.port
dvojportrét	NOUN	dvě.portrét
dvouprocentní	ADJ	dvě.procentní
dvourámkový	ADJ	dvě.rámek
dvourozsahový	ADJ	dvě.rozsahový
dvousoškový	ADJ	dvě.slokový
dvouslokový	ADJ	dvě.slokový
dvojsloví	NOUN	dvě.slovo
dvoustátí	NOUN	dvě.stát
dvojstěžňový	ADJ	dvě.stěžňový
dvousvátkový	ADJ	dvě.svátkový
dvojsystém	NOUN	dvě.systém
dvojšach	NOUN	dvě.šach
dvojšvih	NOUN	dvě.švih
dvoutahový	ADJ	dvě.tahový
dvoutarifní	ADJ	dvě.tarifní
dvojtitul	NOUN	dvě.titul
dvojtrnný	ADJ	dvě.trn
dvoutřetinový	ADJ	dvě.třetinový
dvojtvářný	ADJ	dvě.tvářný
dvojúspěch	NOUN	dvě.úspěch
dvojvěří	NOUN	dvě.víra
dvojvousý	ADJ	dvě.vous
dvojvrstva	NOUN	dvě.vrstva
dvojvýjimečný	ADJ	dvě.výjimečný
dvojvýměna	NOUN	dvě.výměna
dvouapůlletka	NOUN	dvě.půl.léto
ekonomickotechnický	ADJ	ekonomický.technický
embryopatie	NOUN	embryo.-pat-
energovod	NOUN	energie.vést
fenylpropanový	ADJ	fenyl.propan
ferdomravencovský	ADJ	Ferda.mravenec
fialovomodrý	ADJ	fialový.modrý
formálněprocesní	ADJ	formální.procesní
fotekchtivý	ADJ	fotka.chtivý
gabroamfibolit	NOUN	gabr.amfibolit
garážmistr	NOUN	garáž.mistr
gumolatex	NOUN	guma.latex
havlovláda	NOUN	Havel.vláda
heparinocyt	NOUN	heparin.-cyt-
hlinitojílovitý	ADJ	hlinitý.jílovitý
hlubokozmražený	ADJ	hluboký.zmražený
hnědopásník	NOUN	hnědý.-pás-
hnědoolivový	ADJ	hnědý.olivový
hnědorudý	ADJ	hnědý.rudý
vícefotonový	ADJ	hodně.fotonový
víceklínový	ADJ	hodně.klínový
vícekolejnicový	ADJ	hodně.kolejnicový
víceohniskový	ADJ	hodně.ohniskový
vícepokojový	ADJ	hodně.pokojový
víceprocesní	ADJ	hodně.procesní
víceproudý	ADJ	hodně.proud
víceramenný	ADJ	hodně.rameno
vícesektorový	ADJ	hodně.sektorový
víceventilový	ADJ	hodně.ventilový
holekchtivý	ADJ	holka.chtivý
holokrčka	NOUN	holý.krk
horkokrevný	ADJ	horký.krev
Hornorakušan	NOUN	horní.Rakousko
hořečnatoželeznatý	ADJ	hořčík.železo
Hostimil	NOUN	host.milý
hrubokožec	NOUN	hrubý.kůže
hříchuprostý	ADJ	hřích.prostý
hurávlastenec	NOUN	hurá.vlastenec
hypervlna	NOUN	hyper.vlna
chemosyntéza	NOUN	-chem-.syntéza
chloranilin	NOUN	chlor.anilin
chlorpikrin	NOUN	chlor.pikrin
chlorpyridin	NOUN	chlor.pyridin
ideodiverzní	ADJ	idea.diverzní
inkasoindosament	NOUN	inkaso.indosament
javorolistý	ADJ	javorový.list
jednodolarový	ADJ	jeden.dolarový
jednoduchý	ADJ	jeden.duch
jednohlavňový	ADJ	jeden.hlavňový
jednojaderný	ADJ	jeden.jaderný
jednokobkový	ADJ	jeden.kobkový
jednoletý	ADJ	jeden.léto
jednooborový	ADJ	jeden.oborový
jednopruhový	ADJ	jeden.pruhový
jednoprvkový	ADJ	jeden.prvkový
jednotlačítkový	ADJ	jeden.tlačítkový
jednovečerní	ADJ	jeden.večerní
jednoznakový	ADJ	jeden.znakový
jedenáctidenní	ADJ	jedenáct.denní
jedenáctikomorový	ADJ	jedenáct.komorový
jedenáctislotový	ADJ	jedenáct.slotový
jedenapadesátiletý	ADJ	jedenapadesát.léto
jelenohorský	ADJ	jelení.horský
jemnohmotný	ADJ	jemný.hmotný
jihovětnamský	ADJ	jih.vietnamský
jinonárodní	ADJ	jiný.národní
jódškrobový	ADJ	jód.škrobový
kamenotisk	NOUN	kámen.tisk
kamenoželezný	ADJ	kámen.železný
karbonylskupina	NOUN	karbonyl.skupina
kávychtivý	ADJ	káva.chtivý
knihověda	NOUN	kniha.věda
knihvedoucí	NOUN	kniha.vedoucí
kolkuprostý	ADJ	kolek.prostý
kolemstojící	ADJ	kolem.stát
komediograf	NOUN	komedie.-graf-
konkávkonvexní	ADJ	konkávní.konvexní
kontratanec	NOUN	kontra.tanec
kosoběžný	ADJ	kosý.běh
koupánímilovný	ADJ	koupání.milovný
kovohydridový	ADJ	kov.hydridový
kovomodelář	NOUN	kov.modelář
kovotepec	NOUN	kov.tepat
krátkodenní	ADJ	krátký.denní
krátkodobý	ADJ	krátký.doba
krátkorohý	ADJ	krátký.roh
krátkostéblý	ADJ	krátký.stéblo
kremlologie	NOUN	Kreml.-log-
krveprolévání	NOUN	krev.prolévání
krvotok	NOUN	krev.téci
krtonožka	NOUN	krt.noha
křehkolomový	ADJ	křehký.lomový
křesťanskonárodní	ADJ	křesťanský.národní
křesťanskosociální	ADJ	křesťanský.sociální
kulturnětechnický	ADJ	kulturně.technický
ledochod	NOUN	led.chod
ledolom	NOUN	led.lom
lehkoolejářský	ADJ	lehký.olejářský
leitmotiv	NOUN	leit.motiv
libovonný	ADJ	libý.vonný
lichopřeslen	NOUN	lichý.přeslen
literárněteoretický	ADJ	literární.teoretický
lymfogranulóm	NOUN	lymfa.granulom
lyžováníchtivý	ADJ	lyžování.chtivý
maďarskorakouský	ADJ	maďarský.rakouský
maloletý	ADJ	málo.léto
malobankovní	ADJ	malý.bankovní
malolánský	ADJ	malý.lán
malolistý	ADJ	malý.list
malopěstitel	NOUN	malý.pěstitel
mandžuskotunguzský	ADJ	mandžuský.tunguzský
membránofon	NOUN	membrána.-fon-
metalhalidový	ADJ	metal.halidový
methylfentanyl	NOUN	methyl.fentanyl
metylbenzilát	NOUN	metyl.benzilát
meziblokový	ADJ	mezi.blokový
mezicelní	ADJ	mezi.celní
mezijazyk	NOUN	mezi.jazyk
mezikód	NOUN	mezi.kód
mezilidský	ADJ	mezi.lidský
meziobor	NOUN	mezi.obor
mezioperační	ADJ	mezi.operační
mezipásmo	NOUN	mezi.pásmo
mezipevninový	ADJ	mezi.pevninový
mezipolí	NOUN	mezi.pole
mezirezortní	ADJ	mezi.rezortní
meziskelní	ADJ	mezi.skelní
mezisoučet	NOUN	mezi.součet
mezitón	NOUN	mezi.tón
meziústřednový	ADJ	mezi.ústřednový
meziúvěr	NOUN	mezi.úvěr
mezivolební	ADJ	mezi.volební
mezivýdech	NOUN	mezi.výdech
mezizahrada	NOUN	mezi.zahrada
milionářskovojenský	ADJ	milionářský.vojenský
mimobursovní	ADJ	mimo.burzovní
mimocévní	ADJ	mimo.cévní
mimohotelový	ADJ	mimo.hotelový
mimomalířský	ADJ	mimo.malířský
mimoodpovědnostní	ADJ	mimo.odpovědnostní
mimoplanetární	ADJ	mimo.planetární
mimopotravinářský	ADJ	mimo.potravinářský
mimoprovozní	ADJ	mimo.provozní
mimosterlingový	ADJ	mimo.sterlingový
mimotelevizní	ADJ	mimo.televizní
mimovolný	ADJ	mimo.volní
minohledačka	NOUN	mina.hledačka
místokrálovský	ADJ	místo.královský
místopředseda	NOUN	místo.předseda
místoregent	NOUN	místo.regent
mladobucký	ADJ	mladý.buk
mladohegelovec	NOUN	mladý.hegelovec
mladolotych	NOUN	mladý.lotych
mladotřetihorní	ADJ	mladý.třetihory
mladoturek	NOUN	mladý.Turek
mnohabodový	ADJ	mnoho.bodový
mnohohlavý	ADJ	mnoho.hlava
mnohonáboženský	ADJ	mnoho.náboženský
mnohonárodní	ADJ	mnoho.národní
mnohastranový	ADJ	mnoho.stranový
mnohosvazkový	ADJ	mnoho.svazkový
mnohotvářný	ADJ	mnoho.tvářný
mnohoúrovňový	ADJ	mnoho.úrovňový
modrobílooranžový	ADJ	modrý.bílooranžový
modrosemenný	ADJ	modrý.semenný
monarchofašistický	ADJ	monarcha.fašistický
hornomoravský	ADJ	moravský.moravský
moravskoostravský	ADJ	moravský.ostravský
morfoném	NOUN	morf.foném
mýtotvorný	ADJ	mýtus.tvořit
nahoře	ADV	na.hora
náboženskofilozofický	ADJ	náboženský.filozofický
nadhřebenový	ADJ	nad.hřebenový
nadkmenový	ADJ	nad.kmenový
nadměstský	ADJ	nad.městský
nadnulový	ADJ	nad.nula
několikačlenný	ADJ	několik.člen
několikamiliónový	ADJ	několik.miliónový
několikasouborový	ADJ	několik.souborový
několikatisíciletý	ADJ	tisíc.léto
nicnevyzařující	ADJ	nic.vyzařovat
nigerokordofánský	ADJ	Niger.kordofánský
nízkoenergetický	ADJ	nízký.energetický
nízkokvalitní	ADJ	nízký.kvalitní
nízkopásmový	ADJ	nízký.pásmový
novoázerbájdžánština	NOUN	nový.ázerbájdžánština
novobydžovský	ADJ	nový.bydžovský
novočeský	ADJ	nový.český
novohebridský	ADJ	nový.hebridský
novopečený	ADJ	nový.péci
novoplatónský	ADJ	nový.platónský
novopythagoreizmus	NOUN	nový.pythagoreizmus
novostavba	NOUN	nový.stavba
novostrašecký	ADJ	nový.Strašecí
obojživelný	ADJ	obě.živel
okolostojící	ADJ	okolo.stát
opozičněkoaliční	ADJ	opoziční.koaliční
oranžovočelý	ADJ	oranžový.čelo
organologie	NOUN	orgán.-log-
orgánotvorný	ADJ	orgán.tvořit
osmibytový	ADJ	osm.bytový
osmadvacátiny	NOUN	osm.dvacátiny
osmifinalista	NOUN	osm.finalista
osmihodinovka	NOUN	osm.hodinovka
osmichodový	ADJ	osm.chodoý
osmikoncertní	ADJ	osm.koncertní
osmilahvový	ADJ	osm.lahvový
osmaosmdesátník	NOUN	osm.osmdesátník
osmipístkový	ADJ	osm.pístkový
osmipramenný	ADJ	osm.pramenný
osmiramenný	ADJ	osm.rameno
osmadvacetimiliónový	ADJ	osmadvacet.miliónový
osmadvacetiposchoďový	ADJ	osmadvacet.poschoďový
osmnáctimetrový	ADJ	osmnáct.metrový
padesáticentový	ADJ	padesát.centový
padesáticiferný	ADJ	padesát.ciferný
padesátieuro	NOUN	padesát.Euro
padesátimegový	ADJ	padesát.mega
padesátitisícový	ADJ	padesát.tisícový
padesátiwattový	ADJ	padesát.wattový
pantatík	NOUN	pan.tatík
panímáma	NOUN	paní.máma
paropropustný	ADJ	pára.propustný
patnáctiwattový	ADJ	patnáct.wattový
penězchtivý	ADJ	peníz.chtivý
peřenosečný	ADJ	peřený.sekat
pětimanuálový	ADJ	pet.manuálový
pětiarový	ADJ	pět.arový
pětiargumentový	ADJ	pět.argumentový
pěticoulový	ADJ	pět.coulový
pětičtvrťový	ADJ	pět.čtvrťový
pětigramový	ADJ	pět.gramový
pětilůžkový	ADJ	pět.lůžkový
pětiodstavcový	ADJ	pět.odstavcový
pětioscarový	ADJ	pět.oscarový
pětioskarový	ADJ	pět.oscarový
pětipaprskový	ADJ	pět.paprskový
pětipísňový	ADJ	pět.písňový
pětiplatový	ADJ	pět.platový
pětiprstový	ADJ	pět.prstový
pětisegmentový	ADJ	pět.segmentový
pětisériový	ADJ	pět.sériový
pětišestinový	ADJ	pět.šestinový
pětatřicátník	NOUN	pět.třicátník
pětisetkolový	ADJ	pět+sto.kolový
pětadvacetidenní	ADJ	pětadvacet.denní
pětašedesátiprocentní	ADJ	pětašedesát.procentní
písmolijna	NOUN	písmo.lít
plavošedivý	ADJ	plavý.šedivý
plazmagen	NOUN	plazma.-gen-
plnostěnný	ADJ	plný.stěna
plodonoš	NOUN	plod.nést
ploskozubec	NOUN	ploský.zub
ploutvonožec	NOUN	ploutev.noha
pokladotvorný	ADJ	poklad.tvořit
polarimetr	NOUN	polarizace.metros
pornokino	NOUN	porno.kino
postnormalizační	ADJ	post.normalizační
postpozice	NOUN	post.pozice
potravychtivý	ADJ	potrava.chtivý
právotvorný	ADJ	právo.tvořit
pravobok	NOUN	pravý.bok
pravolevý	ADJ	pravý.levý
praxeologie	NOUN	praxe.-log-
progorbačovský	ADJ	pro.gorbačovský
prohitlerovský	ADJ	pro.hitlerovský
projelcinovský	ADJ	pro.jelcinovský
proklepáčovský	ADJ	pro.klepáčovský
promečiarovský	ADJ	pro.mečiarovský
promírový	ADJ	pro.mírový
prosrbský	ADJ	pro.srbský
provojenský	ADJ	pro.vojenský
protialergický	ADJ	proti.alergický
protiaristidovský	ADJ	proti.aristidovský
protiautomatový	ADJ	proti.automatový
protibolševický	ADJ	proti.bolševický
protibruselský	ADJ	proti.Bruselský
protibursíkovský	ADJ	proti.bursíkovský
protielitářský	ADJ	proti.elitářský
protierozní	ADJ	proti.erozní
protiexplosivní	ADJ	proti.explosivní
protihalasovský	ADJ	proti.halasovský
protihrudkující	ADJ	proti.hrudkovat
protichruščovovský	ADJ	proti.chruščovovský
protiimperialistický	ADJ	proti.imperialistický
protijezuitský	ADJ	proti.jezuitský
protikacířský	ADJ	proti.kacířský
protikapsářský	ADJ	proti.kapsářský
protiklenba	NOUN	proti.klenba
protikongresový	ADJ	proti.kongresový
protikonzumní	ADJ	proti.konzumní
protikouřový	ADJ	proti.kouřový
protikremelský	ADJ	proti.kremelský
protilátka	NOUN	proti.látka
protilegionářský	ADJ	proti.legionářský
protimandelinkový	ADJ	proti.mandelinkový
protinacistický	ADJ	proti.nacistický
protinomenklaturní	ADJ	proti.nomenklatura
protiodrazový	ADJ	proti.odrazový
protiposudek	NOUN	proti.posudek
protiprůvanový	ADJ	proti.průvanový
protireformace	NOUN	proti.reformace
protiřímský	ADJ	proti.římský
protisíla	NOUN	proti.síla
protismykový	ADJ	proti.smykový
protistanice	NOUN	proti.stanice
protitalibanský	ADJ	proti.talibanský
protitoxický	ADJ	proti.toxický
protivzteklinový	ADJ	proti.vzteklinový
protiwalderovský	ADJ	proti.walderovský
protiwalderodovský	ADJ	proti.walderodovský
protizávaží	NOUN	proti.závaží
protizemanovský	ADJ	proti.zemanovský
protizvuk	NOUN	proti.zvuk
prvočinitel	NOUN	prvý.činitel
přímotažný	ADJ	přímo.tažný
poloadministrativní	ADJ	půl.administrativní
poloarénový	ADJ	půl.arénový
poločeský	ADJ	půl.český
polodivočák	NOUN	půl.divočák
půlhektolitrový	ADJ	půl.hektolitrový
polohustý	ADJ	půl.hustý
polokomunistický	ADJ	půl.komunizmus
polokurzíva	NOUN	půl.kurzíva
polomafiánský	ADJ	půl.mafiánský
polonahota	NOUN	půl.nahota
polorozevřený	ADJ	půl.rozevřený
polorytmika	NOUN	půl.rytmika
polosirota	NOUN	půl.sirota
polototalitní	ADJ	půl.totalitní
polotyp	NOUN	půl.typ
polouzavřít	VERB	půl.uzavřít
polovoják	NOUN	půl.voják
radiooperatér	NOUN	rádio.operatér
radiosonda	NOUN	rádio.sonda
radiospoj	NOUN	rádio.spoj
rádobyspiklenecký	ADJ	rádoby.spiklenecký
raněstředověký	ADJ	raný.středověký
rautuchtivý	ADJ	raut.chtivý
reálněsocialistický	ADJ	reálný.sicialistický
rovnoúhelník	NOUN	rovný.úhel
rudotvorný	ADJ	rud.tvořit
rudodřevitý	ADJ	rudý.dřevitý
rychločlun	NOUN	rychlý.člun
rychlokurs	NOUN	rychlý.kurs
rychlolezení	NOUN	rychlý.lezení
rychloobčerstvení	NOUN	rychlý.občerstvení
rychlopoma	NOUN	rychlý.poma
rychloportrét	NOUN	rychlý.portrét
rychlopřesun	NOUN	rychlý.přesun
rychlosoustružník	NOUN	rychlý.soustružník
rychlotest	NOUN	rychlý.test
řeckoturecký	ADJ	řecký.turecký
říšskoněmecký	ADJ	říšský.německý
samodokumentovat	VERB	sám.dokumentovat
samohojit	VERB	sám.hojit
samochvála	NOUN	sám.chvála
samoklopný	ADJ	sám.klopit
samomluva	NOUN	sám.mluva
samorozšiřovat	VERB	sám.rozšiřovat
samostříl	NOUN	sám.střílet
samozesilovat	VERB	sám.zesilovat
samozhutnitelný	ADJ	sám.zhutnitelný
sebeaktivnější	ADJ	sebe.aktivní
sebeaktualizovat	VERB	sebe.aktualizovat
sebeanalýza	NOUN	sebe.analýza
sebeblýskavější	ADJ	sebe.blýskavý
sebecitlivější	ADJ	sebe.citlivý
sebečastější	ADJ	sebe.častý
sebedémoničtěji	ADV	sebe.démonický
sebediskreditace	NOUN	sebe.diskreditace
sebenedostupněji	ADV	sebe.dostupný
sebedramatičtěji	ADV	sebe.dramaticky
sebedůležitější	ADJ	sebe.důležitý
sebedůslednější	ADJ	sebe.důsledný
sebeexekuce	NOUN	sebe.exekuce
sebegeniálněji	ADV	sebe.geniální
sebeglorifikace	NOUN	sebe.glorifikace
sebeideálnější	ADJ	sebe.ideální
sebekonfliktnější	ADJ	sebe.konfliktní
sebelaskavější	ADJ	sebe.laskavý
sebelítostný	ADJ	sebe.lítostný
sebemalicherněji	ADV	sebe.malicherný
sebemódnější	ADJ	sebe.módní
sebenápaditější	ADJ	sebe.nápaditý
sebenapínavější	ADJ	sebe.napínavý
sebenaplnění	NOUN	sebe.naplněný
sebenormalizace	NOUN	sebe.normalizace
sebeobhájce	NOUN	sebe.obhájce
sebeobjímavý	ADJ	sebe.objímavý
sebeobrana	NOUN	sebe.obrana
sebeobsloužit	VERB	sebe.obsloužit
sebeocenění	NOUN	sebe.ocenění
sebeočišťovat	VERB	sebe.očišťovat
sebeohlupovat	VERB	sebe.ohlupovat
sebeohrožení	NOUN	sebe.ohrožení
sebeomezenější	ADJ	sebe.omezený
sebeošálení	NOUN	sebe.ošálení
sebeplošnější	ADJ	sebe.plošný
sebepoctivěji	ADV	sebe.poctivý
sebenepodstatnější	ADJ	sebe.podstatný
sebepodvádět	VERB	sebe.podvádět
sebeponičenější	ADJ	sebe.poničený
sebepošetilejší	ADJ	sebe.pošetilý
sebepoškodit	VERB	sebe.poškodit
sebezpoznání	NOUN	sebe.poznání
sebeprestižnější	ADJ	sebe.prestižní
sebeproducírování	NOUN	sebe.producírování
sebeprokazatelný	ADJ	sebe.prokazatelný
sebeproměna	NOUN	sebe.proměna
sebepřesahovat	VERB	sebe.přesahovat
sebepřesvědčivější	ADJ	sebe.přesvědčivý
sebepřísnější	ADJ	sebe.přísný
sebenepřístupný	ADJ	sebe.přístupný
sebereflektivní	ADJ	sebe.reflektivní
seberespekt	NOUN	sebe.respekt
seberozkládat	VERB	sebe.rozkládat
seberozkolísaněji	ADV	sebe.rozkolísaný
seberozmělňovat	VERB	sebe.rozmělňovat
seberozptýlenější	ADJ	sebe.rozptýlený
sebesakrálnější	ADJ	sebe.sakrální
sebesešlejší	ADJ	sebe.sešlý
sebeskvělejší	ADJ	sebe.skvělý
sebenesmyslnější	ADJ	sebe.smyslný
sebesnazší	ADJ	sebe.snadný
sebesoustředěnější	ADJ	sebe.soustředěný
sebestřízlivější	ADJ	sebe.střízlivý
sebesubtilnější	ADJ	sebe.subtilní
sebeneškodnější	ADJ	sebe.škodný
sebetlustší	ADJ	sebe.tlustý
sebetradičnější	ADJ	sebe.tradiční
sebetrapnější	ADJ	sebe.trapný
sebetvrdší	ADJ	sebe.tvrdý
sebeudavač	NOUN	sebe.udavač
sebeupřímnější	ADJ	sebe.upřímný
sebeuvedení	NOUN	sebe.uvedení
sebevřelejší	ADJ	sebe.vřelý
sebevydařenější	ADJ	sebe.vydařený
sebevyváženěji	ADV	sebe.vyvážený
sebevznešeněji	ADV	sebe.vznešený
sebezávažněji	ADV	sebe.závažný
sebenezáživnější	ADJ	sebe.záživný
sebezbožňovat	VERB	sebe.zbožňovat
sebezelenější	ADJ	sebe.zelený
sebezesměšňovat	VERB	sebe.zesměšňovat
sebezkaženěji	ADV	sebe.zkažený
sebeztrapnění	NOUN	sebe.ztrapnění
sebezvládnutí	NOUN	sebe.zvládnutí
sebežrání	NOUN	sebe.žraní
sedmičlenný	ADJ	sedm.člen
sedmikorunový	ADJ	sedm.korunový
sedmilůžkový	ADJ	sedm.lůžkový
sedmasedmdesátka	NOUN	sedm.sedmdesátka
sedmivrstvý	ADJ	sedm.vrstvý
sedmapůlprocentní	ADJ	sedm.půl.procentní
sedmdesátiletý	ADJ	sedmdesát.léto
sedmdesátimilimetrový	ADJ	sedmdesát.milimetrový
sedmnáctičlenný	ADJ	sedmnáct.člen
sedmnáctigólový	ADJ	sedmnáct.gólový
sedmnáctihlavý	ADJ	sedmnáct.hlava
sedmnáctilitrový	ADJ	sedmnáct.litrový
servohlava	NOUN	servo.hlava
severoíránský	ADJ	sever.iránský
severokambodžský	ADJ	sever.kambodžský
severosomálský	ADJ	sever.somálský
severošvýcarský	ADJ	sever.švýcarský
severotádžický	ADJ	sever.tádžický
severozápad	NOUN	sever.západ
sexyhrátky	NOUN	sexy.hrátky
sexyklip	NOUN	sexy.klip
skorodospělý	ADJ	skoro.dospělý
skorokandidát	NOUN	skoro.kandidát
slaboproud	NOUN	slabý.proud
sladkolistý	ADJ	sladký.list
sladkoplodý	ADJ	sladký.plod
slovnědruhový	ADJ	slovní.druhový
smluvněprávní	ADJ	smluvní.právní
sociálněvýchovný	ADJ	sociálně.výchovný
spasmolytický	ADJ	spasmos.lyó
společenskohistorický	ADJ	společnost.historický
společenskotřídní	ADJ	společnost.třída
spolubydlící	ADJ	spolu.bydlící
spolufarník	NOUN	spolu.farník
spoluinvestice	NOUN	spolu.investice
spolukontrolovat	VERB	spolu.kontrolovat
spolumluvčí	NOUN	spolu.mluvčí
spolumukl	NOUN	spolu.mukl
spolupartajník	NOUN	spolu.partajník
spolupoutník	NOUN	spolu.poutník
spolupředsedat	VERB	spolu.předsedat
spoluředitel	NOUN	spolu.ředitel
spolusignatář	NOUN	spolu.signatář
spoluúčastnit	VERB	spolu.účastnit
spoluužívat	VERB	spolu.užívat
spolužadatel	NOUN	spolu.žadatel
sportregion	NOUN	sport.region
sprintrallye	NOUN	sprint.rallye
srbochorvátský	ADJ	srbský.chorvátský
staroasyrský	ADJ	starý.asyrský
staroegyptský	ADJ	starý.egyptský
starokomický	ADJ	starý.komický
staroměstký	ADJ	starý.městský
staromódní	ADJ	starý.módní
staromoravský	ADJ	starý.moravský
stavbychtivý	ADJ	stavba.chtivý
Stavoúdržba	NOUN	stavba.údržba
stejnonožec	NOUN	stejný.noha
stejnopis	NOUN	stejný.psát
stejnoslabičný	ADJ	stejný.slabičný
stihomam	NOUN	stíhat.mámit
stokoňový	ADJ	sto.kůň
stomililitrový	ADJ	sto.mililitrový
stoprocentní	ADJ	sto.procentní
stotunový	ADJ	sto.tunový
stolnětenisový	ADJ	stolní.tenisový
stoptlačítko	NOUN	stop.tlačítko
středohoří	NOUN	střed.hora
středooceánický	ADJ	střed.oceánický
středozairský	ADJ	střed.zairský
stříbrnobílý	ADJ	stříbrný.bílý
stříbronosný	ADJ	stříbro.nést
stříbrorudný	ADJ	stříbro.rudný
stříbroústý	ADJ	stříbro.ústý
studiachtivý	ADJ	studium.chtivý
styluchtivý	ADJ	styl.chtivý
suchokvět	NOUN	suchý.květ
superoyal	NOUN	super.royal
svatokrádež	NOUN	svatý.krádež
svatomartinský	ADJ	svatý.martinský
svatostánek	NOUN	svatý.stánek
svatováclavský	ADJ	Svatý.václavský
světoběžný	ADJ	svět.běhat
světaborný	ADJ	svět.borný
světovládce	NOUN	svět.vládce
světlobojný	ADJ	světlo.bát
svezeníchtivý	ADJ	svezení.chtivý
svrchuřečený	ADJ	svrchu.říct
svémoc	NOUN	svůj.moc
symfonickodramatický	ADJ	symfonický.dramatický
šedesátiletý	ADJ	šedesát.léto
šedesátistránkový	ADJ	šedesát.stránkový
šéfkreslič	NOUN	šéf.kreslič
šéflektor	NOUN	šéf.lektor
šéfodborář	NOUN	šéf.odborář
šéfporadce	NOUN	šéf.poradce
šéfředitel	NOUN	šéf.ředitel
šesticentimetrový	ADJ	šest.centimetrový
šestilistý	ADJ	šest.list
šestilistový	ADJ	šest.listový
šestiminutový	ADJ	šest.minutový
šestimístný	ADJ	šest.místný
šestiportový	ADJ	šest.portový
šestiposádkový	ADJ	šest.posádkový
šestiprostorový	ADJ	šest.prostorový
šestiprvkový	ADJ	šest.prvkový
šestirychlostní	ADJ	šest.rychlostní
šestispřežný	ADJ	šest.spřežný
šestistovka	NOUN	šest.sto
šestistranný	ADJ	šest.stranný
šestiuncový	ADJ	šest.uncový
šestivazebný	ADJ	šest.vazebný
šestivětvový	ADJ	šest.větvový
šestivoltový	ADJ	šest.voltový
šestisethlavý	ADJ	šest+sto.hlava
šestapadesáticentimetrový	ADJ	šestapadesát.centimetrový
šestnáctifinále	NOUN	šestnáct.finále
školkychtivý	ADJ	školka.chtivý
šrotuchtivý	ADJ	šrot.chtivý
štýrskohradecký	ADJ	štýrský.hradecký
tajnokřídlý	ADJ	tajný.křídlo
technickoprovozní	ADJ	technický.provozní
temněrůžový	ADJ	temně.temně
těžkoatletický	ADJ	těžký.atletický
toxinologie	NOUN	toxin.-log-
transaustralský	ADJ	trans.australský
troubleshooting	NOUN	trouble.shooting
trucsenát	NOUN	truc.senát
trucsjezd	NOUN	truc.sjezd
třícyklový	ADJ	tři.-cykl-
tříatomový	ADJ	tři.atomový
trojbarevný	ADJ	tři.barevný
trojblik	NOUN	tři.blik
trojctihodný	ADJ	tři.ctihodný
trojdenní	ADJ	tři.denní
trojdohoda	NOUN	tři.dohoda
třídolarový	ADJ	tři.dolarový
trojdráha	NOUN	tři.dráha
tříelektrodový	ADJ	tři.eletrodový
tříetapový	ADJ	tři.etapový
trojfunkční	ADJ	tři.funkční
trojhák	NOUN	tři.hák
trojhonný	ADJ	tři.honit
trojhran	NOUN	tři.hrana
trojinscenace	NOUN	tři.inscenace
trojkapsový	ADJ	tři.kapsový
trojkomorový	ADJ	tři.komorový
tříkošilový	ADJ	tři.košilový
tříkotlový	ADJ	tři.kotlový
třílampový	ADJ	tři.lampový
trojmezenský	ADJ	tři.mezenský
třímotorový	ADJ	tři.motorový
tříoktávový	ADJ	tři.oktávový
třípapežství	NOUN	tři.papežství
trojpěšec	NOUN	tři.pěšec
třípísničkový	ADJ	tři.písničkový
trojpodlažní	ADJ	tři.podlažní
trojpoměr	NOUN	tři.poměr
trojprostorový	ADJ	tři.prostorový
trojramenný	ADJ	tři.rameno
trojrychlostní	ADJ	tři.rychlostní
tříslabičný	ADJ	tři.slabičný
třístránkový	ADJ	tři.stránkový
trojsvatba	NOUN	tři.svatba
trojtažka	NOUN	tři.táhnout
trojtečka	NOUN	tři.tečka
trojtřídní	ADJ	tři.třídní
trojúrovňový	ADJ	tři.úrovňový
třívřetenový	ADJ	tři.vřetenový
třívýhonkový	ADJ	tři.výhonkový
trojvýstava	NOUN	tři.výstava
třiadvacetičlenný	ADJ	třiadvacet.člen
třicetidolarový	ADJ	třicet.dolarový
třicetilitr	NOUN	třicet.litr
třináctidenní	ADJ	třináct.denní
třináctidílný	ADJ	třináct.díl
třináctiletý	ADJ	třináct.léto
třináctiminutový	ADJ	třináct.minutový
třináctiposchoďový	ADJ	třináct.poschoďový
tvorbychtivý	ADJ	tvorba.chtivý
ufonaut	NOUN	ufo.-naut-
uhlovodík	NOUN	uhlík.vodík
uměleckohistorický	ADJ	umělecký.historický
umělohmotný	ADJ	umělý.hmotný
úzkoletý	ADJ	úzký.létat
úžasuplný	ADJ	úžas.plný
vakuokompresor	NOUN	vakuum.kompresor
vědeckopopulární	ADJ	vědecký.populární
vektografie	NOUN	vektor.-graf-
velikotvárný	ADJ	veliký.tvárný
velkobítešský	ADJ	velký.bítešský
velkodechý	ADJ	velký.dech
veledůkladný	ADJ	velký.důkladný
velkoelektrárenský	ADJ	velký.elektrárenský
velkohit	NOUN	velký.hit
velehory	NOUN	velký.hory
velkohospodář	NOUN	velký.hospodář
velechytře	ADV	velký.chytře
velkokřižník	NOUN	velký.křižník
velemlok	NOUN	velký.mlok
velkonájemce	NOUN	velký.nájemce
velkoodběr	NOUN	velký.odběr
velepilný	ADJ	velký.pilný
velkoprádelna	NOUN	velký.prádelna
velkorozměrový	ADJ	velký.rozměrový
velříše	NOUN	velký.říše
velkosedlák	NOUN	velký.sedlák
veleškodlivý	ADJ	velký.škodlivý
veletoč	NOUN	velký.točit
veleučený	ADJ	velký.učit
velevědecký	ADJ	velký.vědecký
velkozrnný	ADJ	velký.zrnný
veležádoucí	ADJ	velký.žádoucí
větněčlenský	ADJ	větný.členský
videoskop	NOUN	video.-skop-
videoeditovat	VERB	video.editovat
videohardware	NOUN	video.hardware
videohra	NOUN	video.hra
videokopie	NOUN	video.kopie
videoport	NOUN	video.port
videopromítačka	NOUN	video.promítačka
vinobraní	NOUN	víno.braní
Vladimír	NOUN	vládnout.mír
vlakvedoucí	NOUN	vlak.vedoucí
vlastimilovný	ADJ	vlast.milovat
vlezprdelka	NOUN	vlézt.prdelka
vnitrorepublikový	ADJ	vnitro.republikový
vodotok	NOUN	voda.téci
vojenskoprůmyslový	ADJ	vojenský.průmyslový
vojenskostrategický	ADJ	vojenský.strategický
vojenskotechnický	ADJ	vojenský.technický
vokalogram	NOUN	vokál.-gram-
vstřícnolistý	ADJ	vstřícný.list
všejsoucí	ADJ	vše.jsoucí
všehochuť	NOUN	vše.chuť
všelisjak	ADV	vše.jak
všekapitalistický	ADJ	vše.kapitalistický
všelikde	ADV	vše.kde
všekřesťanský	ADJ	vše.křesťanský
všelidový	ADJ	vše.lidový
všemohoucný	ADJ	vše.moci
všeprodejný	ADJ	vše.prodejný
všepřemáhající	ADJ	vše.přemáhající
všetečný	ADJ	vše.téci
vševysvětlující	ADJ	vše.vysvětlující
východokarpatský	ADJ	východ.karpatský
východoslavonský	ADJ	východ.slavonský
výrazuplný	ADJ	výraz.plný
vysokofrekventní	ADJ	vysoký.frekventní
vysokomolekulární	ADJ	vysoký.molekulární
vysokomýtský	ADJ	vysoký.mýtský
vysokopecař	NOUN	vysoký.pecař
vysokorodný	ADJ	vysoký.rodný
vysokorozený	ADJ	vysoký.rodit
vysokoteplotní	ADJ	vysoký.teplotná
vysokoújezdský	ADJ	vysoký.újezdský
vzletuplný	ADJ	vzlet.plný
terazijský	ADJ	X.X
xerotermní	ADJ	xeros.-therm-
západoslovenský	ADJ	západ.slovenský
zatměníchtivý	ADJ	zatmění.chtivý
zelenobranský	ADJ	zelený.branský
zelenofialový	ADJ	zelený.fialový
zelenokabátník	NOUN	zelený.kabátník
zelenokvětý	ADJ	zelený.květ
zeměchtivý	ADJ	země.chtivý
zemětřesení	NOUN	země.třesení
zemědělskolesnický	ADJ	zemědělský.lesnictví
zimomorný	ADJ	zima.mořit
zlatavofialový	ADJ	zlatavý.fialový
znovudefinovat	VERB	znovu.definovat
znovunatočit	VERB	znovu.natočit
znovunavrátit	VERB	znovu.navrátit
znovuotevřít	VERB	znovu.otevřit
znovuovládnutí	NOUN	znovu.ovládnutí
znovupohřbít	VERB	znovu.pohřbít
znovupotvrdit	VERB	znovu.potvrdit
znovustvořit	VERB	znovu.stvořit
znovuumístění	NOUN	znovu.umístění
znovuvysvěcení	NOUN	znovu.vysvěcení
znovuzrodit	VERB	znovu.zrodit
zvědochtivý	ADJ	zvěd.chtivý
zvrtohlavit	VERB	zvrtat.hlava
Železnobrodsko	NOUN	železný.brodský
židovskoimperialistický	ADJ	židovský.imperialismus
životodárce	NOUN	život.dárce
žlutavozelený	ADJ	žlutavý.zelený
žlutohnědý	ADJ	žlutý.hnědý
žlutohřbetý	ADJ	žlutý.hřbet
