lemma	parents
kdoule	kdoule
syringobulbie	-syring- bulbus
trochanterion	-trech-
mimoodborný	mimo odbor
samodělný	sám dělný
samoděržaví	samoděržaví
sugestopedie	sugesce -paid-
vlkodav	vlk dávit
aeroakrobacie	-aer- akrobacie
arcičaroděj	-arci- čaroděj
bioprovincie	-bio- provincie
cykloubytovna	-cykl- ubytovna
postnormalizační	-post- normalizační
postváchalovský	-post- Váchal
ekopolicie	-eko- policie
encyklopedie	-en- -cykl- -paid-
fotofobie	-fot- -fob-
hyperodoncie	-hyper- -odont-
kvaziekologický	-kvazi- ekologický
makromanický	makro mánie
mikrotragédie	-mikr- tragédie
mimokošíkářský	mimo košíkář
mimokřesťanský	mimo křesťan
mimoloutkářský	mimo loutkář
mimomalířský	mimo malíř
mimomanželský	mimo manžel
mimonakladatelský	mimo nakladatel
mimoodborářský	mimo odborář
mimopotravinářský	mimo potravinář
profifotbalista	profi fotbalista
profitenis	profi tenis
vitelogeneze	-tel- geneze
čarověník	čarověník
vnitroklimatický	vnitřní klima
transdisciplinární	-trans- disciplína
turbosféra	-turb- sféra
tvrdohlavý	tvrdý hlava
ultrapravý	-ultra- pravý
televarieté	-tel- varieté
minižačka	minižák
minižákyně	minižák
neobaroko	-neo- baroko
ereutofobie	-ereuth- fobie
subvirový	vir
mimoevropan	mimo Evropa
fotocentrum	-fot- centrum
šedošedý	šedý šedý
krimipříběh	krimi příběh
mimoverbální	mimo verbum
raketoplán	raketa -plan-
mimoodovolací	mimo odvolací
kulturuněpolitický	kulturní politika
polooficální	půl oficiální
termokinetika	-therm- kinetika
absolvenťák	!
hotelovka	!
jazykovka	!
jednokolejka	!
pauzák	!
peďák	!
permice	!
plavečák	!
plenárka	!
polohovka	!
stoeurovka	!
dvoumotorák	!
nobelovka	!
podlahovka	!
jednohodinovka	!
jednosměrka	!
minerálka	!
minimálka	!
miniplenárka	plenárka
astrometrie	-astr- metr
dendrometrie	-dendr- metr
enantiometrie	-enanti- metr
fonometrie	-fon- metr
granulometrie	-granul- metr
hygrometr	-hygr- metr
chronometráž	-chron- metr
audiometr	audio metr
audiometrie	audiometr
barometr	bar metr
bilirubinometr	bilirubin metr
denzitometrie	denzita metr
dynamometr	dynamo metr
elipsometr	elipsa metr
kilometr	kilo metr
kraniometrie	kranium metr
metrologie	metr -log-
pyranometr	pyran metr
radiometrie	radio metr
rentgenometrie	rentgen metr
sinusometr	sinus metr
typometrický	typometrie
autoštěp	-aut- štěp
elektroakupunktura	-elektr- akupunktura
exoparazit	-exo- parazit
kvaziopoziční	-kvazi- opoziční
makromíchání	makro míchání
miniautomobil	-mini- automobil
minbar	-mini- bar
minibikový	-mini- bike
miničtyřka	-mini- čtyřka
minidávkový	-mini- dávka
minifilmeček	-mini- filmeček
minifotbal	-mini- fotbal
miniházená	-mini- házená
minihitparáda	-mini- hitparáda
minihřiště	-mini- hřiště
miniikona	-mini- ikona
miniinvazivní	-mini- invaze
miniinvazní	-mini- invaze
miniknížectví	-mini- knížezctví
miniobrazovka	-mini- obrazovka
miniobřad	-mini- obřad
miniocelárna	-mini- ocelárna
minioddělení	-mini- oddělení
minisalónek	-mini- salónek
minitoolbar	-mini- toolbar
minizářivka	-mini- zářivka
multifokální	-multi- fokus
multilaterální	-multi- laterála
nitroskupina	-nitr- skupina
šusťákovka	!
dvojstěnka	!
airbag	air bag
alergotoxický	alergie toxický
americkofrancouzský	americký francouzský
aminoplast	amin plast
aminopurin	aminopur
arabskoislámský	arabský islámský
autorskoprávní	autorský právo
bassreflex	bass reflex
bělokřídlý	bílý křídlo
bílostříbrný	bílý stříbrný
bílozlatohnědý	bílý zlatý hnědý
běložlutý	bílý žlutý
borůvkobraní	borůvka braní
bosenskochorvatský	bosenský chorvatský
brandýskoboleslavský	brandýský boleslavský
britskoamerický	britský americký
britskoitalský	britský italský
břichabol	břicho bol
býložravý	býlí žravý
celoarabský	celý Arábie
celoperuánský	celý Peru
celotáborový	celý tábor
celovečerní	celý večer
cizojazyčný	cizí jazyk
černoděrový	černý díra
černopolní	černý pole
červenoknihovní	červený knihovna
českobavorský	český bavorský
čínskoamerický	čínský americký
čistokrevný	čistý krev
čistosrdečný	čistý srdce
dalekojdoucí	daleko jdoucí
dalekozření	daleko zřít
dělostřelec	dělo střelec
dlanitodílný	dlanitý díl
dlouhozobý	dlouhý zobák
dolnokounický	dolní Kounice
dolnorakouský	dolní Rakousko
domorodý	doma rodit
domkuchtivý	domek chtivý
dopravněbezpečnostní	dopravní bezpečnost
drahocenný	drahý cena
drsnokřídlec	drsnokřídlý
druhoválečný	druhý válka
dřevouhelný	dřevěný uhlí
dřevohliněný	dřevo hlína
dřevožrout	dřevo žrout
dvouapsidový	dva apsida
dvoubarvotisk	dva barva tisk
dvoubojovník	dva bojovník
dvojhra	dva hra
dvojjehlový	dva jehla
dvojmaraton	dva maraton
dvouapůltisícovka	dva půl tisícovka
dvojřádek	dva řádek
dvojslunce	dva slunce
dvousetdílný	dva sto díl
dvousetmarkový	dva sto marka
dvousetosmimiliónový	dva sto osm milión
dvojzoborožec	dva zobák roh
dynamometrický	dynamometr
dýňobraní	dýně braní
fotokvíz	-fot- kvíz
fotonávod	-fot- návod
fotopapír	-fot- papír
fotopříběh	-fot- příběh
fotopublikace	-fot- publikace
francouzskoněmecký	francouzský německý
fyzickozeměpisný	fyzický zeměpis
genofond	gen fond
grandslam	grand slam
havlovláda	Havel vláda
hlinitoborokřemičitan	hlinitý bor křemičitan
hmyzožravý	hmyz žravý
víceprocesní	hodně proces
víceproudý	hodně proud
víceventilový	hodně ventil
hodnověrný	hodný víra
hodobožový	hodobóžo
hololebý	holý leb
horkovod	horko vést
hornohradební	horní hradba
hořečnatoželeznatý	hořečnatý železnatý
hranatozrnitý	hranatý zrno
hvězdotřesení	hvězda třesení
choroboplodný	choroba plodný
italskofrancouzský	italský francouzský
italskoněmecký	italský německý
izraelskofrancouzský	izraelský francouzský
jaslovskobohunický	Jaslovské Bohunice
jasnozření	jasný zření
javorolistý	javor list
jednodrážkový	jeden drážka
jednofázový	jeden fáze
jednoduchoučce	jednoduchoučký
jídlonosič	jídlo nosič
jinojazyčný	jiný jazyk
jitrocel	jitrocel
jihoirácký	jižní Irák
jihomandžuský	jižní Mandžusko
jihosrbský	jižní Srbsko
kamenožrout	kámen žrout
kdovíkdy	kdo vědět  kdy
kdovíproč	kdo vědět  proč
kdovíjak	kdo vědět jak
kdovíkam	kdo vědět kam
kdovíkde	kdo vědět kde
kilotuna	kilo tuna
kilovar	kilovar
kilowatt	kilowatt
kmenostup	kmen stoupat
kmenotvorný	kmen tvořit
kolemstojící	kolem stojící
kosovskoalbánský	kosovský albánský
kulohlavec	koule hlava
kozorožec	kozoroh
krabožravý	krab žravý
krátkozobý	krátký zobák
krupobití	kroupa bití
křesťanskoafrický	křesťanský africký
křivočarý	křivý čára
kulturychtivý	kultura chtivý
kulturněhistorický	kulturní historie
kulturněpolitický	kulturní politika
kunětickohorský	Kunětica hora
lázeňskoléčebný	lázeňský léčba
ledochod	led chodit
ledolom	led lomit
lehkoolejářský	lehký olejář
liberálněkonzervativní	liberální konzervativní
libovonný	libý vůně
lichozpeřený	lichý zpeřený
lichožrout	lichý žrout
listožravý	list žravý
polopatě	lopata
lýkožravý	lýko žravý
lýkožrout	lýko žrout
maďarskorakouský	maďarský rakouský
maďarskoslovenský	maďarský slovenský
makrocyt	makro -cyt-
makroagregát	makro agregát
makroanalýza	makro analýza
makroaplikace	makro aplikace
makrobudík	makro budík
makrocyklus	makro cyklus
makrodata	makro data
makrodefinice	makro definice
makroelement	makro element
makroenergetický	makro energie
makrofág	makro fág
makrofauna	makro fauna
makrofunkce	makro funkce
makrofyzika	makro fyzika
makrogameta	makro gameta
makroglie	makro glie
makroglobální	makro globální
makroinstrukce	makro instrukce
makrojazyk	makro jazyk
makroklávesa	makro klávesa
makroklima	makro klima
makroklimatologie	makro klimatologie
makrokonvertor	makro konvertor
makrolid	makro lid
makromédium	makro médium
makronukleus	makro nukleus
makroobjektiv	makro objektiv
makrookolí	makro okolí
makroparazit	makro parazit
makropeptid	makro peptid
makropohled	makro pohled
makropohyb	makro pohyb
makropór	makro pór
makroprincip	makro princip
makroprostor	makro prostor
makroprostředí	makro prostředí
makroprvek	makro prvek
makropřeklad	makro překlad
makropřekladač	makro překladač
makropříkaz	makro příkaz
makroregulace	makro regulace
makrorekordér	makro rekordér
makrorozměr	makro rozměr
makrosféra	makro sféra
makrosnímek	makro snímek
makrosporangium	makro sporangium
makrostav	makro stav
makrosvět	makro svět
makrosystém	makro systém
makrotext	makro text
makroúdaj	makro údaj
makroukazatel	makro ukazatel
makrovegetace	makro vegetace
makroveličina	makro veličina
makrovidění	makro vidění
makrozáběr	makro záběr
makroznak	makro znak
makrozvuk	makro zvuk
makrofagocytóza	makrofág -cyt-
makrostruktura	makrostruktura
mandžuskotunguzský	mandžuský tunguzský
masožravý	maso žravý
meruňkovooranžový	meruňkový oranžový
mimoběžný	mimo běžet
mimobiologický	mimo biologie
mimobursovní	mimo bursa
mimocelní	mimo clo
mimoglobální	mimo globál
mimohospodářský	mimo hospodář
mimoherní	mimo hra
mimokonkursní	mimo konkurs
mimolidský	mimo lid
mimoliterární	mimo literatura
mimomzdový	mimo mzda
mimonárodní	mimo národ
mimonovinářský	mimo novinář
mimoobligační	mimo obligace
mimooborový	mimo obor
mimoodvětvový	mimo odvětví
mimopařížský	mimo Paříž
mimoplanetární	mimo planeta
mimoprofesní	mimo profese
mimoprovozní	mimo provoz
mimoresortní	mimo resort
mimorybářský	mimo rybář
mimosoutěžní	mimo soutěž
mimosterlingový	mimo sterling
mimotrestní	mimo trest
mimotřídní	mimo třída
mimoústecký	mimo Ústí
mimohradecky	mimohradecký
mimozaměstnanecky	mimozaměstnanecký
minigrafický	minigraf
mnohonárodní	mnoho národ
mnohanásobný	mnoho násobek
mnohotvářný	mnoho tvář
modrosemenný	modrý semeno
modrozlatý	modrý zlatý
molekulárněbiologický	molekulární biologie
moravskokrumlovský	moravský Krumlov
moravskoostravský	moravský Ostrava
moravskopanonský	moravský panonský
moravskoslezský	moravský slezský
moravskoslovenský	moravský slovenský
mořenokvětý	mořena květ
moskevskohavanský	moskevský havanský
moskevskopražský	moskevský pražský
motýlokvětý	motýlí květ
mrchožravý	mrcha žravý
mrchožrout	mrcha žrout
německoamerický	německý americký
německofrancouzský	německý francouzský
nízkofrekvenční	nízký frekvence
nízkokapacitní	nízký kapacita
nízkoobjemový	nízký objem
nocležiště	nocleh
nocležna	nocleh
novobydžovský	nový Bydžov
novopythagoreizmus	nový pythagoreizmus
novototalitář	nový totalitář
odkudpak	odkud pak
ostravskokarvinský	ostravský karvinský
ostravskokarvínský	ostravský karvínský
ostravskoopavský	ostravský opavský
ostrovtip	ostrý vtip
oxidoredukční	oxid redukce
palivotěsný	palivo těsný
paravýsadek	parašutistický výsadek
perskoarabský	perský arabský
pětičetný	pět čítat
pětilůžkový	pět lůžko
pětimístný	pět místo
pětioskarový	pět Oskar
pětipísňový	pět píseň
pětiprstový	pět prst
pětiprstý	pět prst
pětisegmentový	pět segment
pětistrunný	pět struna
pětišestinový	pět šestina
pětivrstvý	pět vrstva
písčitohlinitý	písčitý hlinitý
pivobraní	pivo braní
plánograf	plán graf
planetocentrický	planeta centrum
plnobarevný	plný barva
plodožravý	plod žravý
plynoinstalatérský	plyn instalatér
plynovzdušný	plyn vzduch
politickoprávní	politický právo
politickosprávní	politický správa
polokošile	pólo košile
polodivoce	polodivoký
polodivoko	polodivoký
polodlouze	polodlouhý
polohopis	poloha psát
polohermeticky	polohermetický
polohořce	polohořký
polochemicky	polochemický
polojasno	polojasný
polokeřík	polokeř
polokeřovitý	polokeř
polokoloniální	polokolonie
polokoulička	polokoule
polokulovitý	polokoule
polokulový	polokoule
polokroužek	polokruh
polokruhovitý	polokruh
polokružnice	polokruh
polokulaťoučký	polokulatý
pololáník	pololán
pololeže	pololežet
pololežící	pololežet
polomafiánský	polomafián
polooblačno	polooblačný
poloobloukový	polooblouk
polodbornický	poloodborník
polookružní	polookruh
poloopile	poloopilý
poloostrůvek	poloostrov
polootrocký	polootrok
polootroctví	polootrok
poloparazitický	poloparazit
polopouštní	polopoušť
polosedě	polosedět
polosladko	polosladký
polosocialistický	polosocialismus
polospící	polospát
polosyto	polosytý
pološeře	pološerý
pološikmost	pološikmý
polotuze	polotuhý
polovypukle	polovypuklý
polozřícenina	polozřícený
polskočeský	polský český
polskoněmecký	polský německý
polskoslezský	polský slezský
polskoukrajinský	polský ukrajinský
praktickohospodářský	praktický hospodářství
právněhistorický	právní historie
prdelolezectví	prdelolezec
prstoklad	prst klást
průtokoměr	průtok měřit
prvobytný	prvý být
prvouka	prvý učit
prvoústý	prvý ústa
polobrekem	půl brek
polokupolový	půl kupolový
pololetí	půl léto
polodborník	půl odborník
polopito	půl pít
polopláně	půl pláň
pološeptem	půl šepot
poloneurčitý	půl určitý
polonezávislý	půl závislý
položertem	půl žert
půldruhastoletý	půldruhý století
pyložravý	pyl žravý
radiobiologie	radio biologie
radiorezistentní	radio rezistentní
radiograficky	radiografický
rakouskočeský	rakouský český
rakouskošvýcarský	rakouský švýcarský
reklamožrout	reklama žrout
reprocentrum	repro centrum
rostlinožravý	rostlina žravý
rumunskomaďarský	rumunský maďarský
rybožravý	ryba žravý
rychlotavba	rychlý tavba
řeckoturecký	řecký turecký
římskoněmecký	římský německý
římskoslovanský	římský slovanský
samodetekce	sám detekce
samodiagnostika	sám diagnostika
samodiskriminace	sám diskriminace
samofakturace	sám fakturace
samohana	sám hana
samohasicí	sám hasicí
samohodnocení	sám hodnocení
samochvála	sám chvála
samokopírovací	sám kopírovací
samolepicí	sám lepicí
samolepící	sám lepící
samolibý	sám libý
samolustrátor	sám lustrátor
samomluva	sám mluva
samonafukovací	sám nafukovací
samonakládací	sám nakládací
samonápovědný	sám nápovědný
samonatáčecí	sám natáčecí
samonatahovací	sám natahovací
samonavíjecí	sám navíjecí
samonivelační	sám nivelační
samonosný	sám nosný
samoobhajoba	sám obhajovat
samoopalovací	sám opalovací
samoopalující	sám opalující
samopal	sám pálit
samorozhodce	sám rozhodce
samorostlý	sám růst
samořezný	sám řezný
samosběr	sám sběr
samosebou	sám se
samosklopný	sám sklopný
samosoud	sám soud
samosprašný	sám sprašný
samostavitel	sám stavitel
samostavitelný	sám stavitelný
samostředný	sám střed
samostřelný	sám střílet
samosvorný	sám svírat
samotestovací	sám testovací
samotěžba	sám těžba
samotíž	sám tíž
samotok	sám tok
samotvorba	sám tvorba
samouhašení	sám uhašení
samoukájení	sám ukájení
samoupínací	sám upínací
samouspokojení	sám uspokojení
samovařič	sám vařič
samovratný	sám vratný
samovýsev	sám výsev
samovysvětlující	sám vysvětlující
samovzpěrný	sám vzpěrný
samozabarvovací	sám zabarvovací
samozápal	sám zápal
samozaváděcí	sám zaváděcí
samožadatel	sám žadatel
samoleštící	samo leštící
samoobčerstvovávaný	samoobčerstvovat
samopoznaný	samopoznat
samosmršťovávaně	samosmršťovávaný
samosmršťovávanost	samosmršťovávaný
samospasitel	samospasit
samospásný	samospasit
samothrácký	Samothráké
saskočeský	saský český
scénosled	scéna sled
sebeaktuálněji	se aktuálně
sebeaktuálnější	se aktuální
sebeatraktivněji	se atraktivně
sebeautentičtější	se autentický
sebeblběji	se blbě
sebebouřlivěji	se bouřlivě
sebečerstvěji	se čerstvě
sebedarování	se darování
semenožravý	semeno žravý
severomandžuský	severní Mandžusko
slezskomoravský	slezský moravský
slezskoněmecký	slezský německý
slezskoostravský	slezský Ostrava
slovenskomaďarský	slovenský maďarský
smluvněprávní	smluvní právo
snadnohořlavý	snadno hořlavý
sociálněpedagogický	sociální pedagogika
sociálněvýchovný	sociální výchova
softsexykomedie	soft sexykomedie
spodnopermský	spodní perm
společenskohistorický	společenský historický
společenskohospodářský	společenský hospodářství
společenskokritický	společenský kritika
společenskopolitický	společenský politika
společenskoprávní	společenský právo
spoluvěřící	spolu věřící
srdcerváč	srdce rváč
stálobarevný	stále barevný
stálozelený	stále zelený
stáložárný	stále žárný
staroběloruský	starý Bělorusko
staroegyptský	starý Egypt
starokomický	starý komika
staroměstký	starý město
stejnoslabičný	stejný slabika
stínobytný	stín být
stolnětenisový	stolní tenis
struskovápenný	struska vápno
středoasyrský	střední Asýrie
středohoří	střední hora
středovýchodoevropský	střední východní Evropa
stříbrohlavý	stříbrný hlava
stříbrolistý	stříbrný list
stříbrnomodrožlutý	stříbrný modrý žlutý
sudetskoněmecký	sudetský Němec
svatomartinský	svatý Martin
svrchnokambrický	svrchní kambrium
svrchuřečený	svrchu říci
syrskoizraelský	syrský izraelský
syrskopalestinský	syrský palestinský
šedostříbřitý	šedý stříbřitý
šeroslepý	šero slepý
škarohlíd	škaredě hledět
škodolibý	škoda libý
štěrkopísčitý	štěrkopísek
šunkofleky	šunka flek
tatrovák	tatra
technickobezpečnostní	technický bezpečnost
technickofyzikální	technický fyzika
technickoprovozní	technický provoz
technoparty	techno party
tělocvik	tělo cvik
temněrůžový	temně růžový
thaiboxer	thajský boxer
tichomoří	tichý moře
tmavobílý	tmavě bílý
tmavočerný	tmavě černý
tmavohnědý	tmavě hnědý
tmavohnědožlutý	tmavě hnědý žlutý
tmavomodrozelený	tmavě modrý zelený
tmavomodrý	tmavě modrý zelený
tmavooranžový	tmavě oranžový
tmavorezavý	tmavě rezavý
tmavorusý	tmavě rusý
tmavošedý	tmavě šedý
tmavozelený	tmavě zelený
tmavězlatý	tmavě zlatý
tmavozrzavý	tmavě zrzavý
tmavožlutý	tmavě žlutý
tmavovýtrusný	tmavý výtrus
transaustralský	trans australský
trolejbus	trolej bus
uherskoostrožský	Uherský Ostroh
uměleckohistorický	umělecký historie
uměleckořemeslný	umělecký řemeslo
umělohedvábný	umělý hedvábí
umělohmotný	umělý hmota
velikotvárný	velice tvárný
velkoelektrárenský	velkoelektrárna
velkoprůmyslný	velkoprůmysl
velkoplochý	velký plocha
velkorozměrový	velký rozměr
velkovýkrm	velký výkrm
veledobrý	velmi dobrý
velenedobrý	velmi dobrý
veledůkladný	velmi důkladný
velechytře	velmi chytře
velemoudrý	velmi moudrý
veleobsáhlý	velmi obsáhlý
velepečlivý	velmi pečlivý
velepilný	velmi pilný
velenepříznivý	velmi příznivý
veleslibný	velmi slibný
velesložitý	velmi složitý
veleškodlivý	velmi škodlivý
veleučený	velmi učený
velevědecký	velmi vědecký
velevhod	velmi vhod
velezběhlý	velmi zběhlý
veležádoucí	velmi žádoucí
veřejnohospodářský	veřejný hospodářství
veřejnoprávní	veřejný právo
videoanarchie	video anarchie
videozařízení	video zařízení
vlhkoměr	vlhko měřit
vlnobití	vlna bití
vnitroalianční	vnitro aliance
vnitrobanka	vnitro banka
vnitrobuněčný	vnitro buňka
vnitrodružstevní	vnitro družstvo
vnitrohospodářský	vnitro hospodářství
vnitroislámský	vnitro islám
vnitroodborářský	vnitro odborář
vnitrookresní	vnitro okres
vnitroorganizační	vnitro organizace
vnitroparlamentní	vnitro parlament
vnitropartajní	vnitro partaj
vnitropůdní	vnitro půda
vnitrorepublikový	vnitro republika
vnitrostátní	vnitro stát
vnitrostranický	vnitro straník
vnitrotelevizní	vnitro televize
vnitroústavní	vnitro ústava
vnitroútvarový	vnitro útvar
vnitrovládní	vnitro vláda
vnitrovýkazový	vnitro výkaz
vnitrozaměstnanecký	vnitro zaměstnanec
vnitročesky	vnitročeský
vojenskobezpečnostní	vojenský bezpečnost
vojenskohistorický	vojenský historie
vojenskohospodářský	vojenský hospodářství
vojenskoprůmyslový	vojenský průmysl
vojenskostrategický	vojenský strategie
vojenskotechnický	vojenský technika
vrubozobý	vrub zobák
vysokofrekvenční	vysoký frekvence
vysokofrekventní	vysoký frekvence
vysokokapacitní	vysoký kapacita
vysokokmitočtový	vysoký kmitočet
vysokomolekulární	vysoký molekula
vysokomýtský	vysoký Mýto
vysokoparohatý	vysoký paroh
vzduchofiltrační	vzduch filtrační
vzduchotěsný	vzduch těsný
zahraničněhospodářský	zahraniční hospodářství
zahraničněpolitický	zahraniční politika
západoafghánský	západní Aghánistán
západobengálský	západní Bengálsko
západogermánský	západní germánský
západogruzínský	západní Gruzie
západoirácký	západní Irák
západoirský	západní Irsko
západokřesťanský	západní křesťanství
západoněmecký	západní Německo
západopennsylvánský	západní Pennsylvánie
západořecký	západní Řecko
západoslavonský	západní Slavonie
západošvédský	západní Švédsko
západoturkický	západní turkický
zelenočtvrteční	zelený čtvrtek
zelenokabátník	zelený kabát
zelenokadeřavý	zelený kadeř
zelenomodrohnědý	zelený modrý hnědý
zelenomodrožlutý	zelený modrý žlutý
zemanofobie	Zeman -fob-
zemědělskohospodářský	zemědělský hospodářství
zemědělskovýrobní	zemědělský výroba
zkázověstný	zkáza věstit
zlatobýl	zlatý býlí
zlatolící	zlatý líce
zlatoústý	zlatý ústa
zlatovlasý	zlatý vlas
zlatozelenohnědý	zlatý zelený hnědý
zpětnovazební	zpětný vazba
zrnožravý	zrní žravý
zrnokaz	zrno kazit
zubořez	zub řez
zvědochtivý	zvědy chtivý
zvěrokruh	zvíře kruh
zvěrokupec	zvíře kupec
zvěrolékař	zvíře lékař
zvěromág	zvíře mág
zvěromalba	zvíře malba
zvonohra	zvon hra
zvonkohra	zvonek hra
zvukotěsný	zvuk těsný
zvukotechnik	zvukotechnika
žabožrout	žába žrout
žabníkovitý	žabník
žezlovládný	žezlo vládnout
žhavopestrý	žhavě pestrý
acetylfenylhydrazin	acetyl fenylhydrazin
adeninribonukleotid	adenin ribonukleotid
adolescentofilie	adolescent -fil-
aerokvětý	aero květ
akrylomalba	akryl malba
aktinodermatitida	aktin dermatitida
aktinometrie	aktin -metr-
aktinomykóza	aktin mykóza
algologie	-alg- -log-
alogamie	-al- -gam-
aminocukr	amin cukr
andragogika	-andr- -agog-
anglofil	Anglie -fil-
aortokoronární	aorta koronární
arabskoizraelský	arabský izraelský
archetyp	-arch- typ
arcičíšník	-arci- číšník
arcipresbyter	-arci- presbyter
aromaterapie	aroma terapie
artrock	art rock
arylcyklohexylamin	aryl cyklohexylamin
arzenopyrit	arzen pyrit
asijskobezpečnostní	asijský bezpečnost
astrokartografie	-astr- kartografie
astromedicína	-astr- medicína
audioefekt	audio efekt
audiokniha	audio kniha
audiomixér	audio mixér
audiopošta	audio pošta
audiopřehrávač	audio přehrávač
audioprůvodce	audio průvodce
audiořetěz	audio řetěz
audiosignál	audio signál
audiostudio	audio studio
audiověž	audio věž
audiovstup	audio vstup
audiovýstup	audio výstup
audiozařízení	audio zařízení
autachtivý	auto chtivý
autoanténa	auto anténa
autočenžr	auto čenžr
autochemie	auto chemie
autodráha	auto dráha
automat	-aut- -math-
autoolej	auto olej
autopojištění	auto pojištění
autopřehlídka	auto přehlídka
autoregresní	-aut- regrese
autorelativní	-aut- relativní
autotrenažér	auto trenažér
azbestocement	azbest cement
baletománie	balet mánie
balíkomat	balík mat
balneoterapie	-balne- terapie
barograf	bar -graf-
basketuchtivý	basket chtivý
bělobradý	bílý brada
bělobřichý	bílý břicho
běločelý	bílý čelo
bělohřbetý	bílý hřbet
bělohubý	bílý huba
bělokamenný	bílý kámen
bělokorý	bílý kůra
bělokur	bílý kur
bělokvetoucí	bílý kvetoucí
bělokvětý	bílý květ
bělolanýž	bílý lanýž
bělolící	bílý líce
bělonohý	bílý noha
běloocasý	bílý ocas
bělopruhý	bílý pruh
běloruký	bílý ruka
bělosemenný	bílý semeno
bělotrn	bílý trn
bělovlasatý	bílý vlasatý
bělovlasý	bílý vlas
bělovousý	bílý vousy
betaverze	beta verze
bétřídní	bé třídní
béžovobronzový	béžový bronzový
béžovočerný	béžový černý
béžovočervený	béžový červený
béžovokaramelový	béžový karamelový
béžovomodrý	béžový modrý
béžovooranžový	béžový oranžový
béžovoterakotový	béžový terakotový
béžovozelený	béžový zelený
béžovozlatý	béžový zlatý
béžovožlutý	béžový žlutý
bezpečnostněpolitický	bezpečnostní politika
bílkovinotvorný	bílkovina tvořit
bíločernočervený	bílý černý červený
bíločernomodrý	bílý černý modrý
bíločernožlutý	bílý černý žlutý
bíločerný	bílý černý
bíločervenočerný	bílý červený černý
bíločervený	bílý červený
bílohnědočervený	bílý hnědý červený
bílohnědozelený	bílý hnědý zelený
bílomodročerný	bílý modrý černý
bílomodrozelený	bílý modrý zelený
bílomodrý	bílý modrý
bílomourovatý	bílý mourovatý
bílooranžovo	bílý oranžový
bílooranžový	bílý oranžový
bílošedooranžový	bílý šedý oranžový
bílostříbřitý	bílý stříbřitý
bílozelenočerný	bílý zelený černý
bílozelenočervený	bílý zelený červený
bílozelenozlatý	bílý zelený zlatý
bílozelenožlutý	bílý zeleno žlutý
bílozelený	bílý zelený
bílozlatý	bílý zlatý
bíložlutočerný	bílý žlutý černý
bíložlutý	bílý žlutý
bioarcheologie	-bio- archeologie
bioberan	-bio- beran
biochemie	-bio- chemie
biočip	-bio- čip
biočistička	-bio- čistička
biodoplněk	-bio- doplněk
biodožínky	-bio- dožínky
bioeidam	-bio- eidam
biofarmacie	-bio- farmacie
bioforma	-bio- forma
biogranule	-bio- granule
biohrnec	-bio- hrnec
biokampaň	-bio- kampaň
biokapr	-bio- kapr
bioklimatologie	-bio- klimatologie
biokoenzym	-bio- koenzym
biokoridor	-bio- koridor
biokybernetika	-bio- kybernetika
biolékořice	-bio- lékořice
biomasa	-bio- masa
bionafta	-bio- nafta
bionákup	-bio- nákup
bionanotechnologie	-bio- nanotechnologie
bionápad	-bio- nápad
bionápoj	-bio- nápoj
bionávyk	-bio- návyk
bionosič	-bio- nosič
bioolympiáda	-bio- olympiáda
biopapež	-bio- papež
bioplínka	-bio- plínka
biopočítač	-bio- počítač
biopohanka	-bio- pohanka
biopohon	-bio- pohon
biopříběh	-bio- příběh
biopříkrm	-bio- příkrm
bioptákovina	-bio- ptákovina
biosedlák	-bio- sedlák
biosexy	-bio- sexy
bioskop	-bio- -skop-
biostabilizační	-bio- stabilizační
biostandard	-bio- standard
biostanice	-bio- stanice
biotolerantní	-bio- tolerantní
biotvaroh	-bio- tvaroh
biotým	-bio- tým
biovajíčko	-bio- vajíčko
biovepřík	-bio- vepřík
biovlna	-bio- vlna
biovložka	-bio- vložka
biovodík	-bio- vodík
biozelí	-bio- zelí
biozrní	-bio- zrní
bipolární	-bi- polární
biréma	-bi- réma
blahočet	blaho čítat
blátošlap	bláto šlapat
blbovzdorný	blb vzdorný
bledomodrý	bledý modrý
bleskosvod	blesk vést
bleskurychlý	blesk rychlý
blogosféra	blog sféra
bobkovišeň	bobek višeň
bodnořezný	bodný řezný
bohabojný	bohabojný
bohapustý	bůh pustý
bohorodice	bůh rodit
bohovat	bůh
bohovražda	bůh vražda
bohulibý	bůh libý
bojeschopný	boj schopný
bokorys	boka rys
bolehlav	bolet hlava
bombometčík	bomba metat
bombometník	bomba metat
boritokřemičitý	boritý křemičitý
borosilikát	bor silikát
bosenskomuslimský	bosenský muslimský
bosonohý	bosý noha
boxmač	box mač
bradykinéza	-brady- -kinet-
branněbezpečnostní	branný bezpečnostní
branněvýchovný	branný výchovný
bratrovrah	bratr vrah
bratrovražda	bratr vražda
břichomluva	břicho mluva
břichonožec	břicho noha
brkoslav	brko slavit
bromkyan	brom kyan
bublifuk	bublina foukat
bůhvíjak	bůh jak
bůhvíkam	bůh kam
bůhvíkde	bůh vědět kde
bůhvíkdy	Běh vědět kdy
bůhvíodkud	bůh vědět odkud
bůhvíproč	běh vědět proč
bulvárumilovný	bulvár milovat
burčákochtivý	burčák chtivý
byznysplán	byznys plán
čajechtivý	čaj chtivý
časoměr	čas měřit
časostroj	čas stroj
celněprávní	celní právo
celodrážní	celý dráha
celoprosklený	celý prosklený
celoškolní	celý škola
celostat	-coel- -stat-
cenotvorba	cena tvorba
černobřichý	černý břicho
černobrvý	černý brva
černobýl	černý býlí
černočervenopestrý	černý červený pestrý
černočervenozlatý	černý červený zlatý
černočervený	černý červený
černohlavý	černý hlava
černohnědozelený	černý hnědý zelený
černohnědožlutý	černo hnědý žlutý
černohřbetý	černý hřbet
černohumorný	černý humor
černokabátník	černý kabát
černokadeřavý	černý kadeř
černokřídlý	černý křídlo
černokrký	černý krk
černolící	černý líce
černomodrý	černý modrý
černonohý	černý noha
černoočka	černý oko
černooký	černý oko
černooranžový	černý oranžový
černopáska	černý páska
černopluchý	černý plucha
černoprachý	černý prach
černoprdelnice	černoprdelník
černopruhý	černý pruh
černorezatý	černý rezatý
černorudý	černý rudý
černorůžový	černý růžový
černošedivý	černý šedivý
černošedobílý	černý šedý bílý
černošedý	černý šedý
černostříbřitý	černý stříbřitý
černotisk	černý tisk
černovlasý	černý vlas
černovýtrusý	černý výtrus
černozelenožlutý	černý zelený žlutý
černozelený	černý zelený
černozlatý	černý zlatý
černožlutý	černý žlutý
černozrzavý	černý zrzavý
čertkus	čert kus
červenobřichý	červený břicho
červenočernobílý	červený černý bílý
červenocitlivý	červený citlivý
červenoduhový	červený duhový
červenohlavý	červený hlava
červenohřbetý	červený hřbet
červenohrdlý	červený hrdlo
červenohřívý	červený hříva
červenoklasý	červený klas
červenokřivolaký	červený křivolaký
červenokřižák	červený kříž
červenokropenatý	červený kropenatý
červenomodrošedý	červený modrý šedý
červenomodrožlutý	červený modrý žlutý
červenonohý	červený noha
červenoocasý	červený ocas
červenooký	červený oko
červenooranžový	červený oranžový
červenopálený	červený pálený
červenoplodý	červený plod
červenoploutvý	červený ploutev
červenopomerančový	červený pomerančový
červenopoříčský	červený Poříčí
červenoprsý	červený prs
červenorezavý	červený rezavý
červenorudozelený	červený rudý zelený
červenorudý	červený rudý
červenoruký	červený ruka
červenorůžový	červený růžový
červenorybízový	červený rybízový
červenošedý	červený šedý
červenoštítý	červený štít
červenovláska	červený vlas
červenovlasý	červený vlas
červenozelenobílý	červený zelený bílý
červenozelenočerný	červený zelený černý
červenozelenomodrý	červený zelený modrý
červenozelený	červený zelený
červenozlatý	červený zlatý
červenožlutavý	červený žlutavý
červenožlutofialový	červený žlutý fialový
červenožlutý	červený žlutý
červenozobý	červený zobák
červenozrzavý	červený zrzavý
cestopis	cesta psát
chloranilin	chlor anilin
chlorpikrin	chlor pikrin
chlorpyridin	chlor pyridin
chmelovodič	chmel vodit
cholangiografie	-chol- angiografie
chondroklast	-chondr- -klast-
chordofon	-chord- -fon-
chromitodraselný	chromitý draselný
chromoterapie	chrom terapie
chudokvětý	chudý květ
chudozubý	chudý zub
chvalořeč	chválit řeč
chvalozpěv	chválit zpěv
chyboražba	chyba ražba
cigártaška	cigáro taška
cihlovočervený	cihlový červený
cihlovošedý	cihla šedý
činohra	čin hra
činorodý	čin rodit
církevněpolitický	církevní politika
církevněsprávní	církevní správní
cirkumpolární	-circum- polární
čiročirý	čirý čirý
čistočistý	čistý čistý
čistopis	čistý psát
civilněbezpečnostní	civilní bezpečnostní
cizokrajný	cizí kraj
cizoložit	cizí lože
cizoměnový	cizí měna
cizopasit	cizí pást
cizorodý	cizí rod
cizosprášení	cizosprášit
cizovláda	cizí vláda
countrybál	country bál
čteníchtivý	čtení chtivý
ctihodný	čest hodný
cukroměr	cukr měřit
cukrovar	cukr vařit
cykloakce	-cykl- akce
cykloareál	-cykl- areál
cykloatrakce	-cykl- atrakce
cykloautobus	-cykl- auto bus
cyklochata	-cykl- chata
cyklodelegace	-cykl- delegace
cyklodráha	-cykl- dráha
cykloexkurze	-ek- exkurze
cyklokalvárie	-cykl- kalvárie
cyklokamarád	-cykl- kamarád
cyklokampaň	-cykl- kampaň
cyklokarta	-cykl- karta
cyklokaskadér	-cykl- kaskadér
cyklokniha	-cykl- kniha
cyklokruh	-cykl- kruh
cyklokurs	-cykl- kurz
cyklomagistrála	-cykl- magistrála
cyklomagnát	-cykl- magnát
cyklomapa	-cykl- mapa
cyklonářadí	-cykl- nářadí
cyklonavigace	-cykl- navigace
cyklooáza	-cykl- oáza
cykloopravář	-cykl- opravář
cyklooř	-cykl- oř
cyklooxygenáza	-cykl- oxygenáza
cyklopark	-cykl- park
cyklopás	-cykl- pás
cykloplavba	-cykl- plavba
cyklopodjezd	-cykl- podjezd
cyklopohár	-cykl- pohár
cykloportál	-cykl- portál
cyklopřilba	-cykl- přilba
cyklopřívěs	-cykl- přívěs
cykloprotest	-cykl- protest
cyklopruh	-cykl- pruh
cykloráj	-cykl- ráj
cyklosezóna	-cykl- sezóna
cykloshow	-cykl- show
cykloskelet	-cykl- skelet
cyklostav	-cykl- stav
cyklostavba	-cykl- stavba
cyklotramp	-cykl- tramp
cyklotremp	-cykl- tremp
cyklotrenažér	-cykl- trenažér
cyklotrialistický	-cykl- trialismus
cykloúčastník	-cykl- účastník
cyklovagón	-cykl- vagón
cyklovak	-cykl- vak
cyklovětšina	-cykl- většina
cystopyelitida	cysta pyelitida
cytopenie	-cyt- -pen-
daktylogram	-daktyl- -gram-
dalekonosný	daleko nosit
dalekostřelný	daleko střílet
dalekozraký	daleký zrak
dálkoměr	dálka měřit
dálkoplavec	dálka plavec
dálkoplaz	dálka plaz
dálnopis	dálný psát
daňotvorný	daň tvořit
dataprojekce	data projekce
datasystém	data systém
dávnověk	dávný věk
dědickoprávní	dědický právo
dějinotvorný	dějiny tvořit
dělnickoaparátnický	dělnický aparátník
dělostřelba	dělo střelba
dennodenní	denní denní
deskotisk	deska tisk
diacetyl	-di- acetyl
diashow	-dia- show
dieselagregát	diesel agregát
dietoterapie	dieta terapie
difenylguanidin	difenyl guanidin
dílovedoucí	dílo vedoucí
dimethylaminobenzaldehyd	dimethylamin benzaldehyd
dinopark	dinosaurus park
dipól	-di- pól
diskohvězda	disko hvězda
diskokabaret	disko kabaret
diskokomplex	disko komplex
diskokostým	disko kostým
diskokrál	disko král
diskometalový	disko metalový
diskoodpoledne	disko odpoledne
diskoretro	disko retro
diskorytmus	disko rytmus
diskoterapie	disko terapie
divotvorce	div tvůrce
divotvorný	div tvořit
dlanitolistý	dlanitý list
dlanitosečný	dlanitý sečný
dlouhodobý	dlouhý doba
dlouhohořící	dlouho hořet
dlouholebý	dlouhý leb
dlouhonohý	dlouhý noha
dlouhoocasý	dlouhý ocas
dlouhorohý	dlouhý roh
dluhopis	dluh psát
dluhuprostý	dluh prostý
dolnodunajský	dolní Dunaj
dolnoguinejský	dolní Guinea
dolnolukavický	dolní Lukavice
dolnolutyňský	dolní Lutyň
dolnolužickosrbský	dolní lužický Srbsko
dolnomoravský	dolní Morava
dolnoněmecký	dolní Německo
dolnopanonský	dolní Panonie
dolnopočernický	dolní Počernice
dolnorychnovský	dolní Rychnov
domobrana	domov bránit
dortuchtivý	dort chtivý
drahokam	drahý kámen
dramaterapeutický	drama terapeutický
drancováníchtivý	drancování chtivý
draselnohlinitý	draselný hlinitý
draselnohořečnatý	draselný hořečnatý
draselnoželezitý	draselný železitý
draselnoživcový	draslík živcový
dřevaprostý	dřevo prostý
dřevobraní	dřevo braní
dřevodělný	dřevo dělat
dřevodeska	dřevo deska
dřevodílna	dřevo dílna
dřevohlinitý	dřevo hlinitý
dřevohra	dřevo hra
dřevokaz	dřevo kaz
dřevoklání	dřevo klání
dřevokombinát	dřevo kombinát
dřevokresba	dřevo kresba
dřevolátka	dřevo látka
dřevomalba	dřevo malba
dřevomateriál	dřevo materiál
dřevomodelář	dřevo modelář
dřevomorka	dřevo mořit
dřevomozaika	dřevo mozaika
dřevoplyn	dřevo plyn
dřevoprůmysl	dřevo průmysl
dřevořez	dřevo řez
dřevořezání	dřevo řezání
dřevořezba	dřevo řezba
dřevořezbářství	dřevo řezbářství
dřevorytectví	dřevorytec
dřevosklad	dřevo sklad
dřevosochař	dřevo sochař
dřevostavba	dřevo stavba
dřevostavitel	dřevo stavitel
dřevoštěpka	dřevo štěpka
dřevotisk	dřevo tisk
dřevotříska	dřevo tříska
dřevovláknitý	dřevovlákno
dřevovýrobek	dřevo výrobek
dřevozávod	dřevo závod
dřevozpracující	dřevo zpracující
dřevožravý	dřevo žravý
drobnohled	drobný hledět
drobnokresba	drobný kresba
drobnoplodý	drobný plod
drobnotvarý	drobný tvar
drogchtivý	droga chtivý
drogychtivý	droga chtivý
drsnosrstý	drsný srst
druhohory	druhý hora
druhoplánový	druhý plán
druhoústý	druhý ústa
držgrešle	držet grešle
držhubné	držet huba
držkopád	držka pád
dubobukový	dub buk
duchověda	duch věda
důlnětechnický	důlní technický
dušezpyt	duše zpytovat
dutorohý	dutý roh
dvojautobus	dva autobus
dynamoelektrický	dynamo elektrický
dýňořezba	dýně řezba
ekonomickohospodářský	ekonomický hospodářský
ekonomickotechnický	ekonomický technický
ekotoxikologie	-eko- toxikologie
ektogenní	-ekt- -gen-
ektotermie	-ekt- -term-
elektospotřebič	-elektr- spotřebič
elektroenergetika	-elektr- energetika
elektroeroze	-elektr- eroze
elektrofonický	-elektr- -fon-
elektrokapilární	-elektr- kapilární
elektrokartáč	-elektr- kartáč
elektrokeramika	-elektr- keramika
elektroměření	-elektr- měřit
elektroodbyt	-elektr- dbát
elektroodpad	-elektr- odpad
elektroprodejna	-elektr- prodejna
elektrosmog	-elektr- smog
elektrosonda	-elektr- sonda
elektrospotřebič	-elektr- spotřebič
elektrošrot	-elektr- šrot
elektroterapie	-elektr- terapie
elektroúdržba	-elektr- údržba
elektrovelkoobchod	-elektr- velkoobchod
elektrovýzbroj	-elektr- výzbroj
embryogeneze	embryo geneze
embryopatie	embryo -path-
embryotoxický	embryo toxický
endobronchiální	-end- bronchiální
energovod	energie vést
enteroskopie	-enter- -skop-
enzymoterapie	enzym terapie
ergoterapie	-erg- terapie
erotickosymbolický	erotický symbol
etnocentrizmus	etno centrizmus
eventostratigrafie	event stratigrafie
exkarvinský	-ex- karvinský
exmístopředseda	-ex- místopředseda
exmistr	-ex- mistr
exsevillský	-ex- sevillský
extřetiligový	-ex- třetiligový
fachidiot	fach idiot
falocentrický	falus centrický
fanklub	fan klub
fanshop	fan shop
felinoterapie	-felin- terapie
fenylpropanový	fenylpropan
ferotapiolit	-ferr- tapiolit
ferroslitina	-ferr- slitina
fialovočerný	fialový černý
fialovohnědý	fialový hnědý
fialovomodrý	fialový modrý
fibrinogen	fibrin gen
fibrinolyzin	fibrin lyzin
filipojakubský	Filip Jakub
filmotéka	film -thek-
filmotvorný	film tvořit
filmuchtivý	film chtivý
filtroventilace	filtr ventilace
finančněhospodářský	finanční hospodářský
finančněprávní	finanční právo
florigen	-flori- -gen-
fluorokřemičitý	fluor křemičitý
folkrock	folk rock
formálněprocesní	formální procesní
fotekchtivý	fotka chtivý
fotoaparát	foto aparát
fotodeska	-fot- deska
fotodynamický	foto dynamický
fotoefekt	-fot- efekt
fotoklub	foto klub
fotoproud	-fot- proud
fotoreportáž	foto reportáž
fototyp	-fot- typ
fytopaleontologie	-fyt- paleontologie
gametogeneze	gameta geneze
garážmistr	garáž mistr
gastroenteritida	-gastr- enteritida
gastrovaskulární	-gastr- vaskulární
generálbas	generální bas
generálmajor	generál major
generálporučík	generál poručík
genobanka	gen banka
genotoxický	gen toxický
genotyp	gen typ
genštáb	generální štáb
golfuchtivý	golf chtivý
gólostroj	gól stroj
grafogram	-graf- -gram-
grafoterapie	-graf- terapie
gramofon	-graf- -fon-
granátomet	granát metat
granitotrachytický	granit trachytický
granodiorit	granit diorit
grantůchtivý	grant chtivý
gravitest	gravidní test
gumolatex	guma latex
hadilov	had lovit
hadimrška	had mrštný
handgranát	hand granát
hanopis	hana psát
heparinocyt	heparin -cyt-
hitparáda	hit paráda
hladinoměr	hladina měřit
hladkosrstý	hladký srst
hlasůchtivý	hlas chtivý
hlenohnisavý	hlen hnisavý
hlenotvorba	hlen tvořit
hlinitoberylnatý	hlinitý berylnatý
hlinitodraselný	hlinitý draselný
hlinitohořečnatý	hlinitý hořečnatý
hlinitojílovitý	hlinitý jílovitý
hlinitokřemičitan	hlinitý křemičitan
hlinitopísčitý	hlinitý písčitý
hlinitovápenatý	hlinitý vápenatý
hlošinolistý	hlošina list
hlubokoorný	hluboký orat
hlubokozmražený	hluboko zmražený
hlukoměr	hluk měřit
hnědobronzový	hnědý bronzový
hnědočernobílý	hnědý černý bílý
hnědočernožlutý	hnědý černý žlutý
hnědočerný	hnědý černý
hnědočervený	hnědý červený
hnědofialový	hnědý fialový
hnědohlavý	hnědý hlava
hnědohnědý	hnědý hnědý
hnědokošiláč	hnědý košile
hnědomodrý	hnědý modrý
hnědookrový	hnědý okrový
hnědoolivový	hnědý olivový
hnědooranžový	hnědý oranžový
hnědopásník	hnědý pás
hnědorezavý	hnědý rezavý
hnědorudý	hnědý rudý
hnědošedofialový	hnědý šedý fialový
hnědošedý	hnědý šedý
hnědovlasý	hnědý vlas
hnědozelenkavý	hnědý zelenkavý
hnědozelený	hnědý zelený
hnědozlatý	hnědý zlatý
hnědožlutý	hnědý žlutý
hnědozubý	hnědý zub
hnidopich	hnida píchat
hnilokal	hnít kal
hodokvas	hod kvasit
hokuspokus	hokus pokus
holekchtivý	holka chtivý
holokrčka	holý krk
holokrystalický	-hol- krystal
holotyp	-hol- typ
horkokrevný	horký krev
hornoblatenský	horní Blatná
hornoegyptský	horní Egypt
hornomoravský	horní Morava
hornooravský	horní Orava
hornopočernický	horní Počernice
hornorakouský	horní Rakousko
hornoroveňský	horní Roveň
hospodářskooperativní	hospodářský operativní
hospodářskopolitický	hospodářský politický
hospodářskoprávní	hospodářský právní
hospodářskospolečenský	hospodářský společenský
hospodářskosprávní	hospodářský správní
housekchtivý	houska chtivý
hrdopyšný	hrdý pyšný
hřibochtivý	hřib chtivý
hřibotvarý	hřib tvar
hříchuprostý	hřích prostý
hrubohmotný	hrubý hmota
hrubokožec	hrubý kůže
hrubosrstý	hrubý srst
hrubotvarý	hrubý tvar
hrůzokrásný	hrůza krásný
hrůzovláda	hrůza vláda
hustoměr	hustý měřit
hvězdokupa	hvězda kupa
hvězdolet	hvězda let
hydrofilněhydrofobní	hydrofilní hydrofobní
hydrogenkarbonát	hydrogen karbonát
hydrogensůl	hydrogen sůl
hydromagnetický	-hydr- magnetický
hygrograf	-hygr- -graf-
hymnograf	hymna -graf-
hyperkomplexní	-hyper- komplexní
hypertenze	-hyper- tenze
hypokortikalismus	-hypo- -kortik-
ideodiverzní	idea diverzní
idiotyp	-idio- typ
infobox	info box
infobudka	info budka
infocentrum	info centrum
infodálnice	info dálnice
infografický	infografika
infokanál	info kanál
infokancelář	info kancelář
infolinka	info linka
infopanel	info panel
infoservis	info servis
infostánek	info stánek
infrapaprsek	-infra- paprsek
inkasoindosament	inkaso indosament
interdentála	-inter- dentála
interfix	-inter- fix
interoperabilní	-inter- operabilní
interprizmatický	-inter- prizmatický
inzulinorezistence	inzulin rezistence
izomorfie	-iso- morf
izotyp	-iso- typ
jaksepatří	jak patřit
jasanolistý	jasan list
jasnovidný	jasný vidět
jasnozřivý	jasný zřít
jasoměr	jas měřit
játroslinivka	játra slinivka
jazykověda	jazyk věda
jazykozpyt	jazyk zpyt
jazzband	jazz band
jazzklub	jazz klub
jazzrock	jazz rock
jazzuchtivý	jazz chtivý
jedinovláda	jediný vláda
jedinovolba	jediný volba
jednokřídlový	jeden křídlo
jednonohý	jedno noha
jednorejstříkový	jeden rejstřík
jelenohorský	jelení horský
jemnobřitý	jemný břit
jemnohmotný	jemný hmota
jemnokresba	jemný kresba
jemnostpán	jemnost pán
jihoafghánský	jižní Aghánistán
jihoafrický	jižní Afrika
jihoalbánský	jižní Albánie
jihoalžírský	jižní Alžírsko
jihoamerický	jižní Amerika
jihoanglický	jižní Anglie
jihoangolský	jižní Angola
jihoarabský	jižní Arábie
jihoasijský	jižní Asie
jihoatlantický	jižní Atlantik
jihoatlantský	jižní Atlanta
jihoaustralský	jižní Austrálie
jihoázerbájdžánský	jižní Ázerbajdžán
jihobavorský	jižní Bavory
jihobelgický	jižní Belgie
jihobosenský	jižní Bosna
jihobrazilský	jižní Brasilie
jihobulharský	jižní Bulharsko
jihočečenský	jižní Čečensko
jihočeský	jižní Čechy
jihochilský	jižní Chile
jihochorvatský	jižní Chorvat
jihočínský	jižní Čína
jihodakotský	jižní Dakota
jihodalmatský	jižní Dalmacie
jihoegyptský	jižní Egypt
jihoevropský	jižní Evropa
jihofidžijský	jižní Fidži
jihofilipínský	jižní Filipíny
jihofrancouzský	jižní Francie
jihogruzínský	jižní Gruzie
jihoindický	jižní Indie
jihoíránský	jižní Írán
jihoirský	jižní Irsko
jihoislandský	jižní Island
jihoitalský	jižní Itálie
jihoizraelský	jižní Izrael
jihojakutský	jižní Jakutie
jihojaponský	jižní Japonsko
jihojemenský	jižní Jemen
jihojordánský	jižní Jordánsko
jihokalifornský	jižní Kalifornie
jihokarolinský	jižní Karolína
jihokarolínský	jižní Karolína
jihokarpatský	jižní Karpaty
jihokašmírský	jižní Kašmír
jihokolumbijský	jižní Kolumbie
jihokorejský	jižní Korea
jihokurilský	jižní Kurily
jiholibanonský	jižní Libanon
jiholondýnský	jižní Londýn
jiholužický	jižní Lužice
jihomaďarský	jižní Maďarsko
jihomalajský	jižní Malajsie
jihomalešický	jižní Malešice
jihomexický	jižní Mexiko
jihomezopotamský	jižní Mezopotámie
jihomongolský	jižní Mongolsko
jihomoravský	jižní Morava
jihomořský	jižní moře
jihoněmecký	jižní Německo
jihonigerijský	jižní Nigérie
jihonizozemský	jižní Nizozemsko
jihoosetinský	jižní Osetie
jihoosetský	jižní Osetie
jihopacifický	jižní Pacifik
jihopákistánský	jižní Pákistán
jihoperuánský	jižní Peru
jihoplzeňský	jižní Plzeň
jihopolární	jižní pól
jihopolský	jižní Polsko
jihoportugalský	jižní Portugalsko
jihorakouský	jižní Rakousko
jihořecký	jižní Řecko
jihorumunský	jižní Rumunsko
jihoruský	jižní Rusko
jihosalvadorský	jižní Salvador
jihosibiřský	jižní Sibiř
jihosicilský	jižní Sicílie
jihoskotský	jižní Skotsko
jihoslovanský	jižní Slovan
jihoslovenský	jižní Slovensko
jihosomálský	jižní Somálsko
jihošpanělský	jižní Španělsko
jihosúdánský	jižní Súdán
jihošvédský	jižní Švédsko
jihošvýcarský	jižní Švýcarsko
jihotádžický	jižní Tádžikistán
jihotchajwanský	jižní Tchajwan
jihoturecký	jižní Turecko
jihotyrolský	jižní Tyroly
jihoukrajinský	jižní Ukrajina
jihoulsterský	jižní Ulster
jihouralský	jižní Ural
jihovětnamský	jižní Vietnam
jihovietnamský	jižní Vietnam
jihozápad	jih západ
jinonárodní	jiný národ
jinorodý	jiný rod
jinud	jiný odkud
jinudy	jiný kudy
jizerskohorský	jizerský hora
kabelovod	kabel vést
kadibudka	kadit budka
kafemlýnek	kafe mlýnek
kalojem	kal jímat
kalyptrogen	-kalyptr- -gen-
kamenořezba	kámen řezba
kamenoželezný	kámen železo
kampak	kam pak
kapraďorost	kapradí růst
karbonylskupina	karbonyl skupina
kasírtaška	kasírovat taška
kaštanovohnědý	kaštanový hnědý
kávomilec	káva milec
kávomlýnek	káva mlýnek
kávovar	káva vařit
kávychtivý	káva chtivý
každodenní	každý den
každoměsíční	každý měsíc
každopádně	každý pád
každotýdenní	každý týden
každovečerní	každý večer
kazisvět	kazit svět
kdypak	kdy pak
keramzitbeton	keramzit beton
kickbox	kick box
kilobaud	-kilo- baud
kilobit	-kilo- bit
kilobyte	-kilo- byte
kilocyklus	-kilo- cyklus
kilogram	-kilo- -gram-
kilometráž	kilometr
kinoamatér	kino amatér
kinoaparát	kino aparát
kinobus	kino bus
kinocentrum	kino centrum
kinocilie	kino cilie
kinodistribuce	kino distribuce
kinofilm	kino film
kinohvězda	kino hvězda
kinokamera	kino kamera
kinokavárna	kino kavárna
kinoklub	kino klub
kinomaniak	kino maniak
kinosál	kino sál
kinotechnika	kino technika
kinotéka	kino téka
kinouhlík	kino uhlík
kinozáznam	kino záznam
kinožurnál	kino žurnál
klapouchý	klopit ucho
klikyhák	klikatý hák
klimatoterapie	klima terapie
klínopis	klín psát
knihkupec	kniha kupec
knihopis	kniha psát
knihosklad	kniha sklad
knihověda	kniha věda
knihvedoucí	kniha vedoucí
kočkopes	kočka pes
koldokola	kolem dokola
koldům	kolektivní dům
kolkolem	kolem kolem
kolkuprostý	kolek prostý
koloběh	kolo běh
koloběžka	kolo běžet
kolozubý	kolo zub
komediograf	komedie -graf-
kominterna	komunistický internacionál
korkotvorný	korek tvořit
kosoběžný	koso běhat
kostitřas	kost třást
koupánímilovný	koupání milovat
kovohydridový	kov hydridový
kožedělný	kůže dělat
kozoroh	koza roh
krajinohospodářský	krajina hospodářský
krásnoočko	krásný očko
krátkodenní	krátký den
krátkodobý	krátký doba
krátkododobý	krátký doba
krátkohubý	krátký huba
krátkokřídlý	krátký křídlo
krátkolebý	krátký leb
krátkolistý	krátký list
krátkonohý	krátký noha
krátkoprstý	krátký prst
krátkorohý	krátký roh
krátkostéblý	krátký stéblo
krátkovlasý	krátký vlas
krátkozubý	krátký zub
kravihorský	kraví hora
křehkolomový	křehký lom
krémovozelený	krémový zelený
křesťanskohumanistický	křesťanský humanistický
křesťanskonárodní	křesťanský národní
křesťanskopravicový	křesťanský pravicový
křesťanskosociální	křesťanský sociální
krimifilm	krimi film
kriminalistickoprávní	kriminalistický právní
kriminalistickotechnický	kriminalistický technický
krimiparodie	krimi parodie
křivkoměr	křivka měřit
křivohlavý	křivý hlava
křivohubý	křivý huba
křivoklasý	křivý klas
křivonohý	křivý noha
křivopruhý	křivý pruh
křivorohý	křivý roh
křivozubý	křivý zub
krkolomný	krk lomit
krokoměr	krok měřit
křovinořez	křovina řez
kruhorohý	kruh roh
krutihlav	kroutit hlava
krveprolévání	krev prolévání
krveprolití	krev prolití
krymskotatarský	krymský Tatar
kryosféra	-kry- sféra
kryptocitát	-krypt- citát
kryptodeprese	-krypt- deprese
kryptodiktatura	-krypt- diktatura
kryptofašista	-krypt- fašista
kryptofederalizmus	-krypt- federalizmus
kryptoklima	-krypt- klima
kryptokrystalický	-krypt- krystalický
kryptomarxistický	-krypt- marxistický
kryptoschéma	-krypt- schéma
kryptosystém	-krypt- systém
kryptovulkanický	-krypt- vulkanický
krystalochemie	krystal chemie
krytokořenný	krytý kořen
krytosemenný	krytý semeno
kulatolebí	kulatý leb
kulatoplodý	kulatý plod
kulihrášek	kulit hrášek
kulinářskoerotický	kulinářský erotický
kuželozubý	kužel zub
kvadrofonie	-kvadr- -fon-
kvazispolečenství	-kvazi- společenství
kvazistelární	-kvazi- stelární
kvazivláda	-kvazi- vláda
kyanoakrylát	-kyan- akrylát
kyanoguanidin	kyan guanidin
kyanoželezitan	kyan železitan
kyjevskopečorský	kyjevský pečorský
kyselinovzdorný	kyselina vzdorný
lamželezo	lámat železo
lapiduch	lapat duch
laryngofaryngitida	-laryng- faryngitida
laseroterapie	laser terapie
latinoamerický	latinský Amerika
latinskoamerický	latinský Amerika
ledopád	led pád
leduprostý	led prostý
lehkonohý	lehký noha
lesnickohospodářský	lesnický hospodářský
lesopark	les park
lesostep	les step
lesotundra	les tundra
letorost	léto růst
liberálněpolitický	liberální politika
libosad	libý sad
lichoběžný	lichý běžet
lichoklas	lichý klas
lichopřeslen	lichý přeslen
lidovláda	lid vláda
liduprostý	lid prostý
lihoměr	líh měřit
lihovar	líh vařit
liliokvětý	lilie květ
lískooříškový	lískový oříšek
listohlod	list hlodat
listokaz	list kazit
listoklad	list klást
literárněfilozofický	literární filozofie
literárněteoretický	literární teorie
litosféra	-lith- sféra
lněnoolejový	lněný olej
lodivod	loď vést
lognormální	logaritmicky normální
lokálpatriotizmus	lokální patriotizmus
loutkohra	loutka hra
lunochod	luna chodit
luskovinoobilný	luskovina obilí
luzovláda	luza vláda
lůzovláda	lůza vláda
lymfoblastický	lymfa -blast-
lymfodrenáž	lymfa drenáž
lymfogranulom	lymfa granulom
lymfogranulóm	lymfa granulom
lysohlávka	lysý hlava
lysohorský	lysý hora
lyžováníchtivý	lyžování chtivý
malobankovní	malý banka
malokvětý	malý květ
malolánský	malý lán
maloletý	malý léto
malolistý	malý list
malopěstitel	malý pěstitel
maloplodý	malý plod
malováníchtivý	malování chtivý
marxleninský	Marx Lenin
masokostní	maso kost
masopust	maso půst
masozávod	maso závod
masožrout	maso žrout
materiálněprávní	materiální právní
matfyz	matematický fyzikální
matkovrah	matka vrah
maxipes	-maxi- pes
maxiplášť	-maxi- plášť
mechanickobiologický	mechanický biologický
mechorost	mech růst
měděnočervený	měděný červený
měděnozlatý	měděný zlatý
mědikovec	měď kovat
mědiryt	měď rýt
meditéka	-medi- -thék-
megabit	-mega- bit
megajachta	-mega- jachta
megamarket	-mega- market
megatrh	-mega- trh
mělkovodní	mělký voda
membránofon	membrána -fon-
meningoencefalitida	-mening- encefalitida
meningomyelitida	-mening- myelitida
methylaminorex	methylamin rex
methylfenobarbital	methyl fenobarbital
methylfentanyl	methyl fentanyl
mezinárodněpolitický	mezinárodní politika
midibus	-midi- bus
milimetr	-mili- metr
milionářskovojenský	milionářský vojenský
mimoalpský	mimo Alpy
mimoamerický	mimo Amerika
mimobankovní	mimo banka
mimobankrotový	mimo bankrot
mimobásnický	mimo básník
mimoběžka	mimo běžet
mimobiblický	mimo bible
mimobilanční	mimo bilance
mimoboční	mimo bok
mimobratislavský	mimo Bratislava
mimobrněnský	mimo Brno
mimobroadwayský	mimo Broadway
mimobuněčný	mimo buňka
mimoburzovní	mimo burza
mimočasový	mimo čas
mimocenový	mimo cena
mimočeský	mimo Čechy
mimocestovní	mimo cesta
mimocévní	mimo céva
mimochod	mimo chodit
mimochrámový	mimo chrám
mimocírkevní	mimo církev
mimoděčný	mimoděk
mimoděk	mimo dík
mimoděložní	mimo děloha
mimoděložný	mimo děloha
mimodiskusní	mimo diskuse
mimodivadelní	mimo divadlo
mimodrážní	mimo dráha
mimoekonomický	mimo ekonomika
mimoemisní	mimo emise
mimoestetický	mimo estetika
mimoetický	mimo etika
mimoevropský	mimo Evropa
mimofakultní	mimo fakulta
mimofinanční	mimo finance
mimofotbalový	mimo fotbal
mimogalaktický	mimo galaxie
mimogalerijní	mimo galerie
mimohistorický	mimo historie
mimohnízdní	mimo hnízdo
mimohokejový	mimo hokej
mimohollywoodský	mimo Hollywood
mimohotelový	mimo hotel
mimohradecký	mimo Hradec
mimohrudní	mimo hruď
mimohudební	mimo hudba
mimohusinecký	mimo Husinec
mimohutní	mimo huť
mimoideologický	mimo ideologie
mimoindický	mimo Indie
mimojaderný	mimo jádro
mimojaponský	mimo Japonsko
mimojaterní	mimo játra
mimojazykový	mimo jazyk
mimojdoucí	mimo jdoucí
mimojedoucí	mimo jedoucí
mimojihlavský	mimo Jihlava
mimojiné	mimo jiný
mimokladenský	mimo Kladno
mimokloubní	mimo kloub
mimoknihovní	mimo knihovna
mimokomisní	mimo komise
mimokomunistický	mimo komunismus
mimokonferenční	mimo konference
mimokonkurzní	mimo konkurz
mimokořenový	mimo kořen
mimokorový	mimo kůra
mimokursový	mimo kurs
mimoléčebný	mimo léčba
mimolexikální	mimo lexikon
mimoliberecký	mimo Liberec
mimolimitní	mimo limit
mimoliturgický	mimo liturgie
mimologický	mimo logika
mimolondýnský	mimo Londýn
mimoměstský	mimo město
mimomotoristický	mimo motorismus
mimomyšlenkový	mimo myšlenka
mimoněmecký	mimo Německo
mimonemocniční	mimo nemocnice
mimoobchodní	mimo obchod
mimoobecní	mimo obec
mimoodborový	mimo odbor
mimoodpovědnostní	mimo odpovědnost
mimopeněžní	mimo peníze
mimoprávní	mimo právo
mimoprocesní	mimo proces
mimorezortní	mimo rezort
mimorodinný	mimo rodina
mimosporný	mimo spor
mimotělesný	mimo tělo
mimotelevizní	mimo televize
mimotoleranční	mimo tolerance
mimovolný	mimo vůle
miniauto	-mini- auto
minibagr	-mini- bagr
miniblok	-mini- blok
minicomputer	-mini- computer
minidebata	-mini- debata
minidodávka	-mini- dodávka
miniexhibice	-mini- exhibice
minifarma	-mini- farma
miniflaštička	-mini- flaštička
minigolf	-mini- golf
miniharpuna	-mini- harpuna
miniherbář	-mini- herbář
minihnutí	-mini- hnutí
minihonorář	-mini- honorář
minihoror	-mini- horor
minihospůdka	-mini- hospůdka
minikabaret	-mini- kabaret
minikajakář	-mini- kajakář
minikalendář	-mini- kalendář
minikancelář	-mini- kancelář
minikára	-mini- kára
minikatalog	-mini- katalog
minikobylka	-mini- kobylka
minikód	-mini- kód
minikomentář	-mini- komentář
minikometa	-mini- kometa
minikompakt	-mini- kompakt
minikoncert	-mini- koncert
minikonektor	-mini- konektor
minikonference	-mini- konference
minikonflikt	-mini- konflikt
minikopaná	-mini- kopaná
minikraječka	-mini- kraječka
minikřeslo	-mini- křeslo
minimaraton	-mini- maraton
minimistr	-mini- mistr
minináboj	-mini- náboj
mininábytek	-mini- nábytek
mininástroj	-mini- nástroj
minipakt	-mini- pakt
minipapírek	-mini- papírek
miniparlament	-mini- parlament
minipartaj	-mini- partaj
minipenalta	-mini- penalta
minipenzión	-mini- penzion
minipohádka	-mini- pohádka
miniportrét	-mini- portrét
minipředpokojík	-mini- předpokojík
minipřehrada	-mini- přehrada
minipříběh	-mini- příběh
minipříloha	-mini- příloha
miniproblém	-mini- problém
miniprofil	-mini- profil
miniprohlídka	-mini- prohlídka
miniprůřez	-mini- průřez
minipuč	-mini- puč
minireferendum	-mini- referendum
minirozdíl	-mini- rozdíl
minisafari	-mini- safari
minisekretariát	-mini- sekretariát
miniseminář	-mini- seminář
miniskandál	-mini- skandál
miniškola	-mini- škola
minisoutěž	-mini- soutěž
ministáteček	-mini- státeček
minisystém	-mini- systém
minitlumič	-mini- tlumič
minitracheotomie	-mini- tracheotomie
minitraktor	-mini- traktor
minitrh	-mini- trh
minitriatlon	-mini- triatlon
miniturnaj	-mini- turnaj
miniúřad	-mini- úřad
minivolba	-mini- volba
minivrt	-mini- vrt
minivýbuška	-mini- výbuška
minivýprava	-mini- výprava
minivýstava	-mini- výstava
minizasedání	-mini- zasedání
minohledačka	mina hledačka
místokonsul	místo konsul
místokrálovský	místokrál
místopředseda	místo předseda
místoředitel	místo ředitel
místoregent	místo regent
mladoarabský	mladý Arábie
mladobucký	mladý buk
mladohegelovec	mladý hegelovec
mladotřetihorní	mladý třetihory
mladoturek	mladý Turek
mlékoměr	mléko měřit
mluvoznalec	mluva znalec
mluvychtivý	mluva chtivý
mnohabodový	mnoho bod
mnohastranový	mnoho strana
mnohohlavý	mnoho hlava
mnohokvětý	mnoho květ
mnohonáboženský	mnoho náboženství
mnohonohý	mnoho noha
mnohosvazkový	mnoho svazek
mnohoúrovňový	mnoho úroveň
mocenskohospodářský	mocenský hospodářský
mocenskosprávní	mocenský správní
močopudný	moč pudit
močovod	moč vést
modrobíločerný	modrý bílý černý
modrobílooranžový	modrý bílý oranžový
modrobílorudý	modrý bílý rudý
modrobílý	modrý bílý
modročernobílý	modrý černý bílý
modročerný	modrý černý
modročervenočerný	modrý červený černý
modročervenožlutý	modrý červený žlutý
modročervený	modrý červený
modrofialovočerný	modrý fialový černý
modrofialovočervený	modrý fialový červený
modrofialovozelený	modrý fialový zelený
modrohnědý	modrý hnědý
modrokvětý	modrý květ
modrooranžovobílý	modrý oranžový bílý
modrooranžový	modrý oranžový
modrošedavý	modrý šedavý
modrošedivý	modrý šedivý
modrošedobílý	modrý šedobílý
modrošedý	modrý šedý
modrostříbřitý	modrý stříbřitý
modrotemenný	modrý temeno
modrotisk	modrý tisk
modrovous	modrý vous
modrozelenobílý	modrý zelený bílý
modrozelenočerný	modrý zelený černý
modrozelenofialový	modrý zelený fialový
modrozelenošedý	modrý zelený šedý
modrozelený	modrý zelený
modrozlatavý	modrý zlatavý
modrozlatozelený	modrý zlatý zelený
modrožlutočerný	modrý žlutý černý
modrožlutočervený	modrý žlutý červený
modrožlutý	modrý žlutý
mokropředený	mokro předený
monarchofašistický	monarcha fašistický
monodisplej	-mon- displej
monoizotopický	-mon- izotopický
monoklinální	-mon- -klin-
monolyžař	-mon- lyžař
monoprogramový	-mon- program
monoterpen	-mon- terpen
mordparta	mord parta
mořechtivý	moře chtivý
morfoném	morf foném
moskevskocentristický	moskevský centristický
motocykl	-moto- -cykl-
motoklub	-moto- klub
motorsport	motor sport
mozkomíšní	mozek mícha
mrakodrap	mrak drápat
mravkolev	mravenec lev
mravokárný	mrav kárný
mravověda	mrav věda
mucholapka	moucha lapat
multidatabázový	-multi- databáze
multimilionář	-multi- milionář
multividový	-multi- vid
muzikoterapeutický	muzika terapie
myocard	-my- -kardi-
myofibrila	-my- fibrila
mysliveckoochranářský	myslivecký ochranářský
mýtotvorný	mýtus tvořit
nabíledni	bílý den
náboženskofilozofický	náboženský filozofický
náboženskohistorický	náboženský historický
náboženskokulturní	náboženský kulturní
nachovýtrusný	nach výtrusný
naftonitril	nafta nitril
náhorněkarabašský	náhorní Karabach
nanebevzatý	nebe vzít
nanebevzetí	nebe vzít
nanovlákenný	-nan- vlákenný
národněkatolický	národní katolický
názvosloví	název slovo
neopozitivizmus	-neo- pozitivizmus
neoveristický	-neo- veristický
nervosvalový	nerv sval
nervydrásající	nerv drásat
netbook	net book
neuropřenašeč	-neur- přenašeč
neuroradiologie	-neur- radiologie
nevímjak	vědět jak
nicnetušící	nic tušit
nicnevyzařující	nic vyzařovat
nitrobřišní	nitro břišní
nitroparafín	-nitr- parafín
nitropyridin	-nitr- pyridin
nitrotělní	nitro tělo
nízkoalkoholický	nízký alkohol
nízkoenergetický	nízký energie
nízkokarátový	nízký karát
nízkooktanový	nízký oktan
nízkoradioaktivní	nízký radioaktivita
nízkorozpočtový	nízký rozpočet
nízkotirážní	nízký tiráž
nocleh	noc ležet
nohejbal	noha ball
nohsled	noha sledovat
nosohltan	nos hltan
nosoretní	nos ret
novoázerbájdžánština	nový ázerbájdžánština
novočeský	nový český
novopečený	nový péci
novoplatónský	nový Platón
novostavba	nový stavba
novostrašecký	nový Strašecí
nudapláž	nudistický pláž
obrátkoměr	obrátka měřit
ocelolitina	ocel litina
ochlokracie	-ochl- -krat-
odsouzeníhodný	odsouzení hodný
okohybný	oko hýbat
okolojdoucí	okolo jdoucí
okolostojící	okolo stát
oligofág	-olig- -fag-
olivovohřbetý	olivový hřbet
onkohematologie	-onk- hematologie
oposmlouva	opoziční smlouva
opovrženíhodný	opovržení hodný
opozičněkoaliční	opoziční koaliční
opozičněsmluvní	opoziční smlouva
optickomechanický	optický mechanický
optoelektrický	optický elektrický
oranžovobílý	oranžový bílý
oranžovožlutý	oranžový žlutý
orgánotvorný	orgán tvořit
ortostatický	-orth- statický
osteopatie	-oste- -pat-
ostnokožec	osten kůže
ostnovýtrusný	osten výtrus
otáčkoměr	otáčka měřit
otcovražda	otec vražda
ovocnářskozahradnický	ovocnářský zahradnický
oxyhemoglobin	-oxy- hemoglobin
ozonosféra	ozón sféra
paleogeografie	-palai- geografie
paleosom	-palai- -som-
palivoenergetický	palivo energie
palivoměr	palivo měřit
paměťožravý	paměť žravý
panímáma	paní máma
panotypie	-pan- -typ-
pantatík	pan tatík
pantomima	-pant- -mim-
papírodárný	papír dát
paprskomet	paprsek metat
paprskoploutvý	paprsek ploutev
paradivadelní	para divadlo
paralelogram	paralela gram
paravýcvik	parašutistický výcvik
pářeníchtivý	páření chtivý
paropropustný	pára propustný
partnerůchtivý	partner chtivý
patrontaška	patrona taška
pedochemický	-ped- chemický
penězchtivý	peníz chtivý
penězochtivý	peníz chtivý
pěnobeton	pěna beton
pěnosilikát	pěna silikát
pěnotvorný	pěna tvořit
pepsinogen	pepsin -gen-
perianální	-peri- anální
pericholecystitida	-peri- cholecystitida
peripetie	-peri- -pet-
perisperm	-peri- -sperm-
permokarbon	perm karbon
pestrobarevný	pestrý barva
pestrokvětost	pestrý květ
pětiboj	pět boj
pěticent	pět cent
pěticiferný	pět cifra
pěticípý	pět cíp
pětičtvrťový	pět čtvrť
pětidílný	pět díl
pětidobý	pět doba
pětidolar	pět dolar
pětidráhový	pět dráha
pětigramový	pět gram
pětihaléř	pět haléř
pětihlasý	pět hlas
pětikačka	pět kačka
pětikanál	pět kanál
pětikilo	pět kilo
pětikolejný	pět kolej
pětikoruna	pět koruna
pětikřížkový	pět křížek
pětikvalt	pět kvalt
pětilibrový	pět libra
pětilitr	pět litr
pětimužný	pět muž
pětiobráncový	pět obránce
pětiodstavcový	pět odstavec
pětioscarový	pět Oscar
pětiosý	pět osa
pětipaprskový	pět paprsek
pětipásmový	pět pásmo
pětipatrový	pět patro
pětiplatový	pět plat
pětipodlažní	pět podlaží
pětipromilový	pět promile
pětiradličný	pět radlice
pětiramenný	pět rameno
pětiranný	pět rána
pětirozměrný	pět rozměr
pětirozměrový	pět rozměr
pětisériový	pět série
pětisměrný	pět směr
pětistopý	pět stopa
pětistup	pět stoupat
pětitřídka	pět třída
pětituna	pět tuna
pětiválec	pět válec
pětivětý	pět věta
pětizápasový	pět zápas
pětizrnný	pět zrno
pětizubý	pět zub
petrogeneze	-petr- geneze
petrografie	-petr- -graf-
pevninotvorný	pevnina tvořit
pianoforte	piano forte
pidikoupelna	-pidi- koupelna
pigmentotvorný	pigment tvořit
pikolitr	piko litr
pilolistý	pila list
pilořitka	pila řiť
pískovohnědý	pískový hnědý
písmolijec	písmo lijec
písmolijna	písmo lít
písmolitecký	písmolitec
písmomalíř	písmo malíř
písmoznalec	písmo znalec
pivotéka	pivo -thék-
pivovar	pivo vařit
placeníchtivý	placení chtivý
plamenomet	plamen metat
planetografický	planeta grafika
plastbeton	plast beton
plastickochirurgický	plastický chirurgie
plavošedivý	plavý šedivý
plavuňotvarý	plavuň tvar
plazmagen	plazma -gen-
plazopánvý	plaz pánev
plesňákotvarý	plesňák tvar
plesnivkotvarý	plesnivka tvar
pleuroperikarditida	pleura perikarditida
plnohlasí	plný hlas
plochozubý	plochý zub
plodonoš	plod nést
ploskohlavý	ploský hlava
ploskolebý	ploský leb
ploskonohý	ploský noha
ploutvonožec	ploutev noha
plynárenskoenergetický	plynárenský energetický
plynočistírna	plyn čistírna
plynodynamický	plyn dynamický
plynoinstalace	plyn instalace
plynosilikát	plyn silikát
plynotěsný	plyn těsný
plynožárný	plyn žár
pneumatolýza	-pneu- -ly-
podnikohospodářský	podnik hospodářský
pojmosloví	pojem slovo
pokladotvorný	poklad tvořit
politickobezpečnostní	politický bezpečnost
politickopolicejní	politický policejní
politickovýrobní	politický výrobní
poloadministrativní	půl administrativní
poloagrární	půl agrární
poloakustický	půl akustický
poloamatér	půl amatér
poloanarchistický	půl anarchistický
poloanonymní	půl anonymní
poloarénový	půl arénový
poloartikulovaný	půl artikulovaný
poloasketický	půl asketický
poloautobiografický	půl autobiografický
poloautomat	půl automat
poloautomatický	půl automatický
poloautomatizovat	půl automatizovat
poloautonomní	půl autonomní
poloautoritářský	půl autoritářský
poloautoritativní	půl autoritativní
polobahnitý	půl bahnitý
polobáječný	půl báječný
polobalada	půl balada
polobarbar	půl barbar
polobarevný	půl barevný
polobdělý	půl bdělý
polobdít	půl bdít
polobedna	půl bedna
polobělený	půl bělený
polobeletristický	půl beletristický
polobezdomovec	půl bezdomovec
polobezvědomí	půl bezvědomí
polobílený	půl bílený
poloblakeový	půl blakeový
poloblázen	půl blázen
polobláznivý	půl bláznivý
poloblb	půl blb
poloblbě	půl blbě
poloblbý	půl blbý
polobohatý	půl bohatý
polobohyně	půl bohyně
polobolševický	půl bolševický
polobotka	půl bota
polobožský	půl božský
polobrácha	půl brácha
polobráška	půl bráška
polobratr	půl bratr
polobřevno	půl břevno
polobudka	půl budka
polobůh	půl bůh
polobulvár	půl bulvár
polobulvární	půl bulvární
polobuničina	půl buničina
poločas	půl čas
poločerný	půl černý
poločesaný	půl česaný
poločeský	půl český
polochcípák	půl chcípák
polochcíplý	půl chcíplý
polochemický	půl chemický
polocírkevní	půl církevní
poločíselný	půl číselný
poločistit	půl čistit
polocivilista	půl civilista
polocivilizovaný	půl civilizovaný
polocizopasný	půl cizopasný
poločlánek	půl článek
poločlověk	půl člověk
poločokoládový	půl čokoládový
polocukrářský	půl cukrářský
polocukrovka	půl cukrovka
polodebilní	půl debilní
polodeklamující	půl deklamující
polodemokratický	půl demokratický
polodenní	půl denní
polodetail	půl detail
polodětský	půl dětský
polodevastovaný	půl devastovaný
polodezertér	půl dezertér
polodiktátor	půl diktátor
polodisident	půl disident
polodivočák	půl divočák
polodivoký	půl divoký
polodlouhosrstý	půl dlouhosrstý
polodlouhý	půl dlouhý
polodokumentární	půl dokumentární
polodospělý	půl dospělý
polodotykový	půl dotykový
polodrahokam	půl drahokam
polodrahý	půl drahý
polodrážka	půl drážka
polodrážkovník	půl drážkovník
polodřevěný	půl dřevěný
polodřevitý	půl dřevitý
polodřímota	půl dřímota
poloduplex	půl duplex
polodutina	půl dutina
polodužnatý	půl dužnatý
poloekonomický	půl ekonomický
poloeliptický	půl eliptický
polofabrikát	půl fabrikát
polofáma	půl fáma
polofantastický	půl fantastický
polofantazijní	půl fantazijní
polofašistický	půl fašistický
polofermentovaný	půl fermentovaný
polofeudální	půl feudální
polofinále	půl finále
polofolklórní	půl folklórní
pologangster	půl gangster
pologenius	půl genius
pologénius	půl génius
pologeometrický	půl geometrický
pologramotný	půl gramotný
polohad	půl had
polohedvábí	půl hedvábí
polohedvábný	půl hedvábný
poloherec	půl herec
polohermetický	půl hermetický
polohistorický	půl historický
polohladový	půl hladový
polohlas	půl hlas
polohlasitý	půl hlasitý
polohláska	půl hláska
polohod	půl hod
polohoměr	poloha měřit
polohořký	půl hořký
polohoror	půl horor
polohospůdka	půl hospůdka
polohotový	půl hotový
polohraněný	půl hraněný
polohraný	půl hraný
polohrubý	půl hrubý
polohustý	půl hustý
poloilegální	půl ilegální
poloimitace	půl imitace
polointegrální	půl integrální
polointeligence	půl inteligence
polointeligent	půl inteligent
polointeligentní	půl inteligentní
poloironický	půl ironický
poloizolátor	půl izolátor
polojámový	půl jámový
polojasný	půl jasný
polojemnovlnný	půl jemnovlnný
polojemný	půl jemný
polojezevčice	půl jezevčice
polokancelářský	půl kancelářský
polokanton	půl kanton
polokapalinný	půl kapalinný
polokapotáž	půl kapotáž
polokapotový	půl kapotový
polokarakul	půl karakul
polokartón	půl kartón
polokaskáda	půl kaskáda
polokatolický	půl katolický
polokavárna	půl kavárna
polokecka	půl kecka
polokeř	půl keř
poloklabonosý	půl klabonosý
polokmen	půl kmen
polokočovný	půl kočovný
polokoks	půl koks
polokolonie	půl kolonie
polokomedie	půl komedie
polokomik	půl komik
polokomisař	půl komisař
polokomunistický	půl komunistický
polokonfekce	půl konfekce
polokonzerva	půl konzerva
polokopec	půl kopec
polokoule	půl koule
polokov	půl kov
polokožený	půl kožený
polokramářský	půl kramářský
polokřeslo	půl křeslo
polokrevný	půl krevný
polokřídlo	půl křídlo
polokrotký	půl krotký
polokrovka	půl krovka
polokruh	půl kruh
polokružný	půl kružný
polokrvavý	půl krvavý
polokrycí	půl krycí
polokrytý	půl krytý
polokulatý	půl kulatý
polokupé	půl kupé
polokupónový	půl kupónový
polokurzíva	půl kurzíva
polokůže	půl kůže
polokvadrát	půl kvadrát
polokvalifikovaný	půl kvalifikovaný
polokvantitativní	půl kvantitativní
polokybernetický	půl kybernetický
pololán	půl lán
pololegální	půl legální
pololegendární	půl legendární
pololesklý	půl lesklý
pololežet	půl ležet
pololidový	půl lidový
pololidský	půl lidský
pololiterární	půl literární
pololněný	půl lněný
polomáčený	půl máčený
polomafián	půl mafián
polomaketa	půl maketa
polomaska	půl maska
polomastný	půl mastný
polomatný	půl matný
polomechanický	půl mechanický
polomechanizovat	půl mechanizovat
poloměkký	půl měkký
polomený	lomený
poloměr	půl měřit
poloměsíčitý	půl měsíčitý
poloměstský	půl městský
polomluvený	půl mluvený
polomocnář	půl mocnář
polomontovat	půl montovat
polomoučný	půl moučný
polomražený	půl mražený
polomrtvý	půl mrtvý
polomyšlenka	půl myšlenka
polomystický	půl mystický
polomytický	půl mytický
polonáborový	půl náborový
polonáboženský	půl náboženský
polonahota	půl nahota
polonahý	půl nahý
polonáprava	půl náprava
polonaturalistický	půl naturalistický
polonemocniční	půl nemocniční
polonemocný	půl nemocný
polonepřítel	půl nepřítel
polonofil	-polon- -fil-
polonosný	půl nosný
polonovinářský	půl novinářský
polonudný	půl nudný
poloobjímavý	půl objímavý
poloobklíčený	půl obklíčený
polooblačný	půl oblačný
poloobléci	půl obléci
polooblouk	půl oblouk
polooblý	půl oblý
poloobnažit	půl obnažit
poloobr	půl obr
poloobrat	půl obrat
poloobruba	půl obruba
poloobsazený	půl obsazený
poloobydlený	půl obydlený
poloochočený	půl ochočený
poloochrnout	půl ochrnout
poloodborářský	půl odborářský
poloodborný	půl odborný
polooděný	půl oděný
poloodhalený	půl odhalený
poloodkrýt	půl odkrýt
poloodkvetlý	půl odkvetlý
poloodpovědný	půl odpovědný
poloodrostek	půl odrostek
poloodtah	půl odtah
polooficiální	půl oficiální
polookruh	půl okruh
poloopadaný	půl opadaný
poloopadavý	půl opadavý
poloopečený	půl opečený
poloopice	půl opice
poloopičí	půl opičí
poloopilý	půl opilý
poloopovážlivý	půl opovážlivý
poloopozice	půl opozice
poloopravený	půl opravený
polooptimistický	půl optimistický
poloopuštěný	půl opuštěný
poloosa	půl osa
poloosel	půl osel
poloosleplý	půl osleplý
poloostrov	půl ostrov
poloostrý	půl ostrý
polootevřít	půl otevřít
polootrávený	půl otrávený
polootrok	půl otrok
polootrokářský	půl otrokářský
polootupět	půl otupět
polootužit	půl otužit
polopancéřovaný	půl pancéřovaný
polopancíř	půl pancíř
polopapírový	půl papírový
poloparazit	půl parazit
poloparlament	půl parlament
poloparuka	půl paruka
polopás	půl pás
polopásák	půl pásák
polopatro	půl patro
polopečený	půl pečený
polopenze	půl penze
polopergamen	půl pergamen
polopermanentní	půl permanentní
poloperníkářský	půl perníkářský
poloperzián	půl perzián
poloplášť	půl plášť
poloplastický	půl plastický
poloplátěný	půl plátěný
poloplazivý	půl plazivý
poloplný	půl plný
poloplstěný	půl plstěný
poloplynový	půl plynový
polopodzemní	půl podzemní
polopohádkový	půl pohádkový
polopohanský	půl pohanský
polopolitický	půl politický
polopolitik	půl politik
poloponorka	půl ponorka
poloponorný	půl ponorný
poloportálový	půl portálový
polopostava	půl postava
polopoušť	půl poušť
polopozdní	půl pozdní
polopracovní	půl pracovní
polopravda	půl pravda
polopravdivý	půl pravdivý
polopravidelný	půl pravidelný
polopravý	půl pravý
poloprázdný	půl prázdný
polopřevod	půl převod
poloprezident	půl prezident
polopříjemný	půl příjemný
polopřiléhavý	půl přiléhavý
polopřímka	půl přímka
polopřímý	půl přímý
polopřipravený	půl připravený
polopřírodní	půl přírodní
polopřirozený	půl přirozený
poloprivatizace	půl privatizace
poloprivátní	půl privátní
polopřívěs	půl přívěs
poloprodukt	půl produkt
poloprofesionál	půl profesionál
poloprofil	půl profil
poloproletář	půl proletář
poloproletariát	půl proletariát
polopropečený	půl propečený
polopropustný	půl propustný
poloprostor	půl prostor
poloprovoz	půl provoz
poloprůběžný	půl průběžný
poloprůhledný	půl průhledný
poloprůmyslový	půl průmyslový
poloprůsvitný	půl průsvitný
poloracionální	půl racionální
polorafinovat	půl rafinovat
poloranný	půl ranný
poloraný	půl raný
polorealistický	půl realistický
poloreálný	půl reálný
poloreforma	půl reforma
polořeholní	půl řeholní
poloreliéf	půl reliéf
poloreportáž	půl reportáž
polorevolucionářský	půl revolucionářský
polořezník	půl řezník
polorituální	půl rituální
polořízený	půl řízený
poloromský	půl romský
poloroubený	půl roubený
polorovina	půl rovina
polorozbitý	půl rozbitý
polorozbořený	půl rozbořený
polorozbouraný	půl rozbouraný
polorozbředlý	půl rozbředlý
polorozepnutý	půl rozepnutý
polorozevřený	půl rozevřený
polorozkazovačný	půl rozkazovačný
polorozpadnout	půl rozpadnout
polorozsypaný	půl rozsypaný
poloroztát	půl roztát
polorozvalený	půl rozvalený
polorozvitý	půl rozvitý
poloruina	půl ruina
polorůžový	půl růžový
polorybářský	půl rybářský
polorytmika	půl rytmika
polosamočinný	půl samočinný
polosamohláska	půl samohláska
polosamosprávný	půl samosprávný
polosamostatný	půl samostatný
polosamota	půl samota
poloscénický	půl scénický
polosed	půl sed
polosedět	půl sedět
polosen	půl sen
polosenzace	půl senzace
pološerý	půl šerý
poloshnilý	půl shnilý
pološikmý	půl šikmý
pološílený	půl šílený
pološipka	půl šipka
polosirota	půl sirota
polosirotek	půl sirotek
poloskalní	půl skalní
poloskleněný	půl skleněný
pološkola	půl škola
poloskořepinový	půl skořepinový
pološkraboškový	půl škraboškový
poloslabý	půl slabý
polosladký	půl sladký
poloslaný	půl slaný
poloslepený	půl slepený
poloslepý	půl slepý
poloslinutý	půl slinutý
polosloup	půl sloup
polosmrt	půl smrt
polosnění	půl snění
polosocializmus	půl socializmus
polosoukromý	půl soukromý
polospálený	půl spálený
polospánek	půl spánek
polospát	půl spát
polospojka	půl spojka
polosportovní	půl sportovní
polostabilní	půl stabilní
polostátní	půl státní
polostep	půl step
polostín	půl stín
polostinný	půl stinný
polostínovat	půl stínovat
polostřela	půl střela
polostrmý	půl strmý
polostrojní	půl strojní
polostrom	půl strom
polostrunatec	půl strunatec
polostudentský	půl studentský
polosuchý	půl suchý
polosuverénní	půl suverénní
polosvéprávný	půl svéprávný
pološvestka	půl švestka
polosvět	půl svět
polosvětlo	půl světlo
polosvětlý	půl světlý
polosvit	půl svit
polosvlečený	půl svlečený
polosvobodný	půl svobodný
polosykavka	půl sykavka
polosyntetický	půl syntetický
polosyrový	půl syrový
polosytý	půl sytý
polotajný	půl tajný
polotekutý	půl tekutý
polotemný	půl temný
poloteplý	půl teplý
poloterénní	půl terénní
poloteroristický	půl teroristický
polotěžký	půl těžký
polotma	půl tma
polotmářský	půl tmářský
polotmavý	půl tmavý
polotón	půl tón
polotónovat	půl tónovat
polototalitní	půl totalitní
polotovar	půl tovar
polotovární	půl tovární
polotransparentní	půl transparentní
polotrikot	půl trikot
polotržní	půl tržní
polotučný	půl tučný
polotuhý	půl tuhý
polotvar	půl tvar
polotvrdý	půl tvrdý
polotyp	půl typ
poloudušený	půl udušený
polouklidnit	půl uklidnit
poloumělý	půl umělý
polounciála	půl unciála
poloupečený	půl upečený
poloúřední	půl úřední
poloúřednický	půl úřednický
polousedlý	půl usedlý
poloúsměv	půl úsměv
poloústava	půl ústava
poloutajený	půl utajený
poloutopený	půl utopený
polouvozí	půl úvoz
polouzavřít	půl uzavřít
polovalba	půl valba
poloválcovitý	půl válcovitý
poloválcový	půl válcový
poloválečný	půl válečný
polovánoční	půl vánoční
polovážný	půl vážný
polovečerní	půl večerní
polovědec	půl vědec
polovědomý	půl vědomý
polovegetační	půl vegetační
polověnec	půl věnec
poloveřejný	půl veřejný
poloverš	půl verš
polovětný	půl větný
polovězeňský	půl vězeňský
polovládní	půl vládní
polovlastní	půl vlastní
polovlhký	půl vlhký
polovlna	půl vlna
polovlněný	půl vlněný
polovodič	půl vodič
polovodivý	půl vodivý
polovodní	půl vodní
polovoják	půl voják
polovojenský	půl vojenský
polovrak	půl vrak
polovychladlý	půl vychladlý
polovydláždit	půl vydláždit
polovyjádření	půl vyjádření
polovymřelý	půl vymřelý
polovypálený	půl vypálený
polovyprodaný	půl vyprodaný
polovypuklý	půl vypuklý
polovýrobek	půl výrobek
polovyschlý	půl vyschlý
polovysokoškolský	půl vysokoškolský
polovysoký	půl vysoký
polovyšumělý	půl vyšumělý
polovysychavý	půl vysychavý
polovzdělanecký	půl vzdělanecký
polovzdělaný	půl vzdělaný
polovzpřímený	půl vzpřímený
polozadlabaný	půl zadlabaný
polozadušený	půl zadušený
polozahloubený	půl zahloubený
polozakázaný	půl zakázaný
polozakázkový	půl zakázkový
polozakrýt	půl zakrýt
polozaměstnaný	půl zaměstnaný
polozapadnout	půl zapadnout
polozaplněný	půl zaplněný
polozapomenutý	půl zapomenutý
polozapuštěný	půl zapuštěný
polozasklený	půl zasklený
polozastíněný	půl zastíněný
polozasypat	půl zasypat
polozataženo	půl zataženo
polozávěrový	půl závěrový
polozávislý	půl závislý
polozávodní	půl závodní
polozavřený	půl zavřený
polozazděný	půl zazděný
polozborcený	půl zborcený
polozbořený	půl zbořený
polozdevastovaný	půl zdevastovaný
polozdivočelý	půl zdivočelý
polozdravý	půl zdravý
polozednářský	půl zednářský
položelatina	půl želatina
polozemnice	půl zemnice
položertovný	půl žertovný
polozhroucený	půl zhroucený
položidovka	půl židovka
položivočišný	půl živočišný
polozkamenělý	půl zkamenělý
polozkažený	půl zkažený
polozmražený	půl zmražený
polozmrzačit	půl zmrzačit
polozmrzlý	půl zmrzlý
polozpěv	půl zpěv
polozraněný	půl zraněný
polozrát	půl zrát
polozrcadlovka	půl zrcadlovka
polozřícený	půl zřícený
polozrůda	půl zrůda
polozrůdička	půl zrůdička
poloztracený	půl ztracený
poloztužený	půl ztužený
polozvířecí	půl zvířecí
polpotovský	Pol Pot
polyaromatický	-poly- aromatický
polyester	-poly- ester
polygenetický	-poly- genetický
polygynie	-poly- -gyn-
polykarbamát	-poly- karbamát
polyreakce	-poly- reakce
polysylogizmus	-poly- sylogizmus
pophvězda	pop hvězda
popkultura	pop kultura
popmusic	pop music
poprock	pop rock
popstar	pop star
pórobeton	pór beton
potravychtivý	potrava chtivý
povahopis	povaha psát
pozitivněprávní	pozitivní právo
pramenověda	pramen věda
právněinformatický	právní informatický
právněpozitivistický	právní pozitivismus
pravobok	pravý bok
pravolevý	pravý levý
právotvorný	právo tvořit
prdelolezec	prdel lezec
předovýchodní	přední východ
přímotažný	přímý tažný
přírodopis	příroda psát
produktovod	produkt vést
projekčněkonstrukční	projekční konstrukční
propanbutan	propan butan
protohvězda	-prot- hvězda
protonotář	-prot- notář
pršiplášť	pršet plášť
prskolet	prskat let
prvočinitel	prvý činitel
prvodárce	prvý dárce
prvořadý	prvý řada
prvorozený	prvý rozený
prvosenkotvarý	prvosenka tvar
prvovýstup	prvý výstup
pryskyřníkokvětý	pryskyřník květ
pryžotextilní	pryž textil
psovod	pes vodit
psychoanalitický	-psych- analytický
psychopatologie	-psych- -path- -log-
psychothriller	-psych- thriller
ptákotrh	pták trh
půdoznalec	půda znalec
punčechtivý	punč chtivý
punkrock	punk rock
puškohled	puška hledět
pyrovůz	-pyr- vůz
radioaktivní	radio aktivní
radioamatér	radio amatér
radioanalytický	radio analytický
radioanténa	radio anténa
radioaparát	radio aparát
radiobazar	radio bazar
radiobudík	radio budík
radioburza	radio burza
radiocentrum	radio centrum
radiochemie	radio chemie
radiochirurgie	radio chirurgie
radiodálnopis	radio dálnopis
radiodárek	radio dárek
radiodepeše	radio depeše
radiodispečink	radio dispečink
radiodraslík	radio draslík
radioelektrický	radio elektrický
radiofarmakum	radio farmakum
radiofrekvence	radio frekvence
radiofyzik	radio fyzik
radiogalaxie	radio galaxie
radiografie	radio -graf-
radiohodinky	radio hodinky
radiohygienický	radio hygienický
radioinženýrský	radio inženýrský
radioklub	radio klub
radiokompas	radio kompas
radiokomunikace	radio komunikace
radioléčba	radio léčba
radioluminiscence	radio luminiscence
radiomaják	radio maják
radiomateriál	radio materiál
radiomechanik	radio mechanik
radiomodem	radio modem
radiomrakodrap	radio mrakodrap
radionahrávka	radio nahrávka
radionavigace	radio navigace
radionuklid	radio nuklid
radiooperatér	rádio operatér
radiooperátor	radio operátor
radiopotřeba	radio potřeba
radiopřehrávač	radio přehrávač
radiopřijímač	radio přijímač
radiopřístroj	radio přístroj
radioprovoz	radio provoz
radiosaturační	radio saturace
radiosignál	radio signál
radiosíť	radio síť
radiosonda	rádio sonda
radiospoj	rádio spoj
radiospojení	radio spojení
radiostanice	radio stanice
radiosterilace	radio sterilace
radiotaxi	radio taxi
radiotechnika	radio technika
radiotelegraf	radio telegraf
radiotelegraficky	radiotelegrafický
radiotelegrafní	radio telegrafní
radiotelekomunikace	radio telekomunikace
radiotelemetrie	radio telemetrie
radiotelevizní	radio televizní
radioterapie	radio terapie
radiotext	radio text
radiouhlík	radio uhlík
radioulnární	radio ulnární
radiovelkoobchod	radio velkoobchod
radiovlna	radio vlna
radiovůz	radio vůz
radiovybavení	radio vybavení
radiovysílačka	radio vysílačka
radiozařízení	radio zařízení
radiožurnál	radio žurnál
rádobypolitik	rádoby politika
rádobyspiklenecký	rádoby spiklenecký
rádobyzasvěcený	rádoby zasvěcený
raketomet	raketa metat
ramenonožec	rameno noha
raněstředověký	raný středověk
ranhojič	rána hojit
rautuchtivý	raut chtivý
redoxní	redukční oxidační
reflektormetr	reflektor -metr-
reflexoterapie	reflex terapie
rentgenoterapie	rentgen terapie
reprobedna	repro bedna
reprokamera	repro kamera
reprotechnika	repro technika
retroohlédnutí	retro ohlédnutí
révokaz	réva kazit
římskoapoštolský	římský apoštolský
římskopapežský	římský papež
římskoprávní	římský právo
říšskoněmecký	říše německý
řiťolezectví	řiť lezectví
rovnoramenný	rovný rameno
rovnoúhelník	rovný úhel
rubopis	rub psát
rudobílý	rudý bílý
rudočerný	rudý černý
rudočervenozelený	rudý červený zelený
rudodřevitý	rudý dřevitý
rudohlavý	rudý hlava
rudohnědý	rudý hnědý
rudohoří	rudý hora
rudokožec	rudý kůže
rudokrký	rudý krk
rudomodrobílý	rudý modrý bílý
rudonohý	rudý noha
rudonosný	ruda nést
rudovlasý	rudý vlas
rudozelený	rudý zelený
rudozlatý	rudý zlatý
rukulíbat	ruka líbat
rumuchtivý	rum chtivý
různotvarý	různý tvar
různozubý	různý zub
růžovočervený	růžový červený
růžovomodrý	růžový modrý
rychloautobus	rychlý autobus
rychlobruslit	rychle bruslit
rychločistírna	rychlý čistírna
rychločlun	rychlý člun
rychloinženýr	rychlý inženýr
rychlokresba	rychlý kresba
rychlokurs	rychlý kurs
rychlokurz	rychlý kurz
rychlokvíz	rychlý kvíz
rychlolezení	rychlý lezení
rychloměr	rychlý měřit
rychloobčerstvení	rychlý občerstvení
rychlopoma	rychlý poma
rychloportrét	rychlý portrét
rychloposun	rychlý posun
rychloprádelna	rychlý prádelna
rychlopraní	rychlý praní
rychlopřesun	rychlý přesun
rychlosoustružník	rychlý soustružník
rychlotest	rychlý test
rychlotrať	rychlý trať
rychloturnaj	rychlý turnaj
sadomasochista	sadomasochismus
sadovnickokrajinářský	sadovnický krajinářský
sádrovláknina	sádra vláknina
sametonohý	samet noha
saúdskoarabský	saudský Arábie
šavlorohý	šavle roh
šavlozubý	šavle zub
sbírkotvorný	sbírka tvořit
schodolez	schod lézt
scintigrafie	-scinti- -graf-
šedivočerný	šedivý černý
sedmasedmdesátiletý	sedm sedmdesát léto
šedobíločerný	šedý bílý černý
šedobílý	šedý bílý
šedočernobílý	šedý černý bílý
šedočerný	šedý černý
šedočervenočerný	šedý červený černý
šedohnědočerný	šedý hnědý černý
šedohnědý	šedý hnědý
šedolistý	šedý list
šedomodrozelený	šedý modrý zelený
šedomodrý	šedý modrý
šedooký	šedý oko
šedosemenný	šedý semeno
šedovlasý	šedý vlas
šedovousý	šedý vous
šedozelenkavý	šedý zelenkavý
šedozelenohnědý	šedý zelený hnědý
šedozelený	šedý zelený
šedožlutozelený	šedý žlutý zelený
šedožlutý	šedý žlutý
šéfdovozce	šéf dovozce
šéfkomentátor	šéf komentátor
šéfkouzelník	šéf kouzelník
šéfkreslič	šéf kreslič
šéflektor	šéf lektor
šéfodborář	šéf odborář
šéfpořadatel	šéf pořadatel
šéfporadce	šéf poradce
šéfředitel	šéf ředitel
šéfreportér	šéf reportér
selenocentrický	selen centrický
selenokyanatan	selen kyanatan
selenouhličitan	selen uhličitan
semiaktivní	-semi- aktivní
semitohamitský	semita hamita
semtam	sem tam
seniorpas	senior pas
senoseč	seno sekat
senovážný	seno vozit
senzacechtivý	senzace chtivý
senzomotorický	senzor motorický
šerozelený	šerý zelený
sestrovrah	sestra vrah
sestrovražedkyně	sestrovrah
sestrovražedný	sestra vražda
severoíránský	severní Irán
severokambodžský	severní Kambodža
severokarpatský	severní Karpaty
severonigerijský	severní Nigérie
severorakouský	severní Rakousko
severoseverozápad	sever severozápad
severosomálský	severní Somálsko
severošpanělský	severní Španělsko
severošvýcarský	severní Švýcarkso
severotádžický	sever tádžický
severozápad	sever západ
sexyhrátky	sexy hrátky
sexyklip	sexy klip
sierraleonský	Sierra Leone
šikmooký	šikmý oko
silikotuberkulóza	-silik- tuberkulóza
silnoproud	silný proud
siloměr	síla měřit
silostroj	síla stroj
singltrek	single trek
sinovietnamský	-sin- vietnamský
šípolistý	šíp list
síranouhličitý	síran uhličitý
síranovzdorný	síran vzdorný
širohřbetý	širý hřbet
širopustý	širý pustý
široširý	širý širý
sítinokvětý	sítina květ
sivozelený	sivý zelený
skálopevný	skála pevný
sklokeramika	sklo keramika
sklolaminát	sklo laminát
sklomalba	sklo malba
sklonoměr	sklon měřit
sklotextilní	sklo textilní
sklovitráž	sklo vitráž
sklovláknitý	sklo vláknitý
školkychtivý	školka chtivý
skorodospělý	skoro dospělý
skorokandidát	skoro kandidát
skorovrah	skoro vrah
škrabopis	škrábat psát
škrtovláda	škrt vláda
skrznaskrz	skrz skrz
slaboduchý	slabý duch
slaboproud	slabý proud
sladkéhochtivý	sladký chtivý
sladkolistý	sladký list
sladkopálivý	sladký pálivý
sladkoplodý	sladký plod
slanorožec	slaný roh
šlechtovláda	šlechta vláda
slepohluchý	slepý hluchý
slizotvorný	sliz tvořit
slohotvorný	sloh tvořit
slovnědruhový	slovní druh
sluchovod	sluch vést
slunoměr	slunce měřit
slunovrat	slunce vracet
slzopudný	slza pudit
slzotvorný	slza tvořit
slzovod	slza vést
směrodatný	směr dát
šmirglpapír	šmirgl papír
smluvněopoziční	smluvní opozice
smrtihlav	smrt hlava
smrtonoš	smrt nosit
smrtonosný	smrt nosit
smutnohra	smutný hra
smutnokrásný	smutný krásný
smutnooký	smutný oko
smutnoveselý	smutný veselý
smyslotvorný	smysl tvořit
sněhuprostý	sníh prostý
socdemák	sociální demokrat
sodnodraselný	sodný draselný
sodnovápenatý	sodný vápenatý
solivar	sůl vařit
sólohráč	sólo hráč
sólokampaň	sólo kampaň
sólokapr	sólo kapr
sólovýstup	sólo výstup
sotvakdy	sotva kdy
spásonosný	spása nosit
spásotvorný	spása tvořit
spastickoparetický	spastický paretický
špekbuřt	špek buřt
spermobanka	sperma banka
spodnodevonský	spodní Devon
společenskokulturní	společenský kultura
společenskotřídní	společenský třída
spolubydlící	spolu bydlící
spolufarník	spolu farník
spoluinvestice	spolu investice
spolukontrolovat	spolu kontrolovat
spolumluvčí	spolu mluvčí
spolumukl	spolu mukl
spolupartajník	spolu partajník
spolupatřičnost	spolupatřičný
spolupoutník	spolu poutník
spolupředsedat	spolu předsedat
spoluředitel	spolu ředitel
spolusedící	spolu sedící
spolusignatář	spolu signatář
spolutrpící	spolu trpící
spoluúčastnit	spolu účastnit
spoluužívat	spolu užívat
spolužadatel	spolu žadatel
sportareál	sport areál
sportbar	sport bar
sportregion	sport region
sprintrallye	sprint rallye
sprostonárodní	sprostý národní
sralbotka	srát botka
srážkoměr	srážka měřit
srdcolistý	srdce list
šrotuchtivý	šrot chtivý
staroasyrský	starý Asýrie
starohory	starý hora
staromódní	starý móda
staromoravský	starý Morava
starořeč	starý řeč
startrekovský	star trek
státohrad	stát hrad
stavbychtivý	stavba chtivý
stavbyvedoucí	stavba vedoucí
stávkokaz	stávka kazit
stejnohlasý	stejný hlas
stejnokroj	stejný kroj
stejnonožec	stejný noha
stejnopis	stejný psát
stejnoplochý	stejný plocha
stejnorodý	stejný rod
stejnotvarý	stejný tvar
stereobrýle	-stereo- brýle
štěrkodrť	štěrk drť
štěrkopísek	štěrk písek
štětinolistý	štětina list
stihomam	stíhat mámit
stínoherní	stínohra
stínohra	stín hra
stínomalba	stín malba
stínovládní	stínový vláda
stmelováníchtivý	stmelování chtivý
stopstav	stop stav
stoptlačítko	stop tlačítko
středoasijský	střední Asie
středoatlantský	střední Atlantik
středoaustralský	střední Austrálie
středoevropský	střední Evropa
středomoravský	střední Morava
středooceánický	střed oceán
středooceánský	střed oceán
středoopavský	střední Opava
středozairský	střední Zair
střelbychtivý	střelba chtivý
střelhbitý	střela hbitý
střelolistý	střela list
stříbřitonohý	stříbřitý noha
stříbrnobílý	stříbrný bílý
stříbrobílý	stříbrný bílý
stříbronosný	stříbro nést
stříbrorudný	stříbrný ruda
stříbrovlasý	stříbrný vlas
střihoruký	stříhat ruka
strojopis	stroj psát
strojvedoucí	stroj vedoucí
stromořadí	strom řada
strukturogram	struktura gram
struskotvorný	struska tvořit
studiachtivý	studium chtivý
styluchtivý	styl chtivý
štýrskohradecký	štýrský Hradec
suchokvět	suchý květ
superoyal	super royal
svatoanežský	svatý Anežka
svatokrádež	svatý krádež
svatostánek	svatý stánek
svatováclavský	svatý Václav
svatvečer	svatý večer
světlobojný	světlo bát
světoběžný	svět běhat
světočára	svět čára
světovládce	svět vládce
svezeníchtivý	svezení chtivý
svijonožec	svinout noha
svinoústý	svinout ústa
svítiplyn	svítit plyn
symfonickodramatický	symfonický dramatický
tachypnoe	-tachy- -pneu-
tajnokřídlý	tajný křídlo
takřečený	tak řečený
tamhletudy	tamhle tudy
tamtudy	tam tudy
technickoekonomický	technický ekonomický
technickohospodářský	technický hospodářský
technickoinženýrský	technický inženýrský
technickoobchodní	technický obchod
technickoorganizační	technický organizační
technickovýrobní	technický výroba
technikychtivý	technika chtivý
technodiktatura	-techn- diktatura
technofestival	-techn- festival
technogerontologie	-techn- gerontologie
technohudba	-techn- hudba
technokultura	-techn- kultura
technorytmus	-techn- rytmus
technoscéna	-techn- scéna
technosféra	-techn- sféra
technotaneční	-techn- taneční
technověda	-techn- věda
tektogramatický	-tekt- -gram-
telekonto	-tel- konto
telemagnát	-tel- magnát
telemetrie	-tel- -metr-
telepatie	-tel- -pat-
telesoutěž	-tel- soutěž
tellurokyanatan	tellur kyanatan
tellurouhličitan	tellur uhličitan
tělokresba	tělo kresba
tělověda	tělo věda
temnopásý	temný pás
temporytmus	tempo rytmus
tenkolistý	tenký list
terčoplodý	terč plod
termostabilní	-therm- stabilní
termoventilátor	-therm- ventilátor
terraformovat	terra formovat
těsnopis	těsný psát
tetraethylplumbium	-tetra- -ethyl- plumbum
tetraetylolovo	-tetra- etyl olovo
tetramethylolovo	-tetra- methyl olovo
tetrapropylenbenzensulfonan	-tetra- propylen benzen sulfonan
těžkoatletický	těžký atletika
těžkotonážní	těžký tonáž
thiosiřičitan	-thi- siřičitan
titanzinek	titan zinek
tlakotěsný	tlak těsný
tlakovodní	tlak voda
tlakovzdušný	tlak vzduch
tlustonohý	tlustý noha
tlustopis	tlustý psát
tlustoretý	tlustý ret
tlustorohý	tlustý roh
tlustozobý	tlustý zobák
tmavohřbetý	tmavý hřbet
tmavokvětý	tmavý květ
tmavolistý	tmavý list
tmavoocasý	tmavý ocas
tmavosemenný	tmavý semeno
tmavovýtrusý	tmavý výtrus
tracheobakterióza	trachea bakterie
tracheomykóza	trachea mykóza
trafostanice	trafo stanice
tragikomedie	tragický komedie
transavantgarda	-trans- avantgarda
třasořitka	třást řiť
trihydrogenfosforečný	-tri- hydrogen fosforečný
trihydroxypurin	-tri- -hydroxy- purin
trihydroxypyrimidin	-tri- -hydroxy- pyrimidin
trnkobraní	trnka brání
trnobřichý	trn břicho
trombolýza	-tromb- -ly-
trubkonosý	trubka nosit
truchlohra	truchlit hra
trucsenát	truc senát
trucvolba	truc volba
trypsinogen	trypsin gen
tukoměr	tuk měřit
tukuprostý	tuk prostý
turbokartáč	-turb- kartáč
tvarosloví	tvar slovo
tvorbychtivý	tvorba chtivý
tyranobijec	tyran bijec
tyranotvůrce	tyran tvůrce
úchylkoměr	úchylka měřit
uhlovodík	uhlík vodík
ultramoravista	-ultra- moravista
ultraodstředivka	-ultra- odstředivka
ultraparodie	-ultra- parodie
ultrapokrokový	-ultra- pokrokový
umělokamenný	umělý kámen
umělovýživář	umělý výživa
uměnověda	umění věda
urinoterapie	-ur- terapie
útlocit	útlý cit
úžasuplný	úžas plný
úzkolebý	úzký leb
úzkoletý	úzký létat
úzkolistý	úzký list
úzkoprsý	úzký prs
vakovlk	vak vlk
vápenatoalkalický	vápenatý alkalický
vápenatohořečnatý	vápenatý hořečnatý
vápnobojný	vápno bát
vařeníchtivý	vaření chtivý
vážnohudební	vážný hudba
včelojed	včela jed
vědeckopopulární	vědecký populární
vědosloví	věda slovo
věkošedý	věk šedý
vektografie	vektor -graf-
veleduchý	velký duch
velehřib	velký hřib
velemlok	velký mlok
velepodvrh	velký podvrh
veleproblém	velký problém
veleprojekt	velký projekt
veleproud	velký proud
velikoduchý	veliký duch
velkoaristokracie	velký aristokracie
velkobítešský	velký Bíteš
velkodechý	velký dech
velkodrama	velký drama
velkodrážní	velký dráha
velkodrogerie	velký drogerie
velkodrůbežář	velký drůbežář
velkodrůbežárna	velký drůbežárna
velkoduchý	velký duch
velkofabrika	velký fabrika
velkofarma	velký farma
velkofarmář	velký farmář
velkofilm	velký film
velkofirma	velký firma
velkohit	velký hit
velkohlavý	velký hlava
velkohospodář	velký hospodář
velkohubý	velký huba
velkoklub	velký klub
velkokníže	velký kníže
velkokonzument	velký konzument
velkokříž	velký kříž
velkokřižník	velký křižník
velkonádraží	velký nádraží
velkonájemce	velký nájemce
velkoobchod	velký obchod
velkoobjekt	velký objekt
velkoodběr	velký odběr
velkopěstírna	velký pěstírna
velkoplodý	velký plod
velkoplošný	velký plocha
velkoprádelna	velký prádelna
velkopříběh	velký příběh
velkoprostor	velký prostor
velkoprůměrový	velký průměr
velkoprůmysl	velký průmysl
velkorozpočtový	velký rozpočet
velkosedlák	velký sedlák
velkosklad	velký sklad
velkoskvrnný	velký skvrna
velkostroj	velký stroj
velkosvět	velký svět
velkotěžba	velký těžba
velkoústý	velký ústa
velkovévoda	velký vévoda
velkozrnný	velký zrno
velříše	velký říše
veřejnosprávní	veřejný správa
veřejnozaměstnanecký	veřejný zaměstnanec
věrouka	víra učit
veršomilec	verš milec
větosled	věta sled
větotvorba	věta tvorba
vícefotonový	hodně foton
víceohniskový	hodně ohnisko
víceramenný	hodně rameno
videoadaptér	video adaptér
videoaparát	video aparát
videočip	video čip
videodeník	video deník
videodigitizér	video digitizér
videodisketa	video disketa
videodisplej	video displej
videodriver	video driver
videoeditovat	video editovat
videoefekt	video efekt
videoexpres	video expres
videofestival	video festival
videofikce	video fikce
videofilm	video film
videofotoaparát	video fotoaparát
videohardware	video hardware
videohit	video hit
videohovor	video hovor
videohra	video hra
videoklub	video klub
videokomunikace	video komunikace
videokonektor	video konektor
videokopie	video kopie
videomikrografie	video mikrografie
videomontáž	video montáž
videomost	video most
videonosič	video nosič
videoobvod	video obvod
videoparty	video party
videopirát	video pirát
videopořad	video pořad
videoport	video port
videoportál	video portál
videopošta	video pošta
videopráce	video práce
videopřekryv	video překryv
videopřenos	video přenos
videopřípad	video případ
videopříprava	video příprava
videoprogram	video program
videopromítačka	video promítačka
videoprvek	video prvek
videorozhodčí	video rozhodčí
videoskop	video -skop-
videospektrální	video spektrální
videospojení	video spojení
videostřežení	video střežení
videostřih	video střih
videotip	video tip
videovkus	video vkus
videovstup	video vstup
videovýběr	video výběr
videozáběr	video záběr
videozpráva	video zpráva
vidloroh	vidle roh
vinobraní	víno braní
vínovočerný	vínový černý
vínovočervený	vínový červený
vínovomodrý	vínový modrý
vínovoperleťový	vínový perleťový
viskoelastický	viskózní elastický
vítězosláva	vítěz sláva
vítězoslavit	vítěz slavit
vládněopoziční	vládní opoziční
vlajkonoš	vlajka nosit
vlakotvorba	vlak tvořit
vlakvedoucí	vlak vedoucí
vlastimilovný	vlast milovat
vlastnoruční	vlastní ruka
vlastnoústní	vlastní ústa
vlezprdelka	vlézt prdelka
vlnovlasý	vlna vlas
vlnovod	vlna vést
vnitroafghánský	vnitřní Afghánistán
vnitroafrický	vnitřní Afrika
vnitroamerický	vnitřní Amerika
vnitroarabský	vnitřní Arábie
vnitroasijský	vnitřní Asie
vnitrobankovní	vnitro banka
vnitrobrazilský	vnitřní Brasilie
vnitrobřišní	vnitro břicho
vnitročeský	vnitřní Čechy
vnitrocírkevní	vnitro církev
vnitrodenní	vnitro den
vnitroevropský	vnitřní Evropa
vnitrofiremní	vnitro firma
vnitrofrancouzský	vnitřní Francie
vnitroizraelský	vnitřní Izrael
vnitrojaderný	vnitro jádro
vnitrokorejský	vnitřní Korea
vnitrolebeční	vnitro lebeční
vnitroměstský	vnitro město
vnitroněmecký	vnitřní Německo
vnitropalestinský	vnitřní Palestina
vnitroplicní	vnitro plíce
vnitropražský	vnitřní Praha
vnitropsychický	vnitro psychika
vnitrorakouský	vnitřní Rakousko
vnitrořecký	vnitřní Řecko
vnitroredakční	vnitro redakce
vnitroskandinávský	vnitřní Skandinávie
vnitroslovný	vnitro slovo
vnitrostaveništní	vnitro staveniště
vnitrostruktura	vnitro struktura
vnitrosudetský	vnitřní Sudety
vnitrotělní	vnitro tělo
vnitrozáběrový	vnitro záběr
vnitrozemčan	vnitrozemí
vnitrozemní	vnitro země
vnitrožilní	vnitro žíla
vnitrozření	vnitřní zření
voděodolný	voda odolný
vodostavební	voda stavba
vodotok	voda tok
vojenskoodborný	vojenský odborný
vojenskosprávní	vojenský správa
vojevůdce	voj vůdce
vokalogram	vokál -gram-
volnoběh	volný běh
volnotržní	volný trh
vrubořezba	vrub řezba
vstřícnolistý	vstřícný list
východoafrický	východní Afrika
východoasijský	východní Asie
východoetiopský	východní Etiopie
východoevropský	východní Evropa
východokarpatský	východní Karpaty
východorománský	východní románský
východoslavonský	východní Slavonie
východošvýcarský	východní Švýcarsko
vydřiduch	vydřít duch
vydřigroš	vydřít groš
výrazuplný	výraz plný
výškoměr	výška měřit
výškopis	výška psát
vysokoafinitní	vysoký afinita
vysokoalpský	vysoký Alpy
vysokobřezí	vysoko březí
vysokocenný	vysoký cena
vysokochlumecký	vysoký Chlumec
vysokoenergetický	vysoký energie
vysokonohý	vysoký noha
vysokoobsažný	vysoký obsah
vysokoohmový	vysoký ohm
vysokopecař	vysoký pecař
vysokopříjmový	vysoký příjem
vysokorodný	vysoký rodný
vysokorodý	vysoký rod
vysokorozený	vysoko rozený
vysokotepelný	vysoký teplo
významotvorný	význam tvořit
vzdorokandidát	vzdor kandidát
vzdorokultura	vzdor kultura
vzdoroprezident	vzdor prezident
vzdororepublika	vzdor republika
vzdorovláda	vzdor vláda
vzduchočistící	vzduch čistící
vzduchoelektrický	vzduch elektrický
vzduchomechanický	vzduch mechanický
vzduchoplavba	vzduch plavba
vzduchoprázdný	vzduch prázdný
vzduchotechnika	vzduch technika
vzduchoventilace	vzduch ventilace
vždyzelený	vždy zelený
vždyživý	vždy živý
vzletuchtivý	vzlet chtivý
vzletuplný	vzlet plný
žabikuch	žába kuchat
žabomyší	žába myš
žábronožka	žábra noha
zadnotřebaňský	zadní Třebaň
západoafrický	západní Afrika
západoalpský	západní Alpy
západoalžírský	západ Alžírsko
západoamerický	západní Amerika
západoanglický	západní Anglie
západoargentinský	západní Argentina
západoatlantský	západní Atlanta
západoaustralský	západní Austrálie
západoběloruský	západní Bělorusko
západoberlínský	západní Berlín
západočečenský	západní Čečensko
západočeský	západní Čechy
západočínský	západní Čína
západoevropský	západní Evropa
západofinský	západní Finsko
západofrancký	západní Franky
západofrancouzský	západní Francie
západofranský	západní Franky
západofríský	západní Frísko
západoholandský	západní Holandsko
západoindický	západní Indie
západojaponský	západní Japonsko
západokambodžský	západní Kambodža
západokanadský	západní Kanada
západokarpatský	západní Karpaty
západokorejský	západní Korea
západokrkonošský	západní Krkonoše
západolibyjský	západní Libye
západolondýnský	západní Londýn
západomexický	západní Mexiko
západomongolský	západní Mongolsko
západomoravský	západní Morava
západonilský	západní Nil
západopacifický	západní Pacifik
západopolský	západní Polsko
západorakouský	západní Rakousko
západořímský	západní Řím
západorumunský	západní Rumunsko
západoruský	západní Rusko
západosaharský	západní Sahara
západosarajevský	západní Sarajevo
západosemitský	západní Semita
západosibiřský	západní Sibiř
západoslezský	západní Slezsko
západoslovenský	západní Slovensko
západosomálský	západní Somálsko
západosrbský	západní Srbsko
západosúdánský	západní Súdán
západošvýcarský	západní Švýcarsko
západotatranský	západní Tatry
západotexaský	západní Texas
západoturecký	západní Turecko
západoukrajinský	západní Ukrajina
západovenezuelský	západní Venezuela
západovirginský	západní Virginie
žároměr	žár měřit
zatměníchtivý	zatmění chtivý
závitořez	závit řez
zaznamenáníhodný	zaznamenání hodný
zbrojnoš	zbroj nosit
zčistajasna	čistý jasný
zdeúřední	zde úřední
zdravíchtivý	zdraví chtivý
zdravověda	zdraví věda
želbohu	žel bůh
zelenobílý	zelený bílý
zelenočernobílý	zelený černý bílý
zelenočernočervený	zelený černý červený
zelenočerný	zelený černý
zelenočervenozelený	zelený červený zelený
zelenočervenozlatý	zelený červený zlatý
zelenofialový	zelený fialový
zelenohlavý	zelený hlava
zelenohnědožlutý	zelený hnědý žlutý
zelenohřbetý	zelený hřbet
zelenoklasý	zelený klas
zelenokvětý	zelený květ
zelenolistý	zelený list
zelenomodrobílý	zelený modrý bílý
zelenomodrý	zelený modrý
zelenonašedlý	zelený našedlý
zelenonohý	zelený noha
zelenoocasý	zelený ocas
zelenookrový	zelený okrový
zelenooký	zelený oko
zelenooranžovobílý	zelený oranžový bílý
zelenooranžový	zelený oranžový
zelenoplodý	zelený plod
zelenorůžovočerný	zelený růžový černý
zelenorůžovočervený	zelený růžový červený
zelenošedivý	zelený šedivý
zelenošedočerný	zelený šedý černý
zelenošedý	zelený šedý
zelenovlasý	zelený vlas
zelenozlatý	zelený zlatý
zelenožlutočerný	zelený žlutý černý
zelenožlutý	zelený žlutý
železnatoželezitý	železnatý železitý
zeměchtivý	země chtivý
zemědělskolesnický	zemědělský lesnický
zemědělskopotravinářský	zemědělský potravinářský
zemědělskoprůmyslový	zemědělský průmyslový
zemědělskotechnický	zemědělský technický
zemitoalkalický	zemitý alkalický
zemitoželeznatý	zemitý železnatý
židovskoimperialistický	židovský imperialismus
zimomorný	zima mořit
zimovzdorný	zima vzdor
živorodý	živý rodit
životodárce	život dárce
životopis	život psát
zkázonosný	zkáza nosit
zkurvysyn	kurva syn
zlatavofialový	zlatavý fialový
zlatavohnědý	zlatavý hnědý
zlatobílý	zlatý bílý
zlatohorský	zlatý hora
zlatonosný	zlato nosit
zlatoplavý	zlatý plavý
zlatořitný	zlatý řiť
zlatorudný	zlatý ruda
zlatorudý	zlatý rudý
zlatožlutý	zlatý žlutý
žlučovod	žluč vést
žlutavozelený	žlutavý zelený
žlutobílý	žlutý bílý
žlutobřichý	žlutý břicho
žlutočernobílý	žlutý černý bílý
žlutočernočervený	žlutý černý červený
žlutočernorudý	žlutý černý rudý
žlutočernozelený	žlutý černý zelený
žlutočerný	žlutý černý
žlutočervenavý	žlutý červenavý
žlutočervený	žlutý červený
žlutohlavý	žlutý hlava
žlutohnědošedý	žlutý hnědý šedý
žlutohnědý	žlutý hnědý
žlutohřbetý	žlutý hřbet
žlutokošilatý	žlutý košile
žlutokvětý	žlutý květ
žlutolící	žlutý líce
žlutolistý	žlutý list
žlutomasý	žlutý maso
žlutomodrý	žlutý modrý
žlutonohý	žlutý noha
žlutookrový	žlutý okrový
žlutooký	žlutý oko
žlutooranžový	žlutý oranžový
žlutopestrý	žlutý pestrý
žlutorezavý	žlutý rezavý
žlutorudý	žlutý rudý
žlutorůžovofialový	žlutý růžový fialový
žlutorůžovomodrý	žlutý růžový modrý
žlutorůžový	žlutý růžový
žlutošedý	žlutý šedý
žlutovlasý	žlutý vlas
žlutozelenobílý	žlutý zelený bílý
žlutozelenočerný	žlutý zelený černý
žlutozelenočervený	žlutý zelený červený
žlutozelený	žlutý zelený
žlutozlatý	žlutý zlatý
žlutozobý	žlutý zobák
žlutozrzavý	žlutý zrzavý
značekchtivý	značka chtivý
známkoprávní	známka právo
znovudefinovat	znovu definovat
znovukandidovat	znovu kandidovat
znovunapustit	znovu napustit
znovunatočit	znovu natočit
znovunavrátit	znovu navrátit
znovuovládnutí	znovu ovládnutí
znovupohřbít	znovu pohřbít
znovupotvrdit	znovu potvrdit
znovuprovdat	znovu provdat
znovustvořit	znovu stvořit
znovuumístění	znovu umístění
znovuvyhlásit	znovu vyhlásit
znovuvyplatit	znovu vyplatit
znovuvysvěcení	znovu vysvěcení
znovuvytvořit	znovu vytvořit
znovuzrodit	znovu zrodit
zoborožec	zobák roh
zpěvohra	zpěv hra
zřídkakdy	zřídka kdy
zrovnoprávnit	rovný právo
zvrtohlavit	zvrtat hlava
zvukomalba	zvuk malba
zvukoměřičství	zvuk měřičství
zvukoměřictví	zvuk měřictví
zvukosled	zvuk sledovat
zvukotechnika	zvuk technika
zvykosloví	zvyk slovo
zvykuprostý	zvyk prostý
dvojakce	dva akce
dvojapůlnásobek	dva půl násobek
dvojapůlnásobný	dvojapůlnásobek
dvojarch	dva arch
dvojbiografie	dva biografie
dvojbitový	dva bit
dvojblok	dva blok
dvojboj	dva boj
dvojbřitvový	dva břitva
dvojbudka	dva budka
dvojbuňka	dva buňka
dvojbusta	dva busta
dvojčárka	dva čárka
dvojchodý	dva chod
dvojchvostý	dva chvost
dvojčinný	dva čin
dvojdepo	dva depo
dvojdeska	dva deska
dvojdíl	dva díl
dvojdílný	dva díl
dvojdílo	dva dílo
dvojdukát	dva dukát
dvojdům	dva dům
dvojduše	dvojduchý
dvojdutý	dva dutý
dvojfázový	dva fáze
dvojfigura	dva figura
dvojgól	dva gól
dvojhlava	dva hlava
dvojhlavičkový	dva hlavička
dvojhlavňový	dva hlaveň
dvojhlavý	dva hlava
dvojhora	dva hora
dvojhrad	dva hrad
dvojhradí	dva hrad
dvojjednota	dva jednota
dvojjehlan	dva jehlan
dvojkajak	dva kajak
dvojkamera	dva kamera
dvojknedlíčkový	dva knedlíček
dvojkniha	dva kniha
dvojknížka	dva knížka
dvojkolejnice	dva kolejnice
dvojkolejný	dva kolej
dvojkolejový	dva kolej
dvojkolí	dva kolo
dvojkolo	dva kolo
dvojkrádež	dva krádež
dvojkrálí	dva král
dvojkytarový	dva kytara
dvojlineární	dva lineární
dvojmanuálový	dva manuál
dvojmužný	dva muž
dvojmužství	dva muž
dvojnehoda	dva nehoda
dvojnekrolog	dva nekrolog
dvojnosý	dva nos
dvojobraz	dva obraz
dvojobrázek	dva obrázek
dvojosý	dva osa
dvojpádlo	dva pádlo
dvojpérový	dva péro
dvojplášť	dva plášť
dvojpól	dva pól
dvojprimátorství	dva primátor
dvojrodný	dva rod
dvojskluzavka	dva skluzavka
dvojsměna	dva směna
dvojsměrný	dva směr
dvojšvih	dva švih
dvojtvářný	dva tvář
dvojúspěch	dva úspěch
dvojveslice	dva veslo
dvojveslový	dva veslo
dvojvrstva	dva vrstva
dvojvrstvý	dva vrstva
dvojzvuk	dva zvuk
dvouačtvrthodinový	dva čtvrt hodina
dvouačtvrtkarátový	dva čtvrt karát
dvouadresový	dva adresa
dvouakordový	dva akord
dvouakrový	dva akr
dvouapůlkarátový	dva půl karát
dvouapůlkilogramový	dva půl kilogram
dvouapůlkilometrový	dva půl kilometr
dvouapůlpalcový	dva půl palec
dvouapůlpokojový	dva půl pokoj
dvouapůlprocentní	dva půl procento
dvouapůltisíciletý	dva půl tisíc léto
dvouapůltunový	dva půl tuna
dvouargumentový	dva argument
dvouarový	dva ar
dvouatomový	dva atom
dvouatriový	dva atrium
dvouautorský	dva autor
dvoubarevný	dva barva
dvoubříškový	dva bříško
dvoucestný	dva cesta
dvoučlánkový	dva článek
dvoučlenný	dva člen
dvoudějový	dva děj
dvoudesítkový	dva desítka
dvoudřez	dva dřez
dvoudvorcový	dva dvorec
dvouetážový	dva etáž
dvoueurovka	dva euro
dvoufázový	dva fáze
dvougenerační	dva generace
dvouhodnotový	dva hodnota
dvouklíčový	dva klíč
dvoukošový	dva koš
dvoukvětý	dva květ
dvoulaločnatý	dva lalok
dvoulaločný	dva lalok
dvouletý	dva rok
dvoumotor	dva motor
dvouocasý	dva ocas
dvouodrůdový	dva odrůda
dvouohniskový	dva ohnisko
dvouoký	dva oko
dvouoperátorový	dva operátor
dvouostruhý	dva ostruha
dvoupásmový	dva pásmo
dvoupavilon	dva pavilon
dvoupedálový	dva pedál
dvoupilířový	dva pilíř
dvouplaneta	dva planeta
dvouplošný	dva plocha
dvoupouzdří	dva pouzdro
dvoupouzdrý	dva pouzdro
dvoupříjmový	dva příjem
dvouprogram	dva program
dvouprstencový	dva prstenec
dvoupyský	dva pysk
dvouranový	dva rána
dvourázový	dva ráz
dvourežimní	dva režim
dvourozhledna	dva rozhledna
dvourozsahový	dva rozsah
dvousborový	dva sbor
dvousegmentový	dva segment
dvousekundový	dva sekunda
dvousetčtyřicetimiliardový	dva sto čtyřicet miliarda
dvousetčtyřicetiprocentní	dva sto čtyřicet procento
dvousetčtyřicetistránkový	dva sto čtyřicet stránka
dvousetčtyřicetitisícový	dva sto čtyřicet tisíc
dvousetdílkový	dva sto dílek
dvousetdolarový	dva sto dolar
dvousetdrachmový	dva sto drachma
dvousethektarový	dva sto hektar
dvousetkolový	dva sto kolo
dvousetnohý	dvě sto noha
dvousetosmimilionový	dva sto osm milion
jednodížový	jeden díž
jednodobý	jeden doba
jednodolarový	jeden dolar
jednodomý	jeden dům
jednodotykový	jeden dotykový
jednodruhový	jeden druh
jednoduchý	jeden duch
jednodvéřový	jeden dveře
jednoetapový	jeden etapa
jednofaktorový	jeden faktor
jednoformulářový	jeden formulář
jednofotonový	jeden foton
jednofunkční	jeden funkce
jednogenerační	jeden generace
jednogólový	jeden gól
jednohadicový	jeden hadice
jednohektarový	jeden hektar
jednohlas	jeden hlas
jednohláskový	jeden hláska
jednohlavňový	jeden hlaveň
jednohlavý	jeden hlava
jednohodinový	jeden hodina
jednohrbě	jednohrbý
jednohrbý	jeden hrb
jednohubka	jeden huba
jednohvězdičkový	jeden hvězdička
jednoinstanční	jeden instance
jednojaderný	jeden jádro
jednojazýčkový	jeden jazýček
jednojazyčný	jeden jazyk
jednojehlový	jedno jehla
acidofobie	-acid- -fob-
aerofobie	-aer- -fob-
agorafobie	-agora- -fob-
aichmofobie	-aichm- -fob-
alopecie	-alopek-
anageneze	-ana- geneze
androkracie	-andr- -krat-
anglofobie	Anglie -fob-
anglosas	Anglie Sas
antropofobie	-anthrop- -fob-
arachnofobie	-arachn- -fob-
architektura	-arch- -takt-
aristokracie	-arist- -krat-
autokracie	-aut- -krat-
automacie	automacie
autožárovka	auto žárovka
babochlap	baba chlap
balkanolog	Balkán -log-
bifida	-bi- -fid-
bigarádie	bigarádie
bílobéžový	bílý béžový
bíločernohnědý	bílý černý hnědý
bíločervenohnědý	bílý červený hnědý
bíločervenomodrý	bílý červený modrý
bíločervenozelený	bílý červený zelený
bíločervenožlutý	bílý červený žlutý
bílofialovorůžový	bílý fialový růžový
bílofialový	bílý fialový
bílohnědočerný	bílý hnědý černý
bílohnědý	bílý hnědý
bílokarmínový	bílý karmínový
bílokarpatský	bílý Karpaty
bílokostelecký	bílý Kostelec
bílokostelský	bílý Kostel
bílomasý	bílý maso
bílomodro	bílý modrý
bílomodročervený	bílý modrý červený
bílomodrofialový	bílý modrý fialový
bílomodrošedý	bílý modrý šedý
bílonachový	bílý nachový
bílonohý	bílý noha
bílopesíkatý	bílý pesík
bíloplášťový	bílý plášť
bíloplodý	bílý plod
bílopodolský	bílý Podolí
bílopotocký	bílý potok
bílorudý	bílý rudý
bílorůžový	bílý růžový
bílošedomodrý	bílý šedý modrý
bílošedý	bílý šedý
bílozelenohnědý	bílý zelený hnědý
bíložlutomodrý	bílý žlutý modrý
bíložlutozelený	bílý žlutý zelený
biochlapeček	-bio- chlapeček
biofacie	-bio- -fac-
biofobie	-bio- -fob-
biokafe	-bio- kafe
bipedie	-bi- -pes-
blankoakceptant	blank akceptant
bohočlověk	bůh člověk
brestlitevský	Brest Litva
bronchologie	-bronch- -log-
buzerplac	buzerovat plac
byrokracie	-byr- -krat-
čechofobie	Čech -fob-
centrifuga	-centr- -fug-
černokaspický	černý Kaspik
cholelithiáza	-chol- -lith-
chromniklový	chrom nikl
cykloakrobacie	-cykl- akrobacie
cyklopolicie	-cykl- policie
cyklorozcestník	-cykl- rozcestník
dělbuch	dělo bouchat
demokracie	-dem- -krat-
diskomelodie	disko melodie
divukrásný	div krásný
donkichot	don Quijote
donquijotský	don Quijote
drátosklo	drát sklo
dysmorfofobie	-dys- -morf- -fob-
ekopodnikatel	-eko- podnikatel
etnokracie	-etn- -krat-
etopedie	-etho- -paid-
eurobyrokracie	-eur- -byr- -krat-
eurokracie	-eur- -krat-
exmonarcha	-ex- monarcha
faxmodem	fax modem
ferdomravencovský	Ferda mravenec
fízlokracie	fízl -krat-
frankofobie	-frank- -fob-
gelotofobie	-tol- -fob-
geomancie	-geo- -mant-
germanofobie	Germán -fob-
gerontokracie	-geront- -krat-
gestaltpsychologie	gestalt psychologie
gnoseologie	-gnos- -log-
gonokok	-gon- -kok-
gymnaestráda	-gymn- estráda
heteroploidie	-heter- -plo-
hlubotisk	hluboký tisk
holoenzym	-hol- enzym
hypnopedie	-hypn- -paid-
ideopolicie	idea policie
idiosynkracie	-idio- -syn- -krat-
intimsprej	intimní sprej
intramuskulární	-intra- muskulární
jetelotravní	jetel tráva
jódškrobový	jód škrob
kamenotisk	kámen tisk
kancerofobie	-kancer- -fob-
karcinofobie	-karcin- -fob-
karpologie	-karp- -log-
kaštanozem	kaštan zem
kolopásový	kolo pás
kolovrat	kolo vrtět
konkávkonvexní	konkávní konvexní
kovomodelář	kov modelář
kovotepec	kov tepat
kožojed	kůže jíst
kremlologie	Kreml -log-
krimikomedie	-krimi- komedie
krvotok	krev tok
kryptobolševik	-krypt- bolševik
kulturnětechnický	kulturní technický
kvazizednářský	-kvazi- zednář
laliofobie	-lali- -fob-
lalokoploutvý	lalok ploutev
letlampa	letovat lampa
letokruh	léto kruh
leukosafír	-leuk- safír
litofacie	-lith- -fac-
logofobie	-log- -fob-
logopedie	-log- -paid-
lužickosrbský	lužický Srbsko
lymforetikulární	lymfa retikulární
makrodoncie	-makr- -odont-
mammologie	-mamm- -log-
meritokracie	-merit- -krat-
metanefridie	metanefridie
mikrocie	-mikr- -ot-
mikrodoncie	-mikr- -odont-
mikrowatthodina	mikrowatt hodina
mimoabonentní	mimo abonent
mimoakademický	mimo akademie
mimoodvolací	mimo odvolání
mimoohniskový	mimo ohnisko
mimoolomoucký	mimo Olomouc
mimooperní	mimo opera
mimoosobní	mimo osoba
mimoosový	mimo osa
mimoostravský	mimo Ostrava
mimopánevní	mimo pánev
mimopardubický	mimo Pardubice
mimoparlamentní	mimo parlament
mimopecní	mimo pec
mimoplatový	mimo plat
mimoplicní	mimo plíce
mimoplzeňský	mimo Plzeň
mimopočítačový	mimo počítač
mimopodnikový	mimo podnik
mimopolicejní	mimo policie
mimopolitický	mimo politika
mimopoštovní	mimo pošta
mimopracovní	mimo práce
mimopražský	mimo Praha
mimoprodejní	mimo prodej
mimoprodukční	mimo produkce
mimoprostějovský	mimo Prostějov
mimoprostor	mimo prostor
mimoprostorový	mimoprostor
mimopstruhový	mimo pstruh
mimoracionální	mimo racionální
mimořádný	mimo řád
mimorakouský	mimo Rakousko
mimorakovnický	mimo Rakovník
mimorámový	mimo rám
mimořečový	mimo řeč
mimoregionální	mimo region
mimorevoluční	mimo revoluce
mimoringový	mimo ring
mimořitní	mimo řiť
mimorozhlasový	mimo rozhlas
mimorozpočtový	mimo rozpočet
mimorozumový	mimo rozum
mimosemilský	mimo Semily
mimosezonní	mimo sezona
mimosezónní	mimo sezóna
mimosilniční	mimo silnice
mimoškolní	mimo škola
mimoškolský	mimo škola
mimoskupinový	mimo skupina
mimoslovenský	mimo Slovensko
mimoslovní	mimo slovo
mimoslužební	mimo služba
mimosměnečný	mimo směnka
mimosmluvní	mimo smlouva
mimosmyslový	mimo smysl
mimosoudní	mimo soud
mimosoustavový	mimo soustava
mimošpičkový	mimo špička
mimospolečenský	mimo společnost
mimosportovní	mimo sport
mimostátní	mimo stát
mimostaveništní	mimo staveniště
mimostranický	mimo strana
mimostředný	mimo střed
mimostřevní	mimo střevo
mimosvazový	mimo svaz
mimosvětský	mimo svět
mimosystémový	mimo systém
mimotarifní	mimo tarif
mimotělní	mimo tělo
mimotextový	mimo text
mimoto	mimo to
mimotopný	mimo topit
mimotropický	mimo tropy
mimotržní	mimo trh
mimoučební	mimo učebna
mimoúčetní	mimo účet
mimoumělecký	mimo umělec
mimouniverzitní	mimo univerzita
mimoúřední	mimo úřad
mimoúrovňový	mimo úroveň
mimoústavní	mimo ústava
mimoúvěrový	mimo úvěr
mimovědecký	mimo věda
mimovědní	mimo věda
mimovegetační	mimo vegetace
mimovládní	mimo vláda
mimovojenský	mimo vojín
mimovolní	mimo vůle
mimovýcvikový	mimo výcvik
mimovýrobní	mimo výroba
mimovyučovací	mimo vyučování
mimozákonný	mimo zákon
mimozaměstnanecký	mimo zaměstnanec
mimozáruční	mimo záruka
mimozávodní	mimo závod
mimozávodový	mimo závod
mimozemský	mimo země
mimozemšťan	mimozemský
mimozkušenostní	mimo zkušenost
mimozlínský	mimo Zlín
mimózovitý	mimóza
mimozrakový	mimo zrak
mincmistr	mince mistr
mineralogie	minerál -log-
mineralokortikoid	minerál kortikoid
mineraloterapie	minerál terapie
minerogenní	minerál -gen-
minesängr	minesängr
miniaféra	-mini- aféra
miniagentura	-mini- agentura
miniaktovka	-mini- aktovka
minialbum	-mini- album
minialiance	-mini- aliance
minianketa	-mini- anketa
miniaplikace	-mini- aplikace
miniarboretum	-mini- arboretum
miniaréna	-mini- aréna
miniarmáda	-mini- armáda
miniatlásek	-mini- atlásek
miniaturgolf	miniatura golf
miniaukce	-mini- aukce
miniautíčko	-mini- autíčko
minibar	-mini- bar
minibasketbal	-mini- basketbal
minibazárek	-mini- bazárek
minibáze	-mini- báze
minibible	-mini- bible
minibikař	-mini- bike
minibook	-mini- book
minibox	-mini- box
minibus	-mini- bus
minibusta	-mini- busta
minibyt	-mini- byt
minibyteček	-mini- byteček
minicartridge	-mini- cartridge
minicartridgový	minicartridge
minicartridžový	minicartridge
minicentrum	-mini- centrum
minicívka	-mini- cívka
minicopánek	-mini- copánek
minicvičák	-mini- cvičák
minicyklus	-mini- cyklus
minidelegace	-mini- delegace
minidélka	-mini- délka
miniderby	-mini- derby
minidesert	-mini- desert
minideska	-mini- deska
minidesktop	-mini- desktop
minidílko	-mini- dílko
minidisk	-mini- disk
minidisketa	-mini- disketa
minidistributor	-mini- distributor
minidivadlo	-mini- divadlo
minidomek	-mini- domek
minidrama	-mini- drama
minidružice	-mini- družice
minidružstvo	-mini- družstvo
minidvorek	-mini- dvorek
minieditor	-mini- editor
minielektrárna	-mini- elektrárna
miniepos	-mini- epos
miniexpozice	-mini- expozice
minifederace	-mini- federace
minifestival	-mini- festival
minifestiválek	-mini- festiválek
minifigurka	-mini- figurka
minifilm	-mini- film
minifirma	-mini- firma
minifontánka	-mini- fontánka
miniformace	-mini- formace
miniformát	-mini- formát
minigalerie	-mini- galerie
minigraf	-mini- graf
minigril	-mini- gril
miniheparinizace	-mini- heparinizace
miniherna	-mini- herna
minihokej	-mini- hokej
minihokejka	-mini- hokejka
minihotýlek	-mini- hotýlek
minihuť	-mini- huť
minihydraulika	-mini- hydraulika
miniimpérium	-mini- impérium
miniinterrupce	-mini- interrupce
miniinterview	-mini- interview
minijeviště	-mini- jeviště
minikalkulačka	-mini- kalkulačka
minikamera	-mini- kamera
minikampaň	-mini- kampaň
minikárista	-mini- kára
minikarta	-mini- karta
minikartridž	-mini- kartridž
minikavárna	-mini- kavárna
minikazeta	-mini- kazeta
minikino	-mini- kino
miniklan	-mini- klan
miniklávesnice	-mini- klávesnice
miniklobáska	-mini- klobáska
minikmen	-mini- kmen
miniknížečka	-mini- knížečka
miniknížka	-mini- kníže
minikobylčin	-mini- kobylka
minikoláček	-mini- koláček
minikolonie	-mini- kolonie
minikomedie	-mini- komedie
minikomise	-mini- komise
minikopie	-mini- kopie
minikošíková	-mini- košík
minikosmodrom	-mini- kosmodrom
minikraťoučký	-mini- kratoučký
minikrize	-mini- krize
minikuchyně	-mini- kuchyně
minikuchyňka	-mini- kuchyňka
minikufřík	-mini- kufřík
minikulečník	-mini- kulečník
minikuře	-mini- kuře
minikurz	-mini- kurz
minilab	-mini- alba
minilaboratoř	-mini- laboratoř
minilampička	-mini- lampička
minilebčička	-mini- lebčička
minilékárna	-mini- lékárna
minilekce	-mini- lekce
miniletadlo	-mini- letadlo
miniliga	-mini- liga
miniložnice	-mini- ložnice
minimainframe	-mini- mainframe
minimanuál	-mini- manuál
minimax	-mini- max
minimedailonek	-mini- medailonek
minimeditace	-mini- meditace
minimenšina	-mini- menšina
miniměstečko	-mini- městečko
miniměsto	-mini- město
minimetro	-mini- metro
minimlékárna	-mini- lékárna
minimodul	-mini- modul
minimonografie	-mini- monografie
minimotocykl	-mini- motocykl
minimotorka	-mini- motorka
minimotůrek	-mini- motorek
minimozaika	-mini- mozaika
minimuzeum	-mini- muzeum
minimuzikál	-mini- muzikál
mininárod	-mini- národ
mininotebook	-mini- notebook
mininovela	-mini- novela
miniobchod	-mini- obchod
miniobchůdek	-mini- obchod
miniokénko	-mini- okénko
miniopera	-mini- opera
minioperace	-mini- operace
miniorchestr	-mini- orchestr
miniorganizace	-mini- organizace
minipartie	-mini- partie
minipivovar	-mini- pivovar
minipivovárek	-mini- pivovárek
miniplátno	-mini- plátno
miniplavečky	-mini- plavečky
minipočítač	-mini- počítač
minipódium	-mini- pódium
minipodnik	-mini- podnik
minipodoba	-mini- podoba
miniponorka	-mini- ponorka
miniposádka	-mini- posádka
minipostava	-mini- postava
minipotůček	-mini- potůček
minipovídka	-mini- povídka
minipovstání	-mini- povstání
minipozemeček	-mini- pozemeček
minipředsíňka	-mini- předsíňka
minipředstavení	-mini- představení
minipřehlídka	-mini- přehlídka
minipřevrat	-mini- převrat
minipřípravek	-mini- přípravek
minipříručka	-mini- příručka
minipříslušenství	-mini- příslušenství
miniprocesor	-mini- procesor
miniprodukce	-mini- produkce
miniprogram	-mini- program
miniprohlížeč	-mini- prohlížeč
miniproslov	-mini- proslov
miniprostor	-mini- prostor
miniprůzkum	-mini- průzkum
minipuchýř	-mini- puchýř
miniradiátor	-mini- radiátor
minirampa	-mini- rampa
minirecenze	-mini- recenze
minireceptář	-mini- receptář
minirecitál	-mini- recitál
minireflexe	-mini- reflexe
miniregion	-mini- region
minirelé	-mini- relé
miniremoska	-mini- remoska
minireportáž	-mini- reportáž
minirepro	-mini- repro
minirepublika	-mini- republika
miniretrospektiva	-mini- retrospektiva
minirevolta	-mini- revolta
miniromán	-mini- román
minirozcvička	-mini- rozcvička
minirozhovor	-mini- rozhovor
minirozměr	-mini- rozměr
minirozpočet	-mini- rozpočet
miniruleta	-mini- ruleta
minirypadlo	-mini- rypadlo
minirýpadlo	-mini- rýpadlo
minisádka	-mini- sádka
minisága	-mini- sága
minisalón	-mini- salón
minisalonek	-mini- salonek
minišaty	-mini- šaty
minisbírka	-mini- sbírka
minischodek	-mini- schodek
minisekce	-mini- sekce
minisen	-mini- sen
miniseriál	-mini- seriál
minisérie	-mini- série
miniseznam	-mini- seznam
minishow	-mini- show
minisídliště	-mini- sídliště
minisignál	-mini- signál
minisíť	-mini- síť
miniskalka	-mini- skalka
miniskansen	-mini- skanzen
miniskanzen	-mini- skanzen
miniskládka	-mini- skládka
miniskok	-mini- skok
miniskupina	-mini- skupina
minislabikář	-mini- slabikář
minislovník	-mini- slovník
minisluchátko	-mini- sluchátko
minisněm	-mini- sněm
minišňůra	-mini- šňůra
minisoft	-mini- soft
minisonda	-mini- sonda
minisopka	-mini- sopka
minisouboj	-mini- souboj
minisoubor	-mini- soubor
minisporťák	-mini- sporťák
ministánek	-mini- stánek
ministanice	-mini- stanice
ministát	-mini- stát
ministavba	-mini- stavba
ministávka	-mini- stávka
ministoleček	-mini- stoleček
ministrana	-mini- strana
ministromek	-mini- stromek
ministrovávání	ministrovávat
ministudio	-mini- studio
minisukně	-mini- sukně
minisukýnka	minisukně
minisummit	-mini- summit
minisuperpočítač	-mini- superpočítač
minisvět	-mini- svět
minisympozium	-mini- sympozium
minitablet	-mini- tablet
minitabletka	-mini- tabletka
minitabulka	-mini- tabulka
minitaháček	-mini- taháček
minitelevizor	-mini- televizor
minitělísko	-mini- tělísko
minitělocvična	-mini- tělocvična
minitéma	-mini- téma
minitest	-mini- test
minitext	-mini- text
minitiskárna	-mini- tiskárna
minitower	-mini- tower
minitrackball	-mini- trackball
minitribuna	-mini- tribuna
minitřída	-mini- třída
miniturné	-mini- turné
miniúhloměr	-mini- úhloměr
miniuložení	-mini- uložení
miniuložený	-mini- uložený
miniuložit	-mini- uložit
miniuložitelný	-mini- uložit
miniuloživší	-mini- uložit
miniústředna	-mini- ústředna
miniutkání	-mini- utkání
miniúzemí	-mini- území
miniválka	-mini- válka
minivan	-mini- van
minivana	-mini- vana
minivarhany	-mini- varhany
minivečírek	-mini- večírek
miniveletrh	-mini- veletrh
minivětráček	-mini- větráček
minivěž	-mini- věž
minivozidlo	-mini- vozidlo
minivozítko	-mini- vozítko
minivrtulník	-mini- vrtulník
minivůz	-mini- vůz
minivysavač	-mini- vysavač
minivysílačka	-mini- vysílačka
minivýsledek	-mini- výsledek
minivýstavka	-mini- výstavka
miniworkshop	-mini- workshop
minižáček	-mini- žáček
minizáchodek	-mini- záchodek
minizahrada	-mini- zahrada
minizahrádka	-mini- zahrádka
minižák	-mini- žák
minizákusek	-mini- zákusek
minizápas	-mini- zápas
minižárovka	-mini- žárovka
minizásoba	-mini- zásoba
minizávod	-mini- závod
minizkouška	-mini- zkouška
miniznačka	-mini- značka
minizoo	-mini- zoo
minizrcadlo	-mini- zrcadlo
monokracie	-mon- -krat-
monokulár	-mon- okulár
monopol	-mon- -pol-
monorchidie	-mon- -orchi-
multimixér	-multi- mixér
nekromancie	-nekr- -mant-
neznaboh	znát bůh
nigerokordofánský	Niger Kordofán
nízkokvalitní	nízký kvalita
nízkopásmový	nízký pásmo
nomokracie	-nom- -krat-
ofiomancie	-ofi- -mant-
oftalmopedie	-ofthalm- -paid-
olejotisk	olej tisk
omfalomancie	-omfal- -mant-
opočlověk	op člověk
optočlen	-opt- člen
oranžovočelý	oranžový čelo
organologie	orgán -log-
orlosup	orel sup
orthopedie	-orth- -pes-
ortodoncie	-orth- -odont-
ortopedie	-orth- -paid-
osteomalacie	-oste- -malak-
ozembouch	zem bouchat
palilogie	-pali- -log-
pantofobie	-pant- -fob-
paraskupina	-para- skupina
pecivál	pec válet
pětatřicátník	pětatřicet
pěticoulový	pět coul
petrklíč	Petr klíč
pevnolátkový	pevný látka
plavovlasý	plavý vlas
plnostěnný	plný stěna
ploskozubec	ploský zub
plutokracie	-plut- -krat-
polykracie	-poly- -krat-
polyodoncie	-poly- -odont-
pomelo	pomelo
pomologie	-pom- -log-
pornokino	porno kino
postdemokracie	-post- demokracie
postpozice	-post- pozice
praxeologie	-prax- -log-
předozadní	přední zadní
pršinos	pršet nos
prvomájový	prvý máj
prvotisk	prvý tisk
psychofarmacie	-psych- farmacie
psychopedie	-psych- -paid-
půdopokryvný	půda pokrývat
půdotok	půda tok
radiofobie	-radi- -fob-
radiofóbie	-radi- -fob-
rádobykomedie	rádoby komedie
retrokomedie	-retr- komedie
rozumbrada	rozum brada
rusofobie	Rus -fob-
šalinkarta	šalina karta
samochladit	sám chladit
samochod	sám chodit
samochválit	samochvála
samočinný	sám činný
samočistit	sám čistit
samodefinovat	sám definovat
samodezinfekční	sám dezinfekční
samodokumentovat	sám dokumentovat
samodruhý	sám druhý
samodružný	sám družný
samodržný	sám držet
samofinancovat	sám financovat
samofokusace	sám fokusace
samohláska	sám hláska
samohojení	samohojit
samohojit	sám hojit
samohonka	samohonka
samohrajka	sám hrát
samohyb	sám hýbat
samoidentifikovat	sám identifikovat
samoindukce	sám indukce
samoinstalovat	sám instalovat
samojed	sám jíst
samojediný	sám jediný
samojistit	sám jistit
samojízdný	sám jezdit
samokalibrovat	sám kalibrovat
samoklopný	sám klopit
samokonfigurovat	sám konfigurovat
samokontrola	sám kontrola
samokřídlo	sám křídlo
samoléčit	sám léčit
samolez	sám lézt
samolikvidovat	sám likvidovat
samomat	sám mat
samomazný	sám mazat
samonabíjet	sám nabíjet
samonakladatel	sám nakladatel
samonapadnout	sám napadnout
samonasávat	sám nasávat
samonaštvat	sám naštvat
samonavádět	sám navádět
samoobčerstvovat	sám občerstvovat
samoobjevitelský	sám objevitelský
samoobnova	sám obnova
samoobsloužit	sám obsloužit
samoočišťovat	sám očišťovat
samoodbavovat	sám odbavovat
samoodečet	sám odečet
samoodmrazovat	sám odmrazovat
samooplodnění	sám oplodnění
samooplození	sám oplození
samoopravit	sám opravit
samoopylit	sám opylit
samoorganizovat	sám organizovat
samootevírat	sám otevírat
samoparkovat	sám parkovat
samopasovat	sám pasovat
samopěstitel	sám pěstitel
samoplátce	sám plátce
samoplodit	sám plodit
samoplodivý	samoplodit
samoplozený	samoplodit
samopohyb	sám pohyb
samopojištění	sám pojištění
samopojízdný	sám pojízdný
samoposilovat	sám posilovat
samoposuvný	sám posuvný
samopotrat	sám potrat
samopoznat	sám poznat
samoprezentovat	sám prezentovat
samoprivatizovat	sám privatizovat
samoprodukovat	sám produkovat
samopropisovat	sám propisovat
samoregulovat	sám regulovat
samorelokabilita	sám relokabilita
samoreprodukovat	sám reprodukovat
samoreturnovat	sám returnovat
samořídit	sám řídit
samorostlík	samorostlý
samorozbalit	sám rozbalit
samorozpad	sám rozpad
samorozpínat	sám rozpínat
samorozpouštět	sám rozpouštět
samorozpoznat	sám rozpoznat
samorozpustit	sám rozpustit
samorozšiřovat	sám rozšiřovat
samorozvinovat	sám rozvinovat
samoschnout	sám schnout
samoshromážděný	samoshromáždit
samoshromáždit	sám shromáždit
samosmršťovací	samosmršťovat
samosmršťovaný	samosmršťovat
samosmršťovat	sám smršťovat
samosmršťovávací	samosmršťovávat
samosmršťovávání	samosmršťovávat
samosmršťovávaný	samosmršťovávat
samosmršťovávat	samosmršťovat
samosmršťovávatelný	samosmršťovávat
samospád	sám spád
samospasit	sám spasit
samosplodit	sám splodit
samospotřebitel	sám spotřebitel
samospoušť	sám spoušť
samospravovat	sám spravovat
samospustit	sám spustit
samostatný	sám stát
samostmívat	sám stmívat
samostříl	sám střílet
samostudovat	sám studovat
samosvěrný	sám svírat
samosvor	sám svírat
samosypný	sám sypat
samotíha	sám tíha
samotitulovat	sám titulovat
samotřetí	sám třetí
samotřídit	sám třídit
samotuhnoucí	sám tuhnoucí
samotvrdnout	sám tvrdnout
samoúčel	sám účel
samoučit	sám učit
samouk	sám učit
samoúnos	sám únos
samouzavírat	sám uzavírat
samovar	sám vařit
samovazba	sám vazba
samovláda	sám vláda
samovlastník	sám vlastník
samovod	sám vést
samovolný	sám volný
samovrah	sám vrah
samovražda	sám vražda
samovstup	sám vstup
samovýběr	sám výběr
samovybíjet	sám vybíjet
samovýčep	sám výčep
samovydavatel	sám vydavatel
samovýklopný	sám výklopný
samovyléčení	sám vyléčení
samovyměření	sám vyměření
samovyměřovat	sám vyměřovat
samovyříkat	sám vyříkat
samovyrobit	sám vyrobit
samovyšetřit	sám vyšetřit
samovýsypný	sám výsypný
samovyvažovací	sám vyvažovací
samovývoj	sám vývoj
samovzdělat	sám vzdělat
samovznítit	sám vznítit
samozahřát	sám zahřát
samozaměstnat	sám zaměstnat
samozamykat	sám zamykat
samozásobit	sám zásobit
samozatmavovat	sám zatmavovat
samozatmívat	sám zatmívat
sebeabsurdněji	se absurdně
sebeabsurdnější	se absurdní
sebeadorace	se adorace
sebeafirmace	se afirmace
sebeaktivnější	se aktivní
sebeaktualizovat	se aktualizovat
sebeambicióznější	se ambiciozní
sebeanalýza	se analýza
sebeatraktivnější	se atraktivní
sebeautentičtěji	se autenticky
sebeautonomněji	se autonomně
sebeautonomnější	se autonomní
sebebanálněji	se banálně
sebebanálnější	se banální
sebebarevnější	se barevný
sebebarvitější	se barvitý
sebebedlivěji	se bedlivě
sebebedlivější	se bedlivý
sebebenevolentnější	se benevolentní
sebebezmocný	se bezmocný
sebebezpečnější	se bezpečný
sebebezvýznamný	se bezvýznamný
sebebičování	se bičování
sebebizarnější	se bizarní
sebebláznivější	se bláznivý
sebeblbější	se blbý
sebeblýskavější	se blýskavý
sebebohatší	se bohatý
sebebolestněji	se bolestně
sebebolestnější	se bolestný
sebebouřlivější	se bouřlivý
sebebujařejší	se bujarý
sebečarovnější	se čarovný
sebečastěji	se často
sebečastější	se častý
sebecenzura	se cenzura
sebečerstvější	se čerstvý
sebečestnější	se čestný
sebechápání	se chápání
sebechápavější	se chápavý
sebecharakteristika	se charakteristika
sebechatrnější	se chatrný
sebechlácholivý	se chlácholivý
sebechmurnější	se chmurný
sebechoulostivější	se choulostivý
sebechudší	se chudý
sebechvála	se chvála
sebechválit	se chválit
sebechytřeji	se chytře
sebechytřejší	se chytrý
sebečileji	se čile
sebečilejší	se čilý
sebečistěji	se čistě
sebečistit	se čistit
sebečistší	se čistý
sebecit	se cit
sebecitace	se citace
sebecítění	se cítění
sebecitlivěji	se citlivě
sebecitlivější	se citlivý
sebecivilizovanější	se civilizovaný
sebecizejší	se cizí
sebectihodnější	se ctihodný
sebecyničtější	se cynický
sebedál	se dál
sebedávnější	se dávný
sebedbalý	se dbalý
sebedefenestrace	se defenestrace
sebedefinovat	se definovat
sebedehonestovat	se dehonestovat
sebedéle	se dlouho
sebedelší	se dlouhý
sebedementnější	se dementní
sebedemokratičtější	se demokratický
sebedemolice	se demolice
sebedémoničtěji	se démonický
sebeděsivější	se děsivý
sebedestruovat	se destruovat
sebedetailnější	se detailní
sebedevastace	se devastace
sebedeviantnější	se deviantní
sebediagnóza	se diagnóza
sebedisciplína	se disciplina
sebediskreditace	se diskreditace
sebediskvalifikující	se diskvalifikovat
sebedivnější	se divný
sebedivočeji	se divoce
sebedivočejší	se divoký
sebedoceňování	se doceňování
sebedojímat	se dojímat
sebedokonaleji	se dokonale
sebedokonalejší	se dokonalý
sebedomestikace	se domestikace
sebedramatičtěji	se dramaticky
sebedramatičtější	se dramatický
sebedrásat	se drásat
sekeromlat	sekera mlátit
sémiologie	-sem- -log-
semitologie	semita -log-
sexykomedie	sexy komedie
silnostěnný	silný stěna
silokřivka	síla křivka
sírodusičnan	síra dusičnan
sklopísek	sklo písek
skoptofobie	-skop- -fob-
skorokomedie	skoro komedie
slepotisk	slepý tisk
službodárce	služba dárce
šmajchlkabinet	šmajchlovat kabinet
somatopedie	-somat- -paid-
sosiekologie	-sosi- ekologie
soudcokracie	soudce -krat-
srdceryvný	srdce rýt
staromilec	starý milovat
stranokracie	strana -krat-
surdopedie	-surd- -paid-
švarcsystém	švarc systém
svémoc	svý moc
synkracie	-syn- -krat-
tatraplán	Tatra plán
technofobie	-techn- -fob-
technofóbie	-techn- -fob-
technokracie	-techn- -krat-
teokracie	-theo- -krat-
tetraploidie	-tetra- -ploi-
tímokracie	-tim- -krat-
toxinologie	toxin -log-
tremolit	-trem- -lith-
tribologie	-trib- -logh-
trikarboxylový	-tri- karboxyl
trubkovnice	trubkový
trucsjezd	truc sjezd
tufobrekcie	tuf brekcie
tyflopedie	tyflo- -paid-
tyranokracie	tyran -krat-
tyranovražda	tyran vražda
ufonaut	ufo -naut-
utřinos	utřít nos
vakuokompresor	vakuum kompresor
valvuloplastika	valvula plastika
veletoč	velký točit
větněčlenský	větný člen
vibrolisovaný	vibrolisovat
víceklínový	hodně klín
vícekolejnicový	hodně kolejnice
vícepokojový	hodně pokoj
vícesektorový	hodně sektor
videoencyklopedie	video encyklopedie
vlnočet	vlna čítat
vlnolam	vlna lámat
vlnotuk	vlna tuk
vnitroareálový	vnitro areál
vnitroatomický	vnitro atom
vnitroatomový	vnitro atom
vnitrobezpečnostní	vnitřní bezpečnost
vnitroblok	vnitřní blok
vnitroblokový	vnitroblok
vnitrobosenský	vnitřní Bosna
vnitrobožský	vnitro bůh
vnitročeskoslovenský	vnitřní Československo
vnitrodruhový	vnitro druh
vnitrodutinový	vnitro dutina
vnitroekonomický	vnitřní ekonomika
vnitrofrancouzskost	vnitřní Francie
vnitrojazykový	vnitro jazyk
vnitrojugoslávský	vnitřní Jugoslavie
vnitroklubový	vnitro klub
vnitrokoaliční	vnitro koalice
vnitrokontinentální	vnitro kontinent
vnitrokožní	vnitro kůže
vnitromongolský	vnitřní Mongolsko
vnitrooční	vnitro oko
vnitroodborový	vnitro odbor
vnitroodrůdový	vnitro odrůda
vnitroodvětvový	vnitro odvětví
vnitropásmový	vnitro pásmo
vnitropodnikový	vnitro podnik
vnitropolitický	vnitřní politika
vnitroreaktorový	vnitro reaktor
vnitroregionální	vnitro region
vnitroresortní	vnitro resort
vnitrorezortní	vnitro rezort
vnitroskladový	vnitro sklad
vnitroskupinový	vnitro skupina
vnitroslovní	vnitro slovo
vnitrosouborový	vnitro soubor
vnitrosovětský	vnitro sovět
vnitrospolečenský	vnitro společnost
vnitrostatkový	vnitro statek
vnitrosvazový	vnitro svaz
vnitrotkáňový	vnitro tkáň
vnitrozávodní	vnitro závod
vnitrozávodový	vnitro závod
vnitrozemec	vnitrozemí
vnitrozemí	vnitro země
vysokoújezdský	vysoký Újezd
wikipedie	-wiki- -paid-
zelenobranský	zelený brána
zemětřesení	země třesení
židobijce	žid bít
židoviník	žid viník
zlatotepec	zlato tepat
zoocecidie	-zo- -ceci-
zpěvoprůmysl	zpěv průmysl
