neozednářský	zednářský
neomocnářský	mocnářský
neomodernistický	modernistický
paštický	paštika
podklášterský	klášterský, klášter
protibursíkovský	bursíkovský
protifierlingerovský	fierlingerovský
protifundamentalistický	fundamentalistický
protiirácký	tirácký
protikrálovský	protikrál, královský
mandejský	manda
protisektářský	sektářský
křížkovský	křížek
kulmský	kulma
kuchyňský	kuchyň
krátecký	krátký, krátko
kostecký	kost, kostka
předlyrický	lyrický, lyra
předmečiarovský	mečiarovský
předpředloňský	předloňský
předumělecký	umělecký
předárijský	árijský
závislácký	závislák
zvolenecký	zvolenec
pšenický	pšenice
radvanecký	radvanec
hašišácký	hašišák
hamernický	hamerník
gulripšský	gulripšsky
včelnický	včelník, čelník, včelnice
výběrovský	výběr
skulérský	kulér
bombarďácký	bombarďák
sněhulácký	sněhulák, sněhuláček, sněhulácky
dardský	darda
daňkovský	daněk
deblkanoistický	deblkanoista
droždářský	droždí
drsoňský	drsoň
taipingský	taping
tatínkovský	tatínek
helvitský	helvít
transsibiřský	sibiřský
světloulinký	světlounký, světlý
heuristický	heuristika
majnský	majna
tučňoučký	tučný
středoirácký	střed
protifarářský	farářský
protigruzínský	gruzínský, gruzinský
lumčický	lumčice, lumčík
pilnický	pilník
novopacký	nový
podkrajský	krajský
kružský	kruž
vlídňoučký	vlídný
bezmraký	mrak, brak, trak
kompletátorský	kompletátor
silický	silika
exbrněnský	brněnský
basiliánský	bazilián, basilián
předsokratický	sokratický
polocukrářský	cukrářský
věkověký	věkově
kančický	kančice, kančík
úpravnický	úpravník
karikaturistický	karikaturista, karikatura
předprezidentský	prezidentský, prezident
bengálský	bengál
slaňoučký	slaný
bábelský	bábel
bídarský	bída
velický	velice
kuběnovský	kuběna
hrazenářský	hrazení
tříboký	trojboký
stranský	strana
dvojboký	dvojný
protijezuitský	jezuitský
transalpínský	alpinský, alpínský, lipský
tasilský	tasit, task
rozvážňoučký	rozvážný, rozvažný, rozvážně
krevský	krev, kráva
protiquebecký	quebecký
protiquébecký	quebecký
protisyrský	syrský
velecký	velký
dobrotivský	dobrotivý
zaatlantický	atlantický
kytlický	kytlice, kytle
neokonfuciánský	konfuciánský
metlický	metlice, metla
dřevárnický	dřevárna
třídvorský	třída
podroháčský	roháčský
neopluralistický	pluralistický
protialbánský	blanský
protialergický	alergický
předškolský	školský
předsovětský	sovětský
chorografický	choreografie
panhelénský	helenský, helénský
tupoučký	tupý
tungský	tunga
kopecký	kopec, kopka
kottický	kotit, kota
brahmický	brahma
slepoučký	slepý, slepo
botnický	botník
protipartyzánský	prota
bařtipánský	bařtipán
chiliastický	chiliasmus, chiliasta
radarácký	darák
supertěžký	těžký, těžko
cigánský	cigán
protoindický	indický
předsokratovský	sokratovský
protiimigrantský	imigrantský
subalpinský	alpinský
protidisidentský	disidentský
zářečský	zářečí
luciferský	lucifer
předšpanělský	španělský
předtkalcovský	tkalcovský
unionský	union, unionizmus
rekatolický	katolický
triumfalistický	triumfalizmus, triumfální
postthatcherovský	thatcherovský
ruchovský	ruch, ruchový
protilatinský	latinský
měšecnický	měšec
podfarmářský	farmářský, farmář, farmářka
loutocký	loutocky
lahodňoučký	lahodný
ultraměštácký	ultraměštácky
předromantický	romantický, mantický
mezolitický	mezolit
entologický	antologie, logický, ontologie
studánecký	studánka
pískovský	pískový
generický	gen, generikum
přehorký	horký
protifederalistický	protifederální
transpacifický	pacifický
vratkovský	vratek, vratka, vratko
krajkovský	krajka
ezoterický	ezoterika, ezoterik
padesátnický	padesátník, desátnický
neomalthusiánský	malthusiánský
neoplastický	neoplasma, neoplazma
postklausovský	klausovský
helioskopický	helioskop
poosvícenský	osvícenský
partikularistický	partikularizmus, partikulární, partikularismus
bicyklický	cyklický, bicykl, cykl, cyklus
lysinský	lysin
teploulinký	teplounký, teplý
předřímský	římský
běličký	bělit, bělič, bílek, bílý, bíle, bělice
útličký	útlý
neoodborářský	odborářský
doubravnický	doubravník, doubrava
protišosácký	protišosácky
bifázický	fázický
předmikulášský	mikulášský
monolitický	monolit
předschengenský	schengenský
bronchologický	bronchologie
živoučký	živý, žít, divý
protikonfuciánský	konfuciánský
šiatorský	šitý
divňoučký	divný, divý
karambolický	karambola, karambol
vraždovský	vražda
svatovítský	svatý, svat
rífský	rúf
protizlodějský	zlodějský
dvoustranický	dvoustrana
protiperský	tiperský
protisymetrický	symetrický
ošklivoučký	ošklivý
exkluzivistický	exkluzivizmus, exkluzivní
yoyobanďácký	yoyobanďácky
protichartistický	chartistický, prota
zavadilský	zavadit, vada
zapatistický	zapatista
podemokratický	demokratický
sociogeografický	geografický
semiautomatický	automatický
sklepovský	sklep
exděčínský	děčínský
monologický	monolog
transamerický	americký
lobbyistický	lobbyista, lobby
poddědický	dědický
hektický	hektik
konjunkturalistický	konjunkturalista, konjunkturalizmus, konjunkturalismus, konjunkturální
martinistický	martinista
sekerářský	sekera
průměrňoučký	průměrný, průměr
vytahovácký	vytahovák
protihusitský	husitský
postudentský	studentský
patarenský	patarén
přesoceánský	oceánský
přechudičký	chudičký
alochromatický	chromatický
roentgenologický	rentgenologie
sečský	sek
předverdiovský	verdiovský
výměnický	výměnice, výměník
subvydavatelský	vydavatelský, vydavatel
předvalentýnský	valentýnský, valentinský
předvelkomoravský	velkomoravský
bezzvuký	zvuk
hamasistický	hamasista
kostnický	kost, kostnice, kostna
melanistický	melanizmus, melanismus
bakteriostatický	bakterie
desetnický	desetník
mastňoučký	mastný, mást, mast
fundamentalistický	fundamentalizmus, fundamentalista
plešaťoučký	plešatý
dvojjaký	dvojka, dvojí, dvojný
romskočeský	romský
dvojaký	dvojka, dvoják
zlaťounký	zlatý
ultralehký	lehký
elektrodiagnostický	diagnostický
protiepidemický	epidemický
ozdobnický	ozdoba, ozdobný, ozdobnice
protimilitaristický	militaristický
subatlantický	atlantický
trapňoučký	trapný, trap
rezofonický	fonický
heraldický	heraldika
populacionistický	populace, populacionizmus
předzámecký	zámecký, zámek
neokapitalistický	kapitalistický, kapitalista
transpadánský	padánský
protimarcosovský	marcosovský
kostumbristický	kostumbrizmus
matematickostatistický	matematický
asomatický	somatický
protikolonialistický	protikoloniální
gnomonický	gnómon
amidistický	amid
semický	sem
nazogastrický	gastrický
zmijinský	zmijí
levňoučký	levný
pleochroický	pleochroizmus
parasurrealistický	surrealistický
makovický	makovice
prachmiliónský	miliónský
tachometrický	tachometr
eurofilský	eurofil, -fil-, fil
čtyrboký	čtyřboký
klapský	klapka
krátkoruký	krátký
patognomický	gnomický
transalpský	alpský
novelský	novela
monumentalistický	monumentalista, monumentalizmus, monumentalismus
vagónářský	vagonář, vagónář, vagón
poststrukturalistický	poststrukturalizmus, poststrukturalismus
sedmihůrský	sedmihorský
psychoneurologický	neurologický
neoarktický	arktický
křivský	křivo
postmaterialistický	materialistický
voluntaristický	voluntarista, voluntarizmus, voluntarismus
románský	román
postchartistický	chartistický
čerňoučký	černý, černík, řečný, kerný
nadsvětský	světský
zmilitký	zmilitka
fysiokratický	fyziokrat, fyziokratický
předwimbledonský	wimbledonský
tříoký	trojoký
hernský	herna, herní
kryptický	krypta
celoučký	celý
exlitvínovský	litvínovský
zastávecký	zastávka
areografický	area
maliličký	malý, maliník
izostatický	izostat
okrouhlecký	okrouhlý
světlooký	světlo
egofuturistický	egofuturizmus, egofuturista
subatomický	atomický
protirácký	trácký
difuzionistický	difuzionista, difuzionizmus
kovanecký	kovanec
protibiologický	biologický
neoklasický	neoklasik, klasický
pohodnický	pohodnice, pohoda
předstalinský	stalinský
neofenomenologický	fenomenologický
sentimentalistický	sentimentální, sentimentalista, sentimentalizmus, sentimentalismus
beachházenkářský	beachházenkář
komorský	komora
seizmonastický	seizmonastie
empirický	empirik, empir
proteosyntetický	proteosyntéza, syntetický
chronický	chron
buclaťoučký	buclatý
eurofederalistický	eurofederalista, eurofederalismus
elegiacký	elegie
posarajevský	sarajevský
autsajderský	autsajdr
fantasmatický	fantazma
protisovětský	sovětský
dispašerský	dispašér
psychosociologický	psychosociolog
neohinduistický	hinduistický, hinduizmus
analistický	analista
syntagmatický	syntagmatika
alicyklický	cyklický
sociopsychologický	psychologický
molický	mol
pšánský	peán
protochetitský	chetitský
protikremelský	kremelský
nudistický	nudista, nudizmus, nudismus
stejnověký	stejně
obyčejnský	obyčejný
neolitický	neolit
protiakademický	akademický
šemický	šém
dvouoký	dvojoký
mimoetický	mimetický, mimetizmus
ultramikroskopický	mikroskopický
chromografický	chromograf
illitický	illit
metabolický	metabolizmus, metabolista
portugalský	portugal
chlupaťoučký	chlupatý
předplavecký	plavecký, plavec
meziměstský	meziměsto
modrokrký	modrý
protisklerotický	sklerotický
předpěstounský	pěstounský
protekcionalistický	protekcionalizmus, protekcionalismus
heterosylabický	sylabický
fosfatický	fosfát
protinovinářský	novinářský
judicialistický	judicielní
protimasarykovský	masarykovský
operacionalistický	operacionalizmus, operacionalismus, operace
kubofuturistický	kubofuturizmus, kubofuturista
exprostějovský	prostějovský
protivlastenecký	vlastenecký
protimarxistický	marxistický
turnianský	turn
mazovský	mazový, maz
protilidský	lidský, lipský
jasenský	jas
primitivistický	primitivizmus, primitivní, primitiv
hypnotický	hypnotikum, hypnóza
protidarwinovský	darwinovský
autosémantický	autosémantikum
purististický	purista, puristický, purizmus
stolický	stůl
proticentralistický	centralistický
celoirský	celý
ulický	ulice
lovenský	lovení
multipartistický	multipartizmus
trojoký	trojka
protifanouškovský	fanouškovský
kosmopolitický	kosmopolit
explosionalistický	explosionalismus
starovodský	star
postkumunistický	postkomunizmus
středolatinský	střed
myasthenický	myastenie
klientelistický	klientelizmus, klient, klientela
veselounký	veselý
protispartský	spartský
ultravysoký	vysoký
protiintelektuálský	intelektuálský
protisaddámovský	saddámovský
neorománský	románský
boccistický	boccista
termoelektrický	elektrický
termoplastický	termoplast
utilitarianistický	utilitarianista, utilitarianizmus, utilitarianismus
energistický	energie, energický
předivoký	divoký, předivý
pragmatický	pragmatika
staropacký	staropacky
paramilitaristický	militaristický, militarizmus
středomořský	střed
normativnětechnický	norma
sálský	sál
nadfyzický	fyzický
komparativistický	komparativní, komparativ
šoumenský	šoumen
ultrademokratický	ultrademokrat, demokratický
biochromatický	chromatický
logografický	logograf
pokřesťanský	křesťanský
prakticistický	prakticizmus, praktický, praktika, praktik, prakticismus, prakticista, praktikum
předsarajevský	sarajevský
monotónický	monotonie, tonus
subchronický	chronický
periskopický	periskop
vírský	vír
mládský	mládí, mladý, mlada
malučký	malý, maličký
senzitivistický	senzitivní, senzitiv
thatcheristický	thatcherizmus, thatcherista, thatcherismus
paleolitický	paleolit
ypsilonovský	ypsilon, ypsilonový
fizulský	fizule
protisandinovský	sandinovský
protisládkovský	sládkovský
noxický	nomický
encefalografický	encefalograf
anamorfický	anamorfa
šibenický	šibenice
oscilografický	oscilograf
podlipský	lipský
hydrochemický	chemický
dvojoký	dvojka, dvojný, dvojí
protiněmecký	německý
podnovinářský	novinářský
transatlantský	atlantský
perkusionistický	perkusionista
dereistický	reistický, reizmus
vibrafonistický	vibrafonista, vibrafon
polootrokářský	polootrok
sulfatický	sulfát
levoruký	levý
exotermický	termický
novářský	nova
popartistický	popartista
podegaullovský	degaullovský
protinacionalistický	nacionalistický
superstarovský	superstar, superstarový
novoitalský	nový
okenský	okno
prostořeký	prostý
jednooký	jedno
grálistický	grálista, grál
transasijský	asijský
transantarktický	antarktický
velkoměšťácký	velkoměšťák
protinacistický	nacistický
hnojnický	hnůj, hnojník
sapfický	sapa
pangalaktický	galaktický
ultrakvistický	ultrakvista
polodbornický	polodborník
ředinký	ředit, ředina
mandlooký	mandle
husický	husice
štěpnický	štěp, štěpnice
keratolytický	keratolytikum
poloautomatický	poloautomat, automatický
splavský	splav, splavení, splavit
mírňounký	mírný, mír
protimenclovský	menclovský
edématický	edém
exblšanský	blanský
atematický	tematický
zeleňounký	zelený, zelení, zeleno
vopravdovský	pravda, opravdu, opravdovský
polotmářský	polotma
protijakobínský	jakobínský
hekatombický	hekatomba
samotinký	samota, samo
protimadridský	madridský
protimarhoulovský	marhoulovský
autosyntagmatický	syntagmatický
eukaryontický	eukaryonta
předsóánský	sóánský
filumenistický	filumenie
zologický	zoologie, logický
homotypický	thema
dobrounký	dobrý, bodrý
amaterský	amatér
přioceánský	oceánský
protiosmanský	masný, osmanský
exšumperský	šumperský
prohibicionistický	prohibicionizmus, prohibicionista, prohibice
almaatský	alma
holotropický	holotropní
štítský	štít
protifašistický	fašistický, tašistický
pubický	pub
transhimálajský	malajský, himálajský
ořešský	ořech, ořeší
protiseizmický	seizmický
patetický	patetika, pata
pragocentrický	pragocentrizmus
protisymbolistický	symbolistický
proticastrovský	castrovský
protoislámský	islámský
byrokratickocentristický	byrokratický
bagský	bag
monopolitický	monopol, monopolní, monopolizmus
piktografický	piktograf
postmarxistický	marxistický, marka
intervokalický	vokalický
živounký	živý, divý, čivý
životický	život
alotropický	alotropní
automilionářský	milionář, milionářský
pravoruký	pravý
paleozoický	paleozoikum
maximalistický	maximalista
konceptualistický	konceptualizmus, konceptualista, konceptuální, konceptualismus, koncept
zoonotický	zoonóza
neoosvětářský	osvětářský
subekumenický	ekumenický
transaljašský	aljašský
hydroskopický	hydroskop
krásňounký	krásný
skřivánecký	skřivánek
antivirotický	antivirotikum
miniaturistický	miniaturista, miniatura, miniaturní
přikarpatský	karpatský
polorybářský	rybářský
servitský	servita
pedostomatologický	somatologický
moonistický	moonista, mono
neoklasistický	neoklasický
parasympatomimetický	parasympatomimetikum
amigistický	amigista
expardubický	pardubický
mýtomanský	mytomanie
monocyklický	cyklický
sarkastický	sarkasta, sarkastka, sarkastik, sarkazmus
protiluxovský	luxovský, luxus
plňoučký	plný
bioelektrický	elektrický
kelský	kel
kaustický	kauza
polomafiánský	polomafián
předturecký	turecký
protichorvatský	chorvatský
bílooký	bílý
volňounký	volný, volní
tragikomický	tragikomika
karlistický	karlista
exkrumlovský	krumlovský
biopsychický	psychický
protimaďarský	maďarský
foenický	foen
protisudetoněmecký	sudetoněmecký
starotibetský	starý
ultrapragmatický	pragmatický
časoměřický	časoměřič
bikvadratický	kvadratický
záhadologický	záhadologie
modřecký	modře, modrý
laiský	laik
brzoučký	brzký
interkomunistický	komunistický
polycyklický	cyklický
veverský	veverka
prosťounký	prostý
magnetoterapeutický	magnetoterapie, magnet
poloteroristický	teroristický, teror
státostranický	státostrana
akrocentrický	centrický
mezenchymatický	mezenchym
mářský	mařit
piktorialistický	piktorialismus, piktorializmus
syndikalistický	syndikalista, syndikalizmus, syndikalismus
dochtorský	dochtor
beztoký	tok
jednocyklický	jednocyklový
jemňoulinký	jemňounký, jemný
patogenický	patogen
polonaturalistický	naturalistický
archaický	archaizmus, archaizace
barský	bar
velikooký	veliký
supermanovský	superman
mosaický	mozaika, mosaika
diagenetický	diageneze
camorristický	camorra
enviromentalistický	enviromentalizmus, enviromentální
protiepileptický	epileptický
bioanalogický	analogický
dosovský	dosový
anachronistický	anachronizmus, anachronický, anachronismus
polychromatický	polychromie, polychromní, chromatický
pletysmografický	pletyzmografie
rudoarmějský	rudoarmějec
předtereziánský	tereziánský
židký	žid
převelký	velký
explozionalistický	explozionalizmus, explozionalismus
podbranský	branský
chmelenský	chmelený
starobabylonský	starobabylónský
partenogenetický	partenogeneze
sympatomimetický	sympatomimetikum
homocentrický	chemický, chemie
justicialistický	justice
exsovětský	sovětský
postmečiarovský	mečiarovský
heboulinký	hebounký
hubeňounký	hubený, hubník, huba
hypotaktický	hypotaxe
canisterapeutický	canisterapie
lytický	litický
starožidovský	star
pikolický	pikolice, pikolík, pikola
dermatoskopický	dermatoskop
topocentrický	cent
goistický	goista
submetacentrický	metacentrický, centrický
komsomolský	komsomol, komsomolec
protoelamský	elamský
daseinsanalytický	daseinsanalýza
velikoruský	veliký
farmaceutický	farmaceutika, farmaceut, farmaceutikum
akatalektický	katalektický
předpoetistický	poetistický, poetický, poetizmus
psinský	psina
administrativněstatistický	administrace
protizpravodajský	zpravodajský
exsocialistický	exsocialista, socialistický
proklepáčovský	proklepat
polootrocký	polootrok
předřecký	řecký, řeka
čerňounký	černý, černík
transoceánský	oceánský
uměleckografický	umělec
extřinecký	třinecký
torický	torus
nahoučký	nahý
postwarholovský	warholovský
protisocialistický	socialistický
holubovský	holub
pologeometrický	geometrický
nadmořský	mořský
želský	žel, želka
montmorillonitický	montmorillonit
fyzický	fyzika
minigrafický	minigraf
saframentský	sakrament
pedocentrický	pedocentrizmus, centrický
krásnooký	krásný
chlororganický	chlor
audiografický	radiografie
videofonický	videofon, videofonní
idiotický	idiot, idiotie
epický	epos
polobeletristický	letristický
postkapitalistický	kapitalistický
svobodský	svoboda
adiagnostický	diagnostický
sociopolitický	politický
ekotoxický	toxický
bezsuký	suk, soukat, sok
polovysoký	lest
dokumentografický	dokument
iracionalistický	iracionalista, iracionalizmus, iracionální, iracionalismus, racionalista
extralehký	lehký
štípský	štíp, štítský
přímoskevský	moskevský
patický	pata, pat
syntetický	syntetika, syntetizmus
vodovský	voda, vodový
exprešovský	prešovský
červeňounký	červený, červeň
trichromatický	chromatický
polodemokratický	demokratický
polyfyletický	polyfyletizmus
jednovoký	jedno
porýnskofalcký	porýnský
proticharvátský	charvátský
talský	tala
vrtbovský	vrtba
oranžovoučký	oranžový
protistranický	protistrana, stranický
postbalzakovský	balzakovský
propedeutický	propedeutika
hezoulinký	hezounký, hezounek
odický	óda, ód
protidynastický	dynastický
subsaharský	saharský
velkořecký	velkořecky
intuitivistický	intuitivizmus
havlíčskobrodský	havlíčkobrodský
gardský	gard, garda
bystrooký	bystrý
pažský	paže
anankastický	anankasmus, anankazmus
multistranický	stranický
bódhisattvický	bódhisattva
egocentrický	egocentrizmus
epodický	epóda
telocentrický	centrický
postfrankistický	frankistický
skotopický	skot
protisolženicynovský	solženicynovský
abiogenetický	biogenetický, abiogeneze
exchomutovský	chomutovský
televangelistický	televangelista
fázický	fáze
protimuslimský	muslimský
zářecký	zářek, září
skoliotický	skolióza, skoliotikum
poloměkký	měkký
nadideologický	ideologický
maradakertský	mardakertský
obrocký	obrok
videoskopický	videoskop
zřídký	řídký
patchworkovský	patchwork
polymelodický	melodický
lockovský	lock
fyziochemický	fyzický
hloupounký	hloupý
osciloskopický	osciloskop
perocentrický	centrický
šovický	šouf
postmagmatický	magmatický
mechanickochemický	mechanický
polochemický	chemický
protimečiarovský	mečiarovský
elektroterapeutický	elektroterapie
psychoekonomický	ekonomický
polosladký	sladký, sladit
protifrankistický	frankistický
polostudentský	studentský
severoirský	sever
křestaňskodemokratický	křesťanskodemokratický
exostravský	sex
postklasický	klasický, klastický, klas, klasa
kolský	kůl, kola, kolář
protimaastrichtský	maastrichtský
protistalinský	stalinský
daleký	dál
excentrický	excentr, excentrista, centrický
apodiktický	apoda
exjugoslávský	jugoslávský
postapokalyptický	apokalyptický
staroirský	starý
lehkotěžký	lehký
transevropský	evropský
protipalestinský	palestinský
protilepenovský	lepenovský
protireaganovský	reaganovský
emfatický	emfáze
anglosaský	anglosas
ultramontánský	ultramontanizmus
traický	trák
staroarménský	star
velkodramatický	velkodrama
subetnický	etnický, ethnický
vratký	vrata, vrátit, vrtat
patognomonický	pat, gnomonický
audiofilský	audiofil
eratický	arita
biopolitický	biopole
suchozemský	suchozemec
nematoblastický	blastický
černosotěnecký	černosotněnec, černosotěnec
ultramonarchistický	monarchistický
subjektivistický	subjektivní, subjektivizmus
severoruský	sever
exsokolovský	sokolovský
temnooký	temno
severofríský	severofrízský
fialovoučký	fialový
exkladenský	kladenský
laternomagický	laterna
venský	ven
transjordánský	jordánský
rychloruký	rychlý
starořecký	starý
autentický	autentika
aplastický	plastický
protobulharský	bulharský
panchromatický	chromatický
protimalarický	malarický
subnordický	nordický
velkodílenský	velkodílna
intermetalický	metalický
posttraumatický	traumatický
podhimálajský	himálajský, himalájský
polosyntetický	syntetický
podjavorinský	javorinský
piezoelektrický	piezoelektrikum, elektrický
semiempirický	empirický
pětiboký	pět
ortorombický	rombický
apomiktický	apomixie
postkatastrofický	katastrofický, post
široboký	širý
orogenetický	orogeneze, genetický
mikrointervalický	mikrointerval
žhavooký	žhavý
elektrický	elektrika
polosocialistický	polosocializmus, polosocialismus
ultrarelativistický	relativistický
klerofašistický	klerofašista, klerofašizmus, klerofašismus
protinarkotický	narkotický
klassický	klasika, klasik, klas, klasický
austroněmecký	německý, mecký
transatlantický	atlantický
podsaharský	saharský
uměleckoakustický	umělecký
transgenetický	genetický, genetika
středoplatónský	střed
starochuchelský	starý
epigenetický	epigeneze, genetický
vysokotlaký	vysokotlak
středoanglický	střed
protislovenský	slovenský
tragický	tragedie
zelenokrký	zelený
mimostranický	stranický
exstrakonický	strakonický
černoprdelnický	černoprdelník
telekinematický	telekineze
postdemokratický	postdemokracie
politbyrokratický	politbyrokrat
intuicionistický	intuicionista, intuicionizmus, intuicionismus
protiseleukovský	seleukovský
onaký	onak
krátký	krát, kráčet
velikopanský	velkopanský
středoegyptský	střed
komiský	komise
libovoučký	libý, libový
východoindický	východní
mělký	mělko
imunoanalytický	imunoanalýza
eklektický	eklektik
šopský	op
nanokrystalický	nanokrystal, krystalický
konciliaristický	konciliarizmus, konciliarismus
jasnooký	jasno
klimatoterapeutický	klimatoterapie
psovský	pes
širokoboký	široboký
červenostonký	červenost
eklamptický	eklampsie
poststalinský	stalinský, poststalinismus
polokatolický	katolický
exmostecký	mostecký
modrooký	modrý
celomoravský	moravský
polykrystalický	polykrystal
malostranský	stranský
poloanarchistický	anarchistický
afotický	afonie
starohorský	starohory
expísecký	písecký
suprematistický	suprematizmus, suprematista
mnohostranický	stranický, strana
hořký	horký
protický	próza
staroitalský	starý
pyrometalurgický	metalurgický
ergoterapeutický	ergoterapie
technorobotický	techno
exboleslavský	boleslavský
nukleosyntetický	nukleosyntéza
postkubistický	postkubizmus, kubistický, postkubismus
poloeliptický	eliptický
finskošvédský	finský
mezispojenecký	spojenecký
polobolševický	bolševický
hrdinskoepický	hrdinský
velkodrůbežárenský	velkodrůbežárna
hezký	hezko
postneorealistický	neorealistický
královehradecký	královéhradecký
hiphoperský	hiphoper, hiphop
starořímský	starý
morfogenetický	morfogeneze
široký	širo, širý
dlouhoruký	dlouhý
monosylabický	sylabický, sylaba
rovnotlaký	rovno
orogenický	orogen, orogén
muský	museum, muset
protispolečenský	společenský
expříbramský	příbramský
vědeckotechnický	vědecký
anglonormanský	normanský
středohornoněmecký	střed
severogermánský	sever
velkomocenský	velkomocný
křivooký	křivý, křivka
malooký	malý
makrospolečenský	společenský
rychlosprávkárenský	rychlosprávkárna
horšovskotýnský	horšovský
předshakespearovský	shakespearovský
tmavooký	tmavý
severoirácký	severoirácky
postsynaptický	synaptický
středoafghánský	střed
semipalatinský	palatinský
zlatooký	zlato
karákóramský	karakoramský
filosofickohistorický	filozofický
uralskoaltajský	uralský
agropotravinářský	potravinářský
horký	horka, hrát, hořký
afrokaribský	frak
dolnoegyptský	dolní, dolný
středoněmecký	střed
středovelkoruský	střed
lacký	lak, lák, lakový
polymetalický	metalický, polymetal
exkarlovarský	karlovarský
polokulaťoučký	polokulatý
indomalajský	malajský
středoitalský	střed
starojesenčanský	staro
staroíránský	starý
ischematický	ischemie, schematický
středovietnamský	střed
středoafrický	střed
středoelamský	střed
mnohoruký	mnohý
ský	sek, ska, ski
polycentrický	polycentrizmus, centrický
mechanoakustický	mechanizmus
západoslovanský	západ
podkrušnohorský	krušnohorský
postčeskoslovenský	československý
hornopožárský	požár
středoasyrský	střed
dolnorychnovský	dolní
středoevropský	střed
protinapoleonský	napoleonský
poloparazitický	poloparazit
multilingvistický	multilingvizmus, multilingvismus
středooceánský	střed
šikmooký	šikma, šikmý
středoaustralský	střed
mimospolečenský	společenský
vnitroodborářský	vnitro
středomoravský	střed
podbělohorský	bělohorský
podkarpatoruský	karpatoruský
středoatlantský	střed
smutnooký	smutný
dolnodunajský	dolní, dolný
jihobosenský	jih
západomongolský	západ
středoopavský	střed
dolnorakouský	dolní
křesťanskoafrický	křesťanský
vnitrorakouský	vnitro
západoslavonský	západ
vnitroevropský	vnitro
jihonizozemský	jih
latinskoamerický	latinský, latinka
kriminalistickotechnický	kriminalistický
plynárenskoenergetický	plyn
nízkoalkoholický	nízko
