reálsocializmus	reálsocialismus
antikonzumerizmus	antikonzumerismus
antivietnamizmus	antivietnamismus
voltairianizmus	voltairián
bikameralizmus	bikameralismus
poststrukturalizmus	poststrukturalistický, poststrukturalismus
abstrakcionismus	abstrakcionizmus, abstrakce
gongorismus	gongorizmus
berlusconizmus	berlusconismus
nazarenismus	nazarenizmus
wallenrodizmus	wallenrodismus
hyperkortikalizmus	hyperkortikalismus
ultrakonservatismus	ultrakonzervatizmus
antropologizmus	antropologie, antropologismus, antropologický
abstrakcionizmus	abstrakce, abstrakcionista
integralizmus	integrální, integrovat, integralismus
evangelikalizmus	evangelikalismus, evangelikální, evangelikál, evangelický
dokumentarizmus	dokument, dokumentní, dokumentaristický, dokumentovat, dokumentární
gangsterizmus	gangsterismus, gangster, gangsterský
dadaizmus	dada, dadaismus
henoteizmus	henoteismus
autoritatizmus	autorita, autoritatismus, autoritativní
buranizmus	buran, buranismus
europrotekcionizmus	europrotekcionismus
neoliberalizmus	neoliberální, neoliberalismus
neutralizmus	neutrální, neutralismus, neutrum, neutrál
chromatizmus	chromatický, chromatismus
literalizmus	literální, literalismus
adopcianismus	adopcianizmus, adopce
neovitalizmus	neovitalismus, vitalizmus
mediumizmus	mediumismus, médium, medium
neoizolacionizmus	neoizolacionismus
sebekriticizmus	sebekritický, sebekritika
frankocentrizmus	frankocentrismus
eurofederalismus	federalizmus
cloisonnizmus	cloisonné
ultraliberalizmus	ultraliberalismus, ultraliberální, ultraliberalistický, liberalizmus
neosurrealizmus	neosurrealismus, surrealismus, surrealizmus
astigmatizmus	astigmatický
ptyalizmus	ptyalismus
konjukturalismus	konjunkturalizmus, konjunkturální
postsocializmus	socializmus
neoexpresionizmus	expresionizmus
druidizmus	druid
abstraktivizmus	abstraktivní, abstrakt, abstrakce, abstraktní, abstraktum
katastrofizmus	katastrofa, katastrofismus, katastrofický
postimpresionizmus	impresionizmus
operacionalizmus	operace, operacionalistický, operační
ultraimperializmus	ultraimperialismus
komunalizmus	komunální, komunalismus
protagonizmus	protagonista, protagonismus
monumentalizmus	monumentalistický, monumentální, monumentalismus, monument
destrukcionizmus	destrukce
regmatizmus	regma
faraonizmus	faraonismus, faraonský, faraon
kondicionalizmus	kondicionální, kondicionalismus, kondicionovat, kondicionál
kontextualizmus	kontextuální, kontext, kontextualismus
asocianizmus	asocianismus, asociální
subrealizmus	subrealismus, realizmus
rayonizmus	rayon
falzifikacionizmus	falzifikacionismus
diamagnetizmus	diamagnetismus, diamagnetický, magnetizmus
naturalizmus	naturální, naturalismus, naturalistický
antagonizmus	antagonistický, antagonista, antagonismus
misantropizmus	misantropie, misantropický, misantrop, misantropismus
neoracionalizmus	racionalizmus
neoabsolutizmus	neoabsolutismus
konvencionalizmus	konvencionální, konvence
neosatanizmus	satanizmus
homoerotizmus	homoerotický, homoerotismus
elementarizmus	elementární, element
neomarxizmus	marxizmus, neomarxistický
achromatizmus	achromatismus, chromatizmus, achromatický
eurocentrizmus	eurocentrický, eurocentrismus, eurocentristický, centrizmus
prohibicionalizmus	prohibice
neotomizmus	neotomismus
libertinizmus	libertin, libertinismus, libertinský
mutualizmus	mutualismus
expresivizmus	expresivní, exprese, expres, expresivismus
rusocentrizmus	rusocentrismus, rusocentrista
protokubizmus	protokubismus, kubizmus
singularizmus	singulární, single
protekcionalizmus	protekce, protekcionalistický
monoteizmus	monoteismus
marxleninizmus	marxleninismus
verifikacionizmus	verifikacionismus
komercializmus	komerciální, komerce, komercialismus
animatizmus	animatismus
organicizmus	organicismus, organik
paramagnetizmus	paramagnetismus, paramagnetický, magnetizmus
proselytizmus	proselytismus
ultraformalizmus	ultraformalista, ultraformalismus
biofanatizmus	biofanatismus
genscherizmus	genscherismus
komenzalizmus	komenzalismus
neonacionalizmus	neon
konciliarizmus	konciliární, konciliarismus, koncil
titanizmus	titánský, titán
hypopituitarizmus	hypopituitarismus
ekocentrismus	ekocentrizmus
instrumentalizmus	instrumentalistický, instrumentální, instrumentalismus
fénicizmus	fénicismus
exkluzivizmus	exkluzivní, exkluze, exklusivní
explozionalizmus	exploze, explozionalismus, explozní
zoomorfizmus	zoomorfismus
evropocentrizmus	evropocentrismus
morganizmus	morgan
galvanizmus	galvanismus, galvanický
fenomenalizmus	fenomenální, fenomenalismus
ekoanarchizmus	ekoanarchismus
donchuanizmus	donchuán, donchuánský, donchuanismus
utilitarianizmus	utilitární
filosemitizmus	filosemitismus, filosemita
voluntarizmus	voluntární
sociálimperializmus	sociálimperialismus
teocentrizmus	teocentrický
moskvocentrizmus	moskvocentrismus
revolucionizmus	revoluční, revoluce, revolucionismus
panenteizmus	panenteismus
kulteranizmus	kulteranismus
epikureismus	epikureizmus, epikúreismus, epikúreizmus
kongregacionalizmus	kongregace, kongregacionální
mondializmus	mondialismus, mond
satanizmus	satan, satanismus, satanský, satanický
protekcionizmus	protekcionistický, protekce, protekcionismus
agrarizmus	agrarismus
plutokratizmus	plutokratický, plutokracie, plutokrat
paviánizmus	pavián, paviánismus
neoslavizmus	neoslavismus
produktivizmus	produktivní, produkce, produkt
geocentrizmus	centrizmus, centrický, geocentrický, centrismus, geocentrismus
monofyzitizmus	monofyzitismus
kreacionizmus	kreacionismus, kreacionistický, kreace
utilitarizmus	utilitarismus, utilitární, utilitaristický, utilitarista, utilita
prezentizmus	prezentismus, prezent
diogenizmus	diogenismus
metodizmus	methodistický, metodismus, methoda
konsekvencialismus	konsekvence
resortismus	rezortizmus, resortizmus, rezortní
neorealizmus	realizmus, neorealismus, real
personalizmus	personalistika, personální, personalismus, personál, personalistický
moralizmus	moralismus, moralistický, morální
perskriptivizmus	perskriptivní
nefiguralizmus	nefiguralismus
bradypsychizmus	bradypsychismus
zarathustrizmus	zarathustrismus
jezuitizmus	jezuita
manierizmus	manierismus
césaropapismus	césaropapizmus
neotaoizmus	neotaoismus
slovakocentrizmus	slovakocentrismus
keynesizmus	keynesismus
pansexualizmus	pansexualismus
monopsychizmus	monopsychismus
vizualizmus	vizuální, vizualismus, visuelní, vizuelní, vizuál
pyrrhonizmus	pyrrhonský
energetizmus	energetismus, energetický, energie
biomagnetizmus	biomagnetický, biomagnetismus
mongolizmus	mongolismus
egalitarizmus	egalitarismus
ultraslavizmus	slavizmus
libertanianizmus	libertanianismus
behavioralizmus	behavioralismus, behaviorální
simultaneizmus	simultaneismus, simultánní
eurorealizmus	eurorealismus, realizmus
ultrarevizionizmus	ultrarevizionismus
indianizmus	indiánský, indium
efektivizmus	efektivní, efekt, efektní
elektrotropizmus	elektrotropismus, elektroterapie
humanitizmus	humanita, humánní, humanitní
nacionálsocializmus	nacionálsocialismus
paralogizmus	paralogismus
paleomagnetizmus	paleomagnetický
monogenizmus	monogenismus
mitterrandizmus	mitterrandismus
šarlatanizmus	šarlatán, šarlatánský, šarlatanismus
europesimizmus	europesimismus
independentizmus	independentismus
metalogizmus	metalogika, lego, metalogický, legizmus
saprofytizmus	saprofyt, saprofytismus, saprofytický
neologizmus	neologismus, neologický, neologistický
breatharianizmus	breathariánský, breatharián
metrarchizmus	metrarchie
proletarizmus	proletarismus
biokolonializmus	biokolonialismus
dikrotizmus	dikrotismus
idealizmus	idealismus, idea, ideální, ideál
experimentalizmus	experimentální, experiment
ultranacionalizmus	ultranacionalismus, ultranacionalistický, ultranacionalista
hungarizmus	hungarismus, hungaristický, hungarista
sigmatizmus	sigma
absentismus	absentizmus, absence
galikanizmus	galikánský, galikanismus
ruralizmus	ruralismus, rurální
biomechanizmus	biomechanika, biomechanik, biomechanismus, mechanizmus
profétizmus	profetický, profétismus
velkohungarizmus	velkohungarismus
kostumbrizmus	kostumbristický
luddizmus	luddismus
merkantilizmus	merkantilismus, merkantilní, merkantilie
divizionizmus	divizionismus, divize
byzantinizmus	byzantinismus
hominizmus	hominismus
mechanicizmus	mechanický, mechanicismus, mechanika
patriarchalizmus	patriarchální
argyrizmus	argyrismus
panpsychizmus	psychizmus, panpsychismus, pumpa
xantorizmus	xantorismus
manažerizmus	manažér
intimizmus	intimní, intimovat
psychovitalizmus	psychovitalismus
panafrikanizmus	panafrikanismus, panafrický
gestualizmus	gestualismus
enviromentalizmus	enviromentalismus, enviromentální
maďarizmus	maďarismus
perónizmus	perón, perónismus
okasionializmus	okasionialismus
syndikalizmus	syndikalismus, syndikovat, syndikalistický
karambolismus	karambola
difuzionizmus	difuzionismus
kofeinizmus	kofein
anabaptizmus	anabaptismus, baptizmus
letrismus	letrizmus
externizmus	externí, externismus, externista
malthuzianizmus	malthuzián, malthuziánský, malthusiánský, malthuzianismus
antinomizmus	antinomismus
sebeerotizmus	sebeerotismus
supranaturalizmus	naturalizmus, supranaturální
neoromantizmus	neoromantický, romantizmus
fedonizmus	fedonismus
revivalizmus	revival, revivalismus
ultramodernizmus	modernizmus
indeterminizmus	determinizmus, indeterminismus
geotropizmus	geotropismus, geotropický
hujerizmus	hujerismus, hujer
gaullizmus	gaullismus
dysfemizmus	dysfemismus
pleonazmus	pleonasmus
muralizmus	muralismus, murální
avanturizmus	avantura
biocentrizmus	biocentrum, centrizmus, biocentrický, centrum, biocentrismus
feromagnetizmus	feromagnetický, feromagnetismus
rusofilizmus	rusofil, rusofilní, rusofilský, rusofilismus
bhaktizmus	bhaktismus, bhaktický
metalizmus	metalismus, metalický, metal
marginalizmus	marginální, marginalismus
donatizmus	donatismus
reaganizmus	reaganismus
neoprimitivizmus	primitivizmus
postsurrealizmus	postsurrealismus, postsurrealistický
kinetizmus	kinetismus, kinetický, kinetika
polyteizmus	polyteismus, teizmus, meta
bioorganizmus	bioorganismus, organizmus
neodadaizmus	neodadaismus
revizionizmus	revizionismus, revize, revizionistický, revizionista
pluralizmus	plurální, pluralismus, plurál
panteizmus	panteismus, pant
montanizmus	montanismus, montanista
postkomunizmus	komunizmus, komuna
panslavizmus	slavizmus
masochizmus	masochismus
katenoteizmus	katenoteismus
bronchospazmus	bronchospasmus
augustinizmus	augustinský
jansenizmus	jansenismus, jansenista
asynchronizmus	asynchronie, synchronizmus, asynchronismus, synchronismus, asynchron, synchron
austroslavizmus	slavizmus
monopluralizmus	monopluralismus, pluralizmus, pluralismus
kryptorchizmus	kryptorchismus, krypta
revmatizmus	revma, revmatik, revmatický
didaktizmus	didaktický, didaktismus
amenzalizmus	amenzalismus
ultrakolonializmus	ultrakolonialismus
unitarizmus	unitární, unitarismus, unita, unitaristický
poverizmus	poverismus, verizmus, verismus
sylogizmus	sylogismus
višnuizmus	višnuismus, višnuistický
tribalizmus	tribalismus
toryizmus	toryismus
solidarizmus	solidární, solida, solidaristický
makaronizmus	makaronismus, makaron, makarón
husitizmus	husitismus
slovakizmus	slovakismus
přímus	přimísit, přemísit
talmudizmus	talmud, talmudský
brežněvizmus	brežněvismus
rigorizmus	rigorismus
odinizmus	odinismus
gestaltizmus	gestaltismus
cézannizmus	cézannismus
cézarizmus	cézarismus
hylozoismus	hylozoizmus
socrealizmus	realizmus, socrealismus
maskulinizmus	maskulinismus, maskulinní
vokalizmus	vokalický, vokální
antropocentrizmus	antropocentrismus, antropocentrický, centrizmus, centrický, centrismus
italismus	italizmus, italický
metamorfizmus	metamorfovat, metamorfický
postfordizmus	fordizmus, ford
obskurantizmus	obskurant, obskurantní, obskurantský
normatizmus	norma
defétizmus	defétismus
autotropizmus	autotropismus
šivaizmus	šivaismus
vegetarianismus	vegetarianizmus, vegetarián, vegetariánizmus, vegetariánský
pársizmus	párský, pársismus
austromarxizmus	marxizmus
absurdizmus	absurdní
majorizmus	majorismus, major, majorista
barokizmus	barok
parnasizmus	parnasismus
byronizmus	byronský
nihilizmus	nihilismus
laboretizmus	laboretismus
hegelianizmus	hegelián, hegeliánský
ultraizmus	ultraismus, ultra
flagelantizmus	flagelantismus, flagelant
melanizmus	melanismus, melanin
nomádizmus	nomád, nomádský, nomádismus
budhizmus	budhismus
mazdakizmus	mazda
saudosizmus	saudosismus
idylizmus	idylický, idyla, idylismus, idylik
instinktivizmus	instinktivní, instinkt
separatizmus	separatismus, separátní, separativní, separát
psychizmus	psychismus, psychický
akméizmus	akméismus, akméistický
ahistorizmus	historizmus, ahistorismus
vagabundizmus	vagabund, vagabundovat, vagabundismus
egofuturizmus	egofuturistický, egofuturismus, egofuturista
kvakerizmus	kvaker, kvakerismus
revanšizmus	revanšismus, revanš
nelogizmus	nelogismus
neronizmus	neronský, neronismus
eurokomunizmus	eurokomunismus
ludibrionizmus	ludibrionismus
hydrotropizmus	hydrotropismus, hydrotropní
recidivizmus	recidiva, recidivní
prozaizmus	próza, prozaický
proporcionalizmus	proporcionální, proporce
bohemizmus	bohemismus
etatizmus	etatismus, etát
egodeizmus	egodeismus
scientizmus	scientismus
piktorializmus	piktorialismus
šmeralizmus	šmeralismus
neosocializmus	socializmus
euhemerismus	euhemerizmus
prohibicionizmus	prohibice, prohibicionistický
microsoftcentrizmus	microsoftcentrismus, centrizmus
fotorealizmus	fotorealismus, foto
plutonizmus	pluton, plutonský, plutonický, plutonismus
legitimizmus	legitimní
švejkizmus	švejk
hotentotizmus	hotentot, hotentotský, hotentotismus
etylizmus	ethyl
anarchosyndikalizmus	syndikalizmus, anarchosyndikalista
plenérizmus	plenérismus, plen, plenér
fatalizmus	fatalismus, fatální, fatovat
wertherizmus	wertherismus
prerafaelizmus	prerafaelismus
pacifizmus	pacifik, pacifismus, pacifický
evropeizmus	evropeismus, evropský
nativizmus	nativní, nativismus
anabolizmus	anabolismus, anabolie
egotizmus	egotismus, ego
sekcionalizmus	sekce
polyfyletizmus	polyfyletismus, polyfyletický
neptunizmus	neptunismus
illyrismus	illyrizmus, illyrský, ilyrizmus
dimorfizmus	dimorfie, dimorfní
panarabizmus	panarabismus
termomagnetizmus	termomagnetický
blefarospazmus	blefarospasmus
titoizmus	titoismus
patetizmus	patetický, patetismus
manicheizmus	manicheismus, manicheistický
fototropizmus	fototropismus
polygenetizmus	polygenetický, polygenetismus
preformizmus	preformismus
novoromantizmus	novoromantický
irénizmus	irénismus
synkretizmus	synkretický
technicizmus	technický, etnický
izolacionalizmus	izolace, izolovat, izolovaný, izolacionalismus
feminizmus	feminismus
imanentizmus	imanentismus, imanentní, imanence
nepotizmus	nepot, nepotismus
panlogizmus	panlogismus
pleomorfizmus	pleomorfismus
židoplutokratizmus	židoplutokratický
pleochroizmus	pleochroismus
suprematizmus	suprematismus
bahaismus	bahaizmus
iredentizmus	iredentismus, iredenta
intuitivizmus	intuitivní, intuice
tragizmus	tragický
recesizmus	recesismus
ultrareformizmus	ultrareformismus
monoteletizmus	monoteletismus
spotřebizmus	spotřeba
castrizmus	castrismus
taoizmus	taoismus, tao
dichroizmus	dichroismus
apolitizmus	apolitický, apolit, apolitismus, apolita
arkadizmus	arkadismus
sunnitizmus	sunnita, sunna
arivizmus	arivismus, arivista, arijský
thatcherizmus	thatcherismus
konceptizmus	koncept, konceptismus
populizmus	populismus
kartezianizmus	karteziánský, kartezián
neonacizmus	neon
valorizmus	valor, valorismus
postromantizmus	postromantický, romantizmus
tradeskancionalizmus	tradeskancionalistický, tradeskancionalista
ultranaturalizmus	ultranaturalista
židobolševizmus	židobolševik, židobolševický
bushizmus	bushismus
menševizmus	menševik
monarchofašizmus	monarchofašismus, monarcha
chaotizmus	chaos, chaot
trializmus	trialismus, trial
kryptosocializmus	kryptosocialismus
blefarospasmus	blefarospazmus
alegorizmus	alegorismus, alegorie, alegorický
monorchizmus	monorchismus
imagizmus	imago
piktoralizmus	piktoralismus
plurilingvizmus	plurilingvismus
hebraizmus	hebraismus
surdomutizmus	surdomutismus
churriguerrizmus	churriguerrismus
luminizmus	luminismus
monofyletizmus	monofyletismus
ibsenizmus	ibsenismus
tropizmus	tropismus, tropický
endemizmus	endemismus
tantrizmus	tantrismus
bipartizmus	bipartice, parita, pare
mesmerizmus	mesmerismus
éterizmus	éterismus
mandeizmus	mandeismus
strabizmus	strabismus
priapizmus	priapismus
logicizmus	logický
pleonasmus	pleonazmus
aforizmus	aforismus
tigmotropizmus	tigmotropismus
exorcizmus	exorcismus
atticizmus	attický
kolonizmus	kolon, kolonismus, kolonie, kolona
děkabrizmus	děkabrismus
indigenizmus	indigenismus
chasidizmus	chasid, chasidismus
emergentizmus	emergentismus, emergentní
heliocentrizmus	heliocentrismus, heliocentrický, centrizmus, centrický, centrismus
zélotizmus	zélotismus, zélotický
sufismus	sufizmus
zoroastrizmus	zoroastrismus
rétorizmus	rétor, rétorský, rétorický, rétorismus
bábizmus	báze, bábismus
palladizmus	palladium
chemotropizmus	chemotropismus
sarkazmus	sarkasmus
eufemizmus	eufemismus
pesimizmus	pesimismus, pesimista, pesimistický
machiavelizmus	machiavelismus, machiavelistický
parašutizmus	parašutismus
papalizmus	papalismus
trietizmus	trietismus
fašizmus	fašismus, fašista, fašistický
blábolizmus	blábolismus
atavizmus	atavismus
hondaizmus	honda
orfizmus	orfismus
polpotizmus	polpotismus
hlasizmus	hlasismus, hlas
galvanotropizmus	galvanotropismus
sylabizmus	sylabismus, sylabický
katabolizmus	katabolický, katabolismus, katabolit
senzualizmus	senzualismus, senzuální
popperizmus	popperismus
paroxyzmus	paroxysmus
palladianizmus	palladianský, palladiánský, palladianismus
subvencionizmus	subvence
bipolitizmus	bipolitismus
kreolizmus	kreol, kreolismus
postkubizmus	postkubistický
haptotropizmus	haptotropismus
rusizmus	rusismus
pelagianizmus	pelagianismus, pelagián, pelagiánský
solipsizmus	solipsismus
alogizmus	alogismus, alogický
hinduizmus	hinduismus
orgazmus	orgasmus
pauperizmus	pauperismus
kladizmus	klad
tenebrizmus	tenebrismus
grafizmus	grafický, grafismus, grafik
dynamoarchizmus	dynamoarchismus
novofunkcionalizmus	novofunkcionalistický
kolorizmus	kolorismus, kolorista, koloristický
sunnizmus	sunna, sun, sunnismus
šintoizmus	šintoismus, šintoistický
bönizmus	bon
mutizmus	mutismus
negrizmus	negrismus
fideizmus	fideismus
tachismus	tachizmus, tašizmus
sofizmus	sofismus, sofistika, sofistický, sofijský
pučizmus	pučismus, pučistický, pučista
lučizmus	lučismus
mimetizmus	mimetický, mimetismus
ageizmus	ageismus
džinizmus	džinismus, džinista
inkubizmus	inkubismus, kubizmus
hermetizmus	hermetický
démonizmus	démon, démonie, démonský, démonismus, démonický
laxizmus	laxismus
čechizmus	čechismus
protofašizmus	fašizmus
tubizmus	tuba, tubismus, tubista
viklefizmus	viklefismus
baptizmus	baptismus
donkichotizmus	donkichotismus, don, donský
balbutizmus	balbutik, balbutismus
altruizmus	altruismus
naturizmus	naturismus, naturista, naturistický
rotacizmus	rotovat, rotace, rotacismus, rota
autizmus	autismus, aut
polycentrizmus	centrizmus, polycentrický, polycentrismus
anachronizmus	anachronismus, anachronický
tenezmus	tenesmus
plasticizmus	plaz, plastický
spazmus	psát
cykloturizmus	cykloturismus, cykloturistický
mobilizmus	mobilismus, mobil, mobilní, mobilovat, mobilie
intuicionizmus	intuicionismus, intuicionistický, intuice
baladizmus	balada, baladismus
purizmus	purismus, puristický, purista, purim
kultizmus	kultismus, kultus, kult
pointilizmus	pointilismus
makroorganismus	makroorganizmus
septimus	septima
teizmus	teismus, ateizmus
lesbizmus	lesbismus, lesba, lesbický
kubofuturizmus	kubofuturistický
isthmus	ismus
ikonoklazmus	ikonoklasmus
šaktizmus	sak, šaktismus
neokonstruktivizmus	neokonstruktivní
zenizmus	zenismus, zen
chiazmus	chiasmus
prodromus	prodrom
gonochorizmus	gonochorismus
lamaizmus	láma, lama
nanizmus	nanismus
legizmus	legismus, legální
animizmus	animální, animismus, animus
liizmus	liismus
truizmus	truismus
deizmus	deismus
anankazmus	anankasmus
primus	mus
rutilizmus	rutil, rutilismus
sikhizmus	sikhismus, sikh
klarizmus	klarismus
eskapizmus	eskapismus
marrizmus	marrismus
verizmus	verismus
algoritmus	algor
mohizmus	mohismus
kormus	cormus, korma
virilizmus	virilní, virilismus
sapfizmus	sapfismus, sapa
utilizmus	utilismus
zenbudhizmus	zenbuddhizmus
izmus	ismus
colbertizmus	colbertismus
holizmus	holý, holismus, hole
reizmus	izmus
velkokapitalizmus	velkokapitalismus
nummus	mus
utrakvizmus	utrakvismus
lokálpatriotizmus	lokálpatriotismus, lokálpatriot
cormus	čest
vidimus	vidium
humus	mus
