Lelková	Lelek
Lejeuneová	Lejeune
Lejeunová	Lejeune
Lejhancová	Lejhanec
Leimbergerová	Leimberger
Žáčková	Žáček, Žák
Videnová	Videnov
Žůrková	Žůrek
Žítková	Žítek
Žďárková	Žďárek
Žídková	Žídek
Žárová	Žára, Žána
Legátová	Legát
Leibermannová	Leitermann
Aahlenová	Aahlen, Ahlen
Aachenová	Aachen
Lehovcová	Lehovec
Žváčková	Žváček
Žurková	Žurek
Žurovcová	Žurovec
Lemúzová	Lemuz
Vicherková	Vicherek, Vichera
Vicencová	Vicenec
Vicenová	Vicena
Vicentová	Vicente
Aaronová	Aaron
Abadieová	Abadie
Abadiová	Abad
Aaronsová	Aarons
Žočková	Žoček
Abakumová	Abakumov
Abadžievová	Abadžiev, Abadžievův
Abakanowiczová	Abakanowicz
Večerová	Večeřa
Abateová	Abate
Večeřílková	Večeřílek
Abascalová	Abascal
Abassová	Abas
Abarcaová	Abarca
Ledvoňová	Ledvoň
Abbidová	Abbid, Abid
Abašinová	Abašin
Abbingtonová	Abington
Abbiová	Abbio, Abbid
Žmolilová	Žmolil
Abbúdová	Abbúd
Žlebková	Žlebek
Abbrentová	Abbrent
Vetýšková	Vetyška, Vetýšek
Lendová	Lande
Lendrová	Lender
Živčicová	Živčic
Živnůstková	Živnostek
Abdallahová	Abdallah
Lenčová	Lenčo
Leníčková	Leníček, Lenička
Abdeslamová	Abdeslam
Abdelnourová	Abdelnour
Abdelrahmanová	Abdelrahman
Abdesslemová	Abdesslem
Živníčková	Živníček
Živcová	Živec, Živko
Vesninová	Vesnin
Vespalcová	Vespalec
Žitková	Žitek
Abdinurová	Abdinur
Abdiová	Abdi, Abdid
Lebová	Lebo, Leba
Žilínková	Žilínek
Abedinová	Abedin, Abdina, Abdin
Verčáková	Věrčák
Villelaová	Ville
Villeneuveová	Villeneuve, Villeneuv
Abelerová	Abeele
Leoniová	Leon
Leonová	Leona, Leon, Leone
Lažánková	Lažánek
Lašťovičková	Laštovička
Žilovcová	Žilov
Abernathyová	Abernathy
Vilmanová	Vilmon
Leopoldová	Leopolda, Leopoldo, Leopold
Lašmanovová	Lašman, Lašmanův
Lerayová	Leary
Abrahamssonová	Abrahamsson
Aboová	Abo, Abou
Židková	Židka, Židek
Abramsonová	Abramson
Abrahamovičová	Abrahamovič
Lavrincová	Lavrinec
Lerougeová	Leroux
Abrlová	Abrle
Abrahamsonová	Abrahamson
Žerníčková	Žerníček
Vilímcová	Vilímec, Vilémec
Vilímková	Vilémek, Vilímek
Vilánková	Vilánek
Vilášková	Vilášek
Verdonková	Verdon
Vilčková	Vilček
Ženíšková	Ženíšek
Žeravicová	Žeravica
Absolínová	Absolín
Ženková	Ženkl
Lavoová	Lava
Laurová	Laura, Lauro
Lesová	Les
Venderová	Vind, Vend, Vander
Venová	Véna, Vin, Venda
Acedová	Aces, Acer, Acera, Ace
Vepřková	Vepřek
Vinciková	Vincík
Vincourková	Vincourek
Žehrová	Žehra, Žehrov
Laurienová	Laurie, Lauri
Lesáková	Lesák
Lattaová	Lajta
Velísková	Velísek
Velíšková	Velíšek
Vencálková	Vencálek
Venclíčková	Venclíček, Venclík
Latnerová	Lajner, Lanner
Lassková	Lassa
Velková	Velek, Velký
Vinklárková	Vinklárek
Žalčíková	Žalčík
Žaludková	Žaluda, Žaludko, Žalud
Žaloudková	Žaloudek
Žaloudíková	Žaloudík
Adamcová	Adamec, Adamko
Adamíčková	Adamíček, Adamčík, Adamičko
Adamovicová	Adamovič
Adamicová	Adamica
Adareová	Ada
Veliková	Velikov, Veliký
Letáková	Lesák
Leuová	Leuna
Lapáčková	Lapáček
Lappertová	Lampert
Veleová	Vele
Veldová	Velde
Žahourková	Žahourek
Adiová	Adi, Adin
Levineová	Levine
Aderová	Adera
Vinárková	Vinárek
Vinčálková	Vinčálek
Levíčková	Levíček, Levík
Lanáčková	Lanáček
Lančová	Lanč, Lančov
Adámková	Adámek, Adamka, Adamek
Adriansenová	Adriansen
Lewinerová	Lewin
Langášková	Langášek
Vejlupková	Vejlupek
Vejdělková	Vejdělek
Landsbergrová	Landsberger, Landsberg
Vechová	Vích, Věch
Vaškovová	Výškov
Lešenarová	Lešenar
Vašínková	Vašinka
Vašíčková	Vašíček
Visaová	Visa
Lečevová	Leščev
Landreová	Lander
Landrová	Lander, Landa, Landl
Vaňásková	Vaňásek
Vařílková	Vařílek
Vaňousková	Vaňousek, Vaňous
Vaňoučková	Vaňouček
Lancigrová	Lanciger
Vaňourková	Vaňourek
Vavruchová	Vavruch, Vavruša
Vavruňková	Vavruněk
Vaľová	Vaňo
Vavřínková	Vavřínek
Vavříčková	Vavříček
Aghová	Agha, Agga
Vavřinčíková	Vavrinčík
Vavrůšková	Vavrúšek, Vavruška, Vavrušek
Agostinová	Agostin, Agostino, Agostini
Vavrínová	Vavrina, Vavřín
Lamarrová	Lamar
Vavroušková	Vavroušek
Vatková	Vetka
Laineová	Laine, Lainer
Lainiová	Laino
Libochová	Liboch
Laichtrová	Laichter
Lahová	Lahn
Vitková	Vitek
Lagoová	Lago, Laga, Lagos
Varenová	Vara
Vardová	Varde
Aichingrová	Aichinger
Aichmaierová	Aichmeier
Lafontová	Lafont
Lichcovová	Lichov, Lichkov
Libíčková	Libíček, Libík, Ličík
Ladronová	Ladron
Varausová	Varous
Varadínková	Varadínek
Aimeeová	Aimee
Vaněčková	Vaněček
Vaníčková	Vaníček, Vaník
Vanýsková	Vanýsek, Vaneska
Vantúchová	Vantuch, Vantoch
Lachlanová	Lachlan
Lichtová	Lich
Labudková	Labudek, Labuda
Vandlíčková	Vandlík
Labatová	Laba
Laanová	Laun, Lana
Vandrovcová	Vandrovec
Kůřilová	Kúřil
Vanclová	Valcl
Valčová	Valčo, Valča, Valčův
Valčuhová	Valčuha
Valčuková	Vaščuk
Valčáková	Valčák
Valíčková	Valíček, Valečík, Valčík
Valušková	Valušek, Valoušek
Vitoušková	Vitoušek, Vitouš
Lietavcová	Lietavec
Křupalová	Křoupal, Křópal, Křůpala
Křováčková	Křováček
Křižánková	Križánek
Valušová	Valuš
Valášková	Valášek, Valaška
Křiváčková	Křiváček
Likavcová	Likavec, Likavka
Valoušková	Valoušek
Křistková	Křistek
Křivancová	Křivanec
Valošková	Valošek
Křiklavová	Křiklava
Valotová	Valo
Valičková	Valiček
Valníčková	Valníček
Alamuddinová	Alamuddin
Křesálková	Křesálek
Lillyová	Lilly
Valentíková	Valentík
Valenzuelová	Valenzuela
Valečíková	Valečík
Albertiová	Alberti
Liljebergová	Liljeberg
Křemečková	Křemeček
Křenková	Křenek
Valenzová	Valenz, Vala
Valentovičová	Valentovič
Křejčířová	Křejčíř, Krejčíř
Křeháčková	Křeháček
Limbergová	Limberg
Kňourková	Kňourek
Valenová	Valena, Valen, Valenka, Valenca
Valensová	Valens
Valentieneová	Valentine
Vitásková	Vitásek
Vitázková	Vitázek, Viták
Vitáčková	Vitáček
Valentiová	Valenti, Valentia, Valencia
Valentineová	Valentine, Valentiner, Valentina, Valentin
Köttnerová	Küttner
Valencová	Valenca
Lindertová	Lind
Köpckeová	Köpke
Valenciová	Valencia, Valencio, Valencie
Alegríová	Alegre
Valdrová	Valda
Valchařová	Valchař
Valatová	Vala
Alexijevičová	Alexijevič
Valchářová	Valchař
Vivodová	Vidov
Kábelová	Kábele
Lipaová	Lipa, Lipo
Aliová	Alia, Ali, Alin, Alida
Kyrianová	Kyrián
Lipová	Lipo, Lipa, Lípa, Lipus
Kyselevová	Kysela, Kyselov
Kyselková	Kyselka
Vafková	Vafek
Vaganovová	Vaginov
Aljoškinová	Aljoška
Liscová	Lisec, Lisko
Vičánková	Vičánek
Allbrightová	Albright
Vachulová	Vachala, Vachel
Vachoušková	Vachoušek
Vachovcová	Vachovec
Višková	Vicko, Vik
Kylianová	Kylián
Vackovcová	Vackovec, Vackov
Vacková	Vacke, Vackov
Vachálková	Vachálek
Vachková	Vachek, Vácha
Vachlová	Vachel
Uřičářová	Uřičář
Uřidilová	Uřidil
Kwaczková	Kwaczek
Alpiová	Alpa, Alpy
Kvítková	Kvítek
Květnová	Květná
Uytvancková	Uytvanck
Utíkalová	Utěkal
Kuželuhová	Kuželuh
Kvačková	Kvaček
Vlastová	Vlasta
Kužílková	Kužílek
Liuová	Li
Alvarezová	Alvarez
Kuščáková	Kučák
Kušová	Kuška
Kušiaková	Kuciak
Urubková	Urubek
Kuřáková	Kuďák, Kučák, Kuťák, Kurák
Kuřinová	Kuřina
Alšová	Aleš, Alba, Alpa
Vlašáková	Vlasák
Vlašánková	Vlašánek
Vlačková	Vlaček
Kučírková	Kučík, Kučírek
Urbanovičová	Urbanovič
Uribová	Uribe
Amadová	Amado
Amanarová	Aman
Kuvčáková	Kufčák, Kulčák
Urbášková	Urbášek
Urbancová	Urbanec
Urbaníková	Urbaník
Urbanczyková	Urbanczyk
Kutálková	Kutálek
Kutílková	Kutílek, Kutík
Kurťáková	Kurták
Kutanová	Kučan, Kuban, Kukan
Lněníčková	Lněníček, Lněnička
Vlášková	Vlaška
Kusová	Kuse, Kuss, Kusý
Voblizová	Vobliza
Vnoučková	Vnouček
Ambuhlová	Ambühl
Vlčková	Vlčko, Vlček
Lobečová	Lobeč
Amelová	Agel
Voběrková	Voběrek
Vocásková	Vocásek
Kurtincová	Kurtinec
Lobčová	Lobeč
Locková	Lock, Locke
Kurincová	Kurinec
Vodseďálková	Vodseďálek
Vodáčková	Vodáček
Umlášková	Umlášek
Kupčová	Kupča, Kupka, Kupčo
Vodřejcová	Vodřejc
Lohrmannová	Lohmann
Voetová	Voe
Ulmonová	Ulmon
Ulmová	Ulm, Ulma
Lokajíčková	Lokajíček
Kuppischová	Kuppisch
Kuprová	Kupr
Loitová	Loi, Lois
Kupkárová	Kupkár
Amrosová	Agros
Lokšová	Lokša
Kupcovová	Kupcov
Kupferová	Kupfer
Kupfová	Kupf
Kupcová	Kupec
Lombardiová	Lombardi, Lombard
Vojancová	Vojanec
Uhmanová	Uhmann, Uhlman
Uhříčková	Uhříček
Uhýrková	Uhýrek
Uhrová	Uher
Andová	Anda, Ando, Andr
Vojtášková	Vojtášek
Vojtíšková	Vojtíšek, Vojtěška
Vojčová	Vojče
Andonovová	Andonov
Lomozová	Lomoz
Kunevová	Kunov
Kunovjánková	Kunovjánek
Kunrátková	Kunrátek
Kunisová	Kunis
Vojáčková	Vojáček
Kuniková	Kukin, Kuniko
Loneová	Lone, Loney
Andrejsková	Andrejsek
Loníčková	Loníček
Kundertová	Kundera
Kunceová	Kunce
Vokřínková	Vokřínek
Andrýsková	Andrýsek
Lorensenová	Lorenzen
Kulíšková	Kulíšek, Kulík, Kulíček
Loreová	Lorec
Vokáčková	Vokáček
Vokálková	Vokálek
Lordová	Lord
Kumherová	Kummer
Kulíčková	Kulíček
Lorrimerová	Lorimer
Lorková	Lorca
Volencová	Volenec
Volejníčková	Volejníček
Loubetová	Loubet
Loubková	Loubek, Loub
Volhardová	Vollard
Kulenová	Kule
Kuldanková	Kuldanek
Louisyová	Louis, Louisa
Třebínová	Třebín
Louchovová	Louchov
Loupová	Loup
Lounková	Lounek, Loun
Kuklevová	Kukla
Kuklínková	Kuklík
Kujíčková	Kujíček
Kuhlmanová	Kuhlmann
Kufová	Kufa
Kudrowová	Kudra, Kudr
Kudílková	Kudílek, Kudík
Kudýnková	Kudýnek
Ansáriová	Ansari
Kudrlová	Kudrle, Kudrna, Kudr
Kudrfalcová	Kudrfalec
Loučímová	Loučim
Kudláčková	Kudláček
Volnerová	Voller
Volová	Volha
Lovečková	Loveček, Loveč
Kudilková	Kudělka
Těšinová	Těšina
Kucianová	Kucián
Kuchtíčková	Kuchtíček
Lošáková	Ločák
Kubátková	Kubátek, Kubák, Kubáček
Kubáčková	Kubáček
Kubášková	Kubášek, Kubák
Kubálková	Kubálek, Kubák
Kubínková	Kubínek, Kubín, Kubík
Kubásková	Kubásek
Lubanová	Lučan
Týnková	Tynka, Týn
Kubovcová	Kubovec
Kubičíková	Kubčík
Kuboušková	Kuboušek
Antoňová	Antoň, Anton
Antůšková	Antůšek, Antušek
Antoníčková	Antoníček
Antálková	Antálek
Antošíková	Antošík
Kubiczková	Kubiczek
Kubincová	Kubinec
Ktová	Keta
Törpová	Tropp
Kubcová	Kubec
Voltmerová	Volmer
Luciaková	Luciak
Lucaová	Luca, Lucas, Luco
Lucianiová	Luciani
Lucinová	Lucina, Lucinus, Lukin
Krůčková	Krůček, Klůček
Ksandová	Kanda
Krůšková	Krůšek
Tímrová	Timr
Volzová	Volha, Volga
Ludková	Ludva
Lucková	Luck, Lucek, Luco, Luc
Krňávková	Krňávek
Šůnová	Šůna, Šona
Tísková	Tísek
Šůstková	Šůstek
Applová	Apple
Šňupárková	Šňupárek
Šťovíčková	Šťovíček
Ščučková	Ščuk
Ludvíčková	Ludvíček
Tyronová	Tyr, Tyrin
Šňupíková	Šňupík
Šťavová	Šťáva
Aquilerová	Aquilera
Královcová	Královec
Králíčková	Králíček
Tylečková	Tyleček
Krzyžanková	Krzyžanek, Krzyžánek
Krzyžánková	Krzyžánek
Kryžanková	Kryžanek
Kryštofková	Kryštofek, Kryštof
Kryštůfková	Kryštůfek
Tymkovičová	Timkovič
Tylmanová	Tilman
Tykvartová	Tykvart
Tyburcová	Tyburec
Krystýnková	Krystýnek
Šírková	Šírek
Šústalová	Šustal, Šůstal
Šípková	Šípek
Šístková	Šístek
Krutílková	Krutílek, Krútílek
Lukacková	Lukacko
Vomastková	Vomastek
Volánková	Volánek
Archmanová	Archman
Tvrdková	Tvrdek, Tvrtka
Tvarůžková	Tvarůžek
Lukavcová	Lukavec
Lukesová	Lukes
Lukerová	Luker
Šášinková	Šašinka
Šátralová	Šátral
Lukejová	Lukej
Lukašová	Lukaš
Krumbholzová	Krummholz
Krumbholcová	Krombholc
Tvardková	Tvardek
Luknarová	Luknar
Luknárová	Luknár
Lukičová	Lukič, Lukic, Lucič
Vondrášková	Vondrášek, Vondráška
Vondroušková	Vondroušek
Krsková	Krsek, Krs
Krpálková	Krpálek
Lukyová	Luky
Krpcová	Krpec
Tučová	Tuka
Tučímová	Tučím
Kroutilíková	Kroutilík
Kroutlová	Kroutl
Lukšíčková	Lukšíček
Šárovcová	Šárovec
Šálková	Šálek
Šáralová	Šáral
Šádková	Šádek
Šáfrová	Šafr
Lukšanová	Lukšan
Kropková	Kropek, Krka
Kroppová	Kropp
Kropáčková	Kropáček
Tutterová	Tutter
Turčaková	Turček, Turčák
Turčínková	Turčín, Turčínek
Arnoštková	Arnoštka, Arnoštek
Lukášková	Lukáška
Lukáčková	Lukáček
Kronková	Kronek
Kronychová	Kronich
Vonášková	Vonášek
Vonásková	Vonásek
Krondlová	Krondl
Lundeová	Lund
Krogová	Krok
Krohová	Kroh, Kroha, Krohe
Lupanová	Luhan, Lužan
Vopršálková	Vopršálek
Krmíčková	Krmíček
Švrčková	Švrček
Križánková	Križánek
Krkavcová	Krkavec
Krištůfková	Krištůfek, Krištúfek
Križalkovičová	Křižalkovič
Krištanová	Kristan
Krištúfková	Krištúfek
Luuová	Lu, Lun
Švihlová	Švihl, Švihla
Švihovcová	Švihovec
Švihálková	Švihálek
Asadaová	Asada, Asad
Turečková	Turček, Tureček
Voráčková	Voráček
Aschermanová	Aschermann
Krinková	Kring, Krinke
Krilová	Krill
Kristková	Kristek, Krista, Krist
Kristová	Krist, Krista, Kristl
Vosečková	Voseček
Tuová	Tu, Tuva, Tuma, Tula
Voskovcová	Voskovec
Luxíková	Luxík
Luversová	Luders
Tuláčková	Tuláček
Luštincová	Luštinec, Luština
Luňáčková	Luňáček, Luňák
Krhánková	Krhánek
Tuluová	Tula
Tullová	Tull, Tulla
Krhounková	Krhounek
Švejdarová	Švejdar
Kretková	Kretek
Švaříčková	Švaříček
Kremlová	Kreml, Kremla
Krendlová	Kerndl, Kreidl
Kremláčková	Kremláček
Kremlevová	Kreml, Kremla
Tuháčková	Tuháček
Tulliová	Tulli, Tullia
Švalbová	Šalba
Tukačová	Tkač
Lysoňová	Lysoň
Lysaková	Lysák
Švantnerová	Švantner
Švancerová	Švancer
Krejzková	Krejzek
Krejzlová	Krejza
Krejsková	Krejsek, Krejsa
Vostárková	Vostárek
Švagrová	Švagera
Šustáčková	Šustáček, Šusťáček, Šusták
Vostatková	Vostatek
Šustková	Šustek
Lábková	Lábek, Láb
Lábová	Láb, Lába, Lábek
Krchňáčková	Krchňáček, Krchňák
Krbcová	Krbec
Krchovová	Krcha
Krbušková	Krbušek
Krbálková	Krbálek
Krbůšková	Krbůšek
Krbicová	Krb, Krbice, Krbec
Lysáčková	Lysáček
Votroubková	Votroubek
Votrubcová	Votrubec, Votruba
Šurmánková	Šurmánek
Trčálková	Trčálek
Láníčková	Láníček, Lánička, Laníček
Lámerová	Lamer
Kračmaříková	Kračmařík
Kračková	Kraček
Kračmanová	Kračman
Kračmerová	Kračmer
Auersvaldová	Auersvald
Audranová	Audran
Aueová	Auer, Au
Šuralevová	Šural
Trávníčková	Trávníček
Kravcová	Kravec
Kraváčková	Kraváček, Kravčák, Kravák
Lázníčková	Lázníček
Šumšálová	Šumšal
Augustynová	Augustin
Augutinová	Augustin
Šuminová	Šumen
Votápková	Votápek
Vouetsová	Vouet
Vovsová	Voves
Lépešová	Lepeš
Šulcková	Šulcek
Vozobulová	Vozobule
Krasová	Kraso
Lášková	Lášek, Laška
Voříšková	Voříšek
Šuhajová	Šohaj, Šuhajda
Auředníčková	Auředníček
Šugárková	Šugárek
Štůsková	Štůsek
Kramériusová	Kramerius
Krandová	Kranda
Lízancová	Lízanec
Lívancová	Lívanec
Trunečková	Truneček
Trumhová	Trumm
Lískovcová	Lískovec
Lísková	Líska, Líský, Lísek
Trsková	Trsek
Trubáčková	Trubáček, Trubáčkův
Voženílková	Voženílek
Lópezová	López, Lopez, Lopes, Lope, Lopéz
Trtková	Trtek
Trubačová	Trubačov
Trtílková	Trtílek
Kraková	Krakov
Krajíčková	Krajíček
Lövyová	Löwy
Trpálková	Trpálek
Trpkovičová	Trpkovič, Trpka
Trpkošová	Trpkoš, Trpka
Krajicková	Krajicek
Trottaová	Trott
Trousílková	Trousílek
Troutová	Trout
Krajbichová	Krajbich, Krejbich
Kraitlová	Krajtl
Krahulcová	Krahulec
Krahlová	Krajl
Vrabcová	Vrabec
Troníčková	Troníček
Troopová	Troup, Trope
Vrablecová	Vráblec
Vrablová	Vrábl
Štípalová	Štípal, Štípala, Šípal
Štípková	Štípek, Štěpka
Štípová	Štípa
Tronečková	Troneček
Štáfková	Štáfek
Krabcová	Krabec
Kožíšková	Kožíšek
Lýrová	Lír, Lér
Trojáčková	Trojáček
Štveráčková	Štveráček, Štverák
Trochová	Torch, Toch
Kožnárková	Kožnárek
Kožoušková	Kožoušek
Maanenová	Mane
Trogerová	Troeger
Trojancová	Trojanec
Štulrajterová	Štulajter
Trnová	Trna
Trnovcová	Trnovec, Trnov
Štukavcová	Štukavec
Štrétová	Škréta
MacGrawová	McGraw
Košíčková	Košíček
Koščová	Koška
Košťálková	Košťálek, Košťál
Babenková	Babenko
Babejová	Babej
Babiaková	Babiak, Babiák
Babbová	Babb, Babbo
Macalíková	Macalík
Košábková	Košábek
Košárková	Košárek, Kosárek, Korák
Košvancová	Košvanec
Koštálková	Koštálek, Košťálek
Babitzová	Babitz, Babits
Babiuková	Babiuk, Babiák
Štrayblová	Štrajbl
Babinová	Babina, Babiny
Babincová	Babinec
MacKinnonová	Mackinnon
Machalíčková	Machalíček
Machancová	Machanec
Babidoričová	Babidorič
Babkinová	Babkin
Babkovičová	Babkovič
Babjarová	Babjar
Babjuková	Babjuk
Babjáková	Babják
Babjárová	Babjár
Vrbanovová	Vrbanův, Vrban
Machanderová	Machander
Kořízková	Kořízek
Kořínková	Kořínek
Babováková	Babovák
Babrnáková	Babrnák, Babrňák
Babtistová	Babtista
Baboučková	Babouček
Babovcová	Babovec
Koďousková	Koďousek
Machaňová	Machaň
Tribusonová	Tribuson
Tribusová	Tribus
Štosková	Štosek
Štosová	Štos, Štós
Štoudková	Štoudek
Babuljaková	Babuljak
Babušíková	Babušík
Baburová	Bábura, Babúr
Macharáčková	Macharáček
Machanová	Machan, Machane
Machaníčková	Machaníček, Machančík
Machovcová	Machovec
Kočárková	Kočárek
Machková	Machek
Baběrádová	Baběrád
Babulová	Babula, Babule
Babuláková	Babulák
Babulíková	Babulík, Bubulík
Babůrková	Babůrek
Babulenková	Babulenko
Babíčková	Babíček
Baběráková	Baběrák
Vrbíčková	Vrbíček
Vrbovcová	Vrbovec
Babyrádová	Babyrád
Bacallová	Bacall
Baccagliniová	Baccaglini
Babáčková	Babáček
Bachmeierová	Bachmaier
Bachledová	Bachleda
Bachmaierová	Bachmaier, Bach, Bachmayer
Bacheletová	Bachelet
Machútová	Machát
Kočandrlová	Kočandrle
Machálková	Machálek
Machálová	Machala
Kozůbková	Kozůbek
Kozánková	Kozánek
Kozárková	Kozárek
Kozáčková	Kozák
Baconová	Bacon
Backlundová	Backlund
Bachůrková	Bachůrek
Bachůrová	Bachora
Bachňáková	Bachňák
Bachtíková	Bachtík
Bachurková	Bachurek, Bachura, Bachůrek
Štibrányová	Štibrány
Bachurová	Bachura, Bachora
Kozubková	Kozubek
Trenzová	Trenze
Backová	Backe, Bacca
Kozenková	Kosenko, Kosenka
Kozlíčková	Kozlík
Koziorková	Koziorek
Badaňová	Badaň
Badalcová	Badalec
Badaljanová	Badaljan
Badalíková	Badalík, Bakalík
Bacílková	Bacílek
Štepáneková	Štěpánek
Macourková	Macourek
Macošková	Macocha
Macánová	Macan, Machan
Kowinová	Kokin
Kovářiková	Kovařik, Kováčik
Kováčová	Kováč
Kovrzková	Kovrzek
Badáňová	Badaň
Badošková	Badošek
Baduová	Bauda, Bada
Trefancová	Trefanec
Baedekerová	Baedeker, Baedecker
Baehlerová	Beehler
Badžgoňová	Badžgoň
Kovaříčková	Kovaříček, Kováříček
Kovařicová	Kovačica
Vrdlovcová	Vrdlovec
Traversová	Travers, Traverso
Šteigrová	Šteiger
Kovalčílková	Kovalčík
Kovalyová	Koval
Baggerová	Bagger
Trbušková	Trbušek
Štefánková	Štefánek
Štefáčková	Štefáček
Kouřímová	Kouřim
Magnová	Magna
Koucourková	Koucourek
Kourková	Kourek
Kounková	Kounek
Šteflíčková	Šteflíček
Štefečková	Štefeček, Štefek
Bagnoldová	Bagnold
Bagnallová	Bagnall
Bahníčková	Bahníček
Bagshaweová	Bagshawe
Bagshotová	Bagshot
Trantírková	Trantírek
Štefaniková	Štefánik
Mahalová	Mahala, Mahal
Koukolíčková	Koukolíček, Koukolík
Kouhoutková	Kouhoutek
Koudelníčková	Koudelníček
Štambergová	Štemberg
Koubková	Koubek
Kotěšovcová	Kotěšovec
Koubíčková	Koubíček
Kotýnková	Kotýnek
Mahelová	Mahle, Mahler
Vrtková	Vrtek
Baisová	Baise
Baiblová	Bail
Kotásková	Kotásek
Tranděnková	Tranděnkov
Baizleová	Baizley
Bajanová	Bajan
Kottková	Kottek, Kott
Kotoučková	Kotouček
Kottnerová	Küttner
Vrzáčková	Vrzáček
Vrábková	Vrábek
Trailová	Train
Vrtílková	Vrtílek, Vrtělka
Kotoulková	Kotoulek, Kotulka
Kotrbáčková	Kotrbáček
Bajtková	Bajtek, Batko
Šrůtková	Šrůtek, Šrůta
Šrámková	Šrámek
Kotláriková	Kollárik
Maiolová	Maioli, Maio
Továrková	Továrek
Bajčíková	Bajčík
Šroubková	Šroubek
Šrolová	Šrol
Šroňková	Šroněk
Bakajsová	Bakajsa
Toušková	Toušek, Toucha
Toušlová	Tojšl
Šromotová	Šromota
Vrátníčková	Vrátníček
Vránková	Vránek, Vrána
Vrátilová	Vrátil
Kotlářová	Kotlář
Kothánková	Kothánek
Tourková	Tourek
Kosárková	Kosárek
Kosánková	Kosánek
Majnerová	Mainer
Totušková	Totušek
Baladová	Balaďa
Špringlerová	Špringer
Špreňarová	Špreňar
Balajová	Balaj
Kosďunová	Kosťun
Kosáčková	Kosáček
Kosínková	Kosík, Kosinka
Kosířová	Kosíř
Balakrishnanová	Balakrishnan
Vršíčková	Vršíček
Šplýchalová	Šplíchal
Majrychová	Majrich
Majíčková	Majíček
Kostěncová	Kostěnec
Kostílková	Kostík, Kostílek
Kostínková	Kostínek
Špičáková	Špičák
Špitová	Špit, Špita, Šmit
Špittová	Špitt
Balatová	Balatý, Balatá, Bala
Balcárková	Balcárek
Balcarková	Balcarka, Balcar
Kostrůnková	Kostrůnek
Makarová	Makar, Makara
Tornová	Tor
Baldrianová	Baldrian
Balejíková	Balejík
Kostincová	Kostinec
Balgová	Balga
Balhárková	Balhárek
Makiová	Maxi
Kostelencová	Kostelec
Balesová	Bales
Balfourová	Balfour
Balentová	Balent
Balintová	Balint
Makovcová	Makovec
Balkinová	Balkin
Topolovová	Topol
Topoľová	Topor
Koskádová	Kosák
Tooleová	Toole
Ballková	Ballko, Ballok, Balla, Ball
Balleková	Ballek, Bally, Ballko, Ball
Tomšicová	Tomšic
Špetlová	Špetl
Balnohová	Balnoha
Balochová	Baloch
Balmerová	Balmer
Špetláková	Špetlák
Šperňáková	Šperňák
Balonová	Balonka
Špicová	Špic
Balláková	Ballák
Balnerová	Balner
Malcová	Malec
Baloušková	Baloušek
Balová	Bala, Bali, Bale
Tomšíčková	Tomšíček
Malchárková	Malchárek
Korábková	Korábek, Korák
Koráčková	Koráček
Korýtková	Korytko
Koryčánková	Koryčánek, Korýčánek
Špaňůrová	Špaňár
Špecingrová	Špecinger
Baltsanová	Baltsan
Tomrdlová	Tomrdle
Balázsová	Balász, Balázs, Balasz
Tománková	Tománek
Tomíčková	Tomíček, Tomčík
Baláčková	Baláček
Malejeová	Malejev
Korytová	Koryta, Koryto
Balůšková	Balůšek
Špačková	Špak, Špaček
Španerová	Španner
Balčiráková	Balčirák
Špalková	Špalek
Tomíšková	Tomíšek, Tomášek, Tomáško
Balůsková	Balůsek
Malečková	Maleček
Kortánková	Kortánek
Korvašová	Korvas
Bambuškarová	Bambuškar
Balýová	Balý
Bambousková	Bambousek
Tomlinová	Tolmin
Korpiová	Korpa
Tomečková	Tomeček
Tomcová	Tomec
Bambušková	Bambušek
Bambásková	Bambásek
Korobkovová	Korobko
Šourková	Šourek
Tomancová	Tomanec
Šoustková	Šoustek
Šoutová	Šoun
Šoufková	Šoufek
Bandaová	Banda, Bandai, Bandar
Vycpálková	Vycpálek
Vyhnánková	Vyhnánek
Bandiová	Bandi, Bandia
Vyhnálková	Vyhnálek
Šotková	Šotek
Šostková	Šostek
Banegasová	Bengas
Banfieldová	Banfield, Benfield
Banerdžíová	Banerdži, Banerdží
Malochová	Maloch
Malovcová	Malovec
Maloneyová	Maloney
Kornoušková	Kornoušek
Banková	Bank
Bangová	Bang, Bango, Bangka
Malušová	Maluš
Malátková	Malátek
Malínková	Malínek
Banseová	Banset
Banonová	Banon, Bannon
Banyaová	Banya
Banyová	Bany, Banya
Šolléová	Šolle
Banyáková	Banyák, Banyak
Malásková	Malásek
Malíčková	Malíček
Tobíšková	Tobíšek
Tocháčková	Tocháček
Vylitová	Vylita
Baquerová	Baquero, Bačer
Šodková	Šodek
Baníková	Baník
Baptisteová	Baptiste
Baptistová	Baptiste, Baptist
Korečková	Koreček
Vymětálková	Vymětálek
Vyorálková	Vyorálek
Šnýdlová	Šnídl
Barabanová	Barabanov
Mandincová	Mandinec
Mandelíčková	Mandelíček, Mandelík
Tlášková	Tlášek
Šnejdárková	Šnejdárek
Vysekalová	Vysekal
Barancová	Baranca, Baranec
Šnajdárková	Šnajdárek
Baraová	Bara, Baraba, Barao, Barama, Baran, Barac
Mandžuková	Mandzuk
Korcová	Korec
Mandrlová	Mandl
Mandovcová	Mandovec
Korbašová	Korbach, Korbas
Tlapalová	Tlapal
Šnablová	Šnábl
Šmídková	Šmídek, Šmíd
Šmédková	Šmédek, Šmídek
Kopčányová	Kopčány
Kopčániová	Kopčáni, Kopčani
Tkadlečková	Tkadleček
Barbořáková	Barbořák
Kopčajová	Kopčaj
Kopčanová	Kopčan, Kopkan
Kopánková	Kopánek
Kopárková	Kopárek
Kopáčková	Kopáček
Barchánková	Barchánek, Barchanek
Vyslyšelová	Vyslyšel
Kopuncová	Kopunec
Šmotková	Šmotek
Bardetová	Bardet, Bard
Šmondrková	Šmondrk
Šmolcová	Šmolc
Kopincová	Kopinec
Manserová	Mans
Manoliuová	Manoli
Bardounková	Bardoun
Barcuchová	Barcuch
Bardonková	Bardona
Manoušková	Manoušek
Kopencová	Kopenec, Kopec
Barinovová	Barinův, Barin
Baretová	Bares, Barat
Mantovaniová	Mantovani
Kopcová	Kopec
Baričičová	Barič
Mančičová	Manča
Konůpková	Konůpek, Konupka
Vytásková	Vytásek
Vysučková	Vysuček
Tipmanová	Tippman
Barkóciová	Barkóci, Barkoci
Barkociová	Barkoci
Barkovová	Barkov, Barok
Barkumová	Barum
Barkinová	Barčin
Maradová	Marada
Marainiová	Maraini
Koníčková	Koníček
Konárková	Konárek
Barmošová	Barmoš
Šmatlánová	Šmatlán
Šmakalová	Šmakal
Barnabyová	Barnaby, Burnaby
Barlogová	Barlog
Barlová	Barla
Barnettová	Barnett, Barnet, Barrett
Barnošáková	Barnošák
Barnátová	Barnát
Barlettová	Barletta, Barrett
Barnatová	Barnat, Barnato
Tinayrová	Tinayre
Marangová	Maragno
Marciňová	Marcin
Marciníková	Martiník
Tillesová	Tille, Tiller
Timmermannová	Timmermann, Timmer
Barosová	Baroso, Baros, Baroš
Baroneová	Barone, Baron
Baronovová	Baron, Baronův
Barníková	Barník
Marcišová	Marciš, Marci
Timeková	Timex
Barraová	Barr, Barre, Barro
Barrancová	Barranco
Šlezarová	Šlézar
Konopová	Konop, Konopa
Konopásková	Konopásek
Marečková	Mareček
Barrichellová	Barrichell, Barrichello
Barreová	Barre
Barretová	Barret
Barringerová	Barringer
Koniasová	Koniass
Šlejnicová	Šlejnic, Šlejnice
Barringtonová	Barrington
Barréová	Barré, Barre
Barrowová	Barrow
Marianiová	Mariani, Mariano
Kongaová	Kongo
Kondýsková	Kondýsek
Barsukovová	Barsukov
Barsuková	Barsuk, Barsukov
Barszczová	Barszcz
Bartakovicsová	Bartakovics
Barshefskyová	Barshefsky
Barsová	Barsa, Bars, Barza
Bartesová	Bartes
Barthelová	Barthel, Bartel
Bartelmusová	Bartelmus
Bartelová	Bartel, Bertel
Bartelsová	Bartels
Šlapalová	Šlapal
Bartejsová	Bartejs
Bartakovičová	Bartakovič
Bartalovičová	Bartalovič
Bartalová	Bartal, Bartali
Bartalošová	Bartaloš
Marianková	Marian, Marianek
Marienfeldová	Maria
Komárková	Komárek
Ticháčková	Ticháček
Šlahůnková	Šlahůnek
Bartiková	Bartik, Bartík
Škůrková	Škůrek, Škorka
Komínková	Komínek
Mariánková	Mariánek, Marianek, Marienka
Kománková	Kománek
Barthezová	Barthez, Berthez, Bárthez
Bartheldyová	Bartheldy
Tiberiová	Tiberius
Bartlíková	Bartlík, Bertlík, Baltík
Bartmannová	Bartmann
Barthetová	Barthet, Barthes, Berthet
Bartlettová	Bartlett, Bartlet
Bartleyová	Bartley
Bartoiová	Barto, Barco
Bartliová	Bartl
Markelová	Markelov
Marjánová	Marjan
Kombercová	Komberec
Markovcová	Markovec
Bartoníčková	Bartoníček, Bartončík, Bartoník
Bartišová	Bartiš
Bartkowiaková	Bartkowiak
Bartolliová	Bartolli
Bartoková	Bartok, Barco, Barto
Bartolenová	Bartolen
Bartolomějová	Bartoloměj, Bartolomej, Bartholomeu
Bartolová	Bartol, Bartolo, Bartoli
Bartolčicová	Bartolčic
Thälmannová	Thälmann, Thalmann
Bartoliniová	Bartolini, Bertolini
Markulewiczová	Marculewicz
Bartolettiová	Bartoletti, Bertoletti
Bartoshuková	Bartoshuk
Bartoňková	Bartoňka, Bartoněk
Bartoszová	Bartosz
Bartoschová	Bartosch
Bartuňková	Bartuněk
Bartušeková	Bartušek, Bartuška
Bartušová	Bartuška
Bartunčíková	Bartunčík
Bartusiaková	Bartusiak
Bartošovičová	Bartošovič
Bartošáková	Bartošák
Komancová	Komanec
Kolčová	Kolč, Kolča
Kolčárková	Kolčárek
Marquardtová	Marquardt
Bartůsková	Bartůsek, Bartásek
Václavíčková	Václavíček
Václavková	Václavek, Václav
Vyžrálková	Vyžrálek
Bartůňková	Bartůněk
Bartůšková	Bartůšek, Bartášek, Bartuška
Bartásková	Bartásek
Bartáčková	Bartáček
Bartášková	Bartášek, Barták, Barťák
Bartóková	Bartók, Bartok, Barták, Bartík
Marousková	Marousek
Maroušková	Maroušek
Maroneyová	Mahoney
Marosiová	Ma, Maroši
Maroszová	Marosz, Ma
Barčová	Barča, Bačer
Barčíková	Barčík, Bárčík, Barcík
Barášová	Baláš, Banáš
Martenková	Martenek
Kolínková	Kolín
Kolová	Kolka, Kolja
Kolumpková	Kolumpek
Baránková	Baránek
Škrášková	Škrášek
Škubnová	Škubna
Škubníková	Škubník
Martincová	Martinec
Martinesová	Martine, Martin
Martiová	Marci
Martinásková	Martinásek
Koloučková	Kolouček
Koloušková	Koloušek, Kolouček
Škráčková	Škráček
Škrobánková	Škrobánek
Basileová	Basile, Basilea, Basileus
Marušincová	Marušinec
Basiková	Basík
Válečková	Váleček
Baslarová	Baslar
Škrabálková	Škrabálek
Škrabánková	Škrabánek
Marčenková	Marčenko, Marčenkov, Marčok
Basárová	Basár
Basáková	Basák
Maráčková	Maráček
Marášková	Marášek, Marák, Maryška
Batalovová	Batalov
Batalová	Batal, Bata
Škovránková	Škovránek
Maršálková	Maršálek
Marčáková	Marčák
Marčevová	Marčev
Škopková	Škopek
Kolencová	Kolence
Batoušková	Batoušek
Batovcová	Batovec
Battleová	Battle
Masařová	Masař
Masariková	Masarik
Masarová	Masar, Masař
Kolbábková	Kolbábek
Masliková	Maslikov
Batunová	Batuna
Masiniová	Masini
Kokrhánková	Kokrhánek
Kokotková	Kokotek
Baumaneová	Bauman
Kokavcová	Kokavec
Kojčevová	Kojčev
Bauová	Baun
Baumbergerová	Baumberger
Kohůtková	Kohůtek, Kohútka
Kojalová	Kojál
Koháčková	Koháček, Koláček, Komáček
Kohoušková	Kohoušek
Kohutková	Kohutek, Kohútka
Kohoutková	Kohoutek
Kohánková	Kohánek, Kománek
Kohárová	Kožár, Komár, Kolár
Kohlíčková	Kohlíček, Kohlík
Šitoová	Šiko
Bautzová	Bautze
Tesárková	Tesárek
Bauschová	Bausch
Baxterová	Baxter
Širůčková	Širůček
Bavoráková	Bavorák
Mastersová	Masters
Mastílková	Mastík, Masílko
Šitarová	Šita
Bayeová	Bay, Bayle
Bayfordová	Bay
Bazarovová	Bazarov
Kofránková	Kofránek
Koffaová	Kaffa
Šindýlková	Šindýlek
Bazánová	Bazan
Bazlerová	Basler
Bačuvčíková	Bačuvčík
Bačvarovová	Bačvarov
Bačková	Baček
Kodádková	Kodádek
Kodíčková	Kodíček
Kodýdková	Kodýdek
Kodydková	Kodydek
Kodýtková	Kodýtek
Kodytková	Kodytek
Tereliová	Terela
Bařáková	Bařák, Bačák
Baňárová	Baňár
Baškircevová	Baškircev
Kodousková	Kodousek
Šimůnková	Šimůnek, Šimonko
Šimíčková	Šimíček
Baštincová	Baštinec
Šimánková	Šimánek, Šimán
Šimáčková	Šimáček
Kocúmová	Kocum
Kocurková	Kocurek
Baťulková	Batulka
Vélová	Véla, Véle, Víla
Tenkrátová	Tenkrát
Bašátková	Bašák
Beachová	Beach
Matiášková	Matiášek
Kocmánková	Kocmánek
Kocourková	Kocourek
Matoulková	Matoulek, Matulka
Kochánková	Kochánek
Matthesová	Matthes
Beallová	Beall
Bažanovová	Bazanov
Beavanová	Beavan
Beaunová	Beaune
Šimoníčková	Šimoníček
Šimotová	Šimo
Kobrlová	Kobrle
Koblová	Kebl
Koblížková	Koblížek
Koblischková	Koblischke, Koblischek
Bechiniová	Bechinie
Tellaová	Tell
Šimarová	Šimara
Bechyňová	Bechyně, Bechyňa
Matuševičová	Matuševič
Matušincová	Matušinec
Kněžínková	Kněžínek
Kněžíčková	Kněžíček
Kněžourková	Kněžourek
Vítečková	Víteček
Šilhánková	Šilhánek
Bedellová	Bedell
Knězková	Knězek
Knyttlová	Kny
Knápková	Knápek
Knýová	Knín
Matyášková	Matyášek
Knězáčková	Knězáček
Bedeová	Beda
Bedardová	Bedard
Bedrošová	Bedroš
Bedrychová	Bedrych
Bednarčiková	Bednárčik
Bedrníčková	Bedrníček, Bedrník
Bednárková	Bednárek, Bednár
Telcová	Telce
Vítovcová	Vítovec, Vítovka
Tekeľová	Teke
Knížová	Kníže, Kněž
Knížátková	Knižátko, Knížák
Beganovičová	Beganovič
Begleyová	Begley
Knotková	Knotek
Matějovcová	Matějovec
Matýsková	Matýsek, Matýšek
Matýsová	Matýs
Matějcová	Matějec, Matějka
Matějíčková	Matějíček, Matějík, Matějčík
Beilocková	Beilock
Beilová	Beil
Šichtařová	Šichtář
Behringová	Behring
Matásková	Matásek, Maťásek
Knižáková	Knížák
Bejčková	Bejček
Bejšovcová	Bejšovec
Bejerová	Bejer
Behunová	Behún
Matějčková	Matějček, Matějčík
Kniezková	Kniezek
Bejlková	Bejlek, Bejček
Belančíková	Belančík
Šetřilová	Šetřil
Bekárková	Bekárek
Ševečková	Ševeček
Beldíková	Beldík, Bedlík
Belecová	Belec
Šetková	Šetek
Belblová	Belbl
Techlová	Tecl
Kmošková	Kmošek
Knebelová	Knebel
Belingrová	Belinger, Bellinger
Víšková	Víšek, Víska, Vícha, Víša, Výška
Mauraová	Maur
Kmuníčková	Kmuníček
Kmoníčková	Kmoníček
Knapková	Knapek
Bellutiová	Bellouti
Mauteová	Maude
Mauritzoová	Mauritz
Kmetcová	Kmec
Klügerová	Kluger
Klímková	Klímko
Belousová	Belous
Klátová	Klát, Klápa
Klásková	Klásek, Kláska
Maysová	Maas
Klárová	Klára, Klár, Klárka, Klán
Belušová	Beluš, Beluša
Belucciová	Belucci
Belčáková	Belčák
Klušáková	Klusák, Klučák
Klušáčková	Klusáček, Klučák
Klváčková	Klváček
Benaissaová	Benaissa
Benaissová	Benaissa
Tatoušková	Tatoušek
Mazlová	Mázl, Mazel, Matl
Mazancová	Mazanec, Mazanka
Kluzová	Kluz
Kluvancová	Kluvanec
Klustová	Klust
Tatenová	Tata, Tate
Bendulová	Bendula
Šedovičová	Šedovič
Tatoová	Tata, Tate
Taterová	Tater, Tatar
Mazánková	Mazánek
Mazálková	Mazálek
Klusáčková	Klusáček
Mazurková	Mazurek
Klugarová	Klug
Klukáčková	Klukáček
Šedivcová	Šedivec
Benediková	Benedik, Bendik
Benensonová	Benenson
Kločková	Klokoč
Kloučková	Klouček
Klošková	Kloš
Klouzková	Klouzek
Benetinová	Benetin
Šebánková	Šebánek
Bengtsonová	Bengtson
Tarterová	Tater, Tartar
Beningová	Benning
Mařincová	Mařinec
Mařencová	Mařenka
Kloubcová	Kloubec
Kloubková	Kloubek, Klouba
Kloubová	Klouba, Kloub
Šebková	Šebek, Šeba
Benteová	Bente
Bennková	Benn
Klobásníková	Klobásník
Klopotková	Klopotek
Klomínková	Klomínek
Benová	Ben, Beno, Benn, Bena, Benka, Beng
Mašnerová	Mašon
Klišková	Klička, Klika
Mařánková	Mařánek
Klofandová	Klofanda
Klofcová	Klofec, Klosek
Bentzová	Bantz
Kloboučková	Klobouček, Kloboučky
Klintová	Klinc
Klirová	Klír
Šašková	Šaka, Šacha, Šašek
Šašmová	Šacha, Šamša
Benšíková	Beník
Klinkáčková	Klinkáček, Klinkáč
Klinčoková	Klinko
Beníčková	Beníček
Benýšková	Benýšek
Benáčková	Benáček
Klingmanová	Klingmann
Klimošková	Klimošek, Klimoš
Berdichová	Bertich, Berdych
Bercowová	Bercow
Berdalová	Berdal
Berchinová	Berchin, Bechin
Berchová	Bercha
Klimíčková	Klimíček
Klimánková	Klimánek
Klimáčková	Klimáček
Klimčovičová	Klimkovič
Klimčuková	Klimčák
Berecová	Berec
Beretová	Bera, Bert
Beranková	Beranek, Beran
Klimečková	Klimeček
Klimoszková	Klimoszek
Klihavcová	Klihavec
Bergeová	Berg, Bergen
Berglová	Bergl
Bergetová	Burget, Bergé
Šaturová	Šata
Šatánková	Šatánek
McBeanová	McLean
Klesová	Klesa
Klhůfková	Klhůfek
Kleslová	Klesl, Klesla
Kleštincová	Kleštinec
Berglundová	Berglund
Tandyová	Tandy
Šarhanová	Šarman
Klečánková	Klečánek
Kleybanovová	Klebanov
Kleypasová	Kley
Berkowitzová	Berkowitz
Berhardová	Berhard
Berkovcová	Berkovec
Berkhoutová	Berkhout
Berkleyová	Berkley, Berkeley
Berlietová	Berliet
Berlinová	Berlin, Berling
Berlusconiová	Berlusconi
Berhnartová	Bernhart
Berholdová	Berhold
Klesalová	Klesal
Berlakovichová	Berlakovich
Tamblynová	Tamblyn
Kleová	Klee
Klepáčková	Klepáček
Šantrůčková	Šantrůček
Bernatowiczová	Bernatowicz
Bernardyová	Bernardy, Bernard
Klejslová	Klesl, Klesla
Klejbanovová	Klebanov
Kleineová	Kleine, Klein
Kleislová	Kleis
Bernhartová	Bernhart
Bernfeldová	Bernfeld
Šanovcová	Šanovec, Šanov
Bernklauová	Bernklau
McKinseyová	McKinsey
McKiernanová	McTiernan
McKennaová	McKenna
Klauzová	Klauda
Beroušková	Beroušek
Bernášková	Bernášek
Berntsenová	Berntsen
Berová	Bera, Berka, Bern, Berov, Berk
Klattenová	Klatte
Bertensová	Bertens
Bertelliová	Bertelli
Klapálková	Klapálek
Klapsiová	Klapsia
Klaputová	Klaput
Klapitová	Klapita
Klapová	Klap, Klápa
McNicollová	McColl
Klapcová	Klapka
Klapetková	Klapetek
Klamová	Klem
Bertoniová	Bertoni, Berton
Šallerová	Šaler
Takalová	Takaka
Bertinottiová	Bertinotti, Bertinetti
Bertlová	Bertl
Včelařová	Včelař
Bertiová	Berti, Berta, Bert
Bervidová	Bervid, Bervida, Berwid
Berubeová	Berube
Mcgrathová	McGrath
Tainaová	Tain
Berčáková	Berčák
Berňáčková	Bernáček
Bertonová	Berton, Berthon, Bertone, Berta
Bertová	Berta, Bert, Barta
Berzsiová	Berzsi
Beránková	Beránek
Šajdková	Šajdek
Mechová	Mech
Mecová	Mec, Meca
Klabečková	Klabeček
Bessisová	Bessi
Besonovová	Besonov
Bestová	Besta, Best
Bestagnová	Bestagno
Šaffková	Šafka
Šafiková	Šafka
Šafranová	Šafrán
Medková	Medek, Meda
Kiseljevová	Kiseljov
Kittnarová	Kittner
Kittová	Kittl
Kirshnerová	Kirschner
Šafarová	Šavara, Šafár
Betlachová	Betlach
Bettencourtová	Bettencourt
Betíková	Betík
Betuštiaková	Betuštiak
Bettisová	Betti
Kirrinová	Kirin
Kisserová	Kiss
Bevisová	Bevis
Beumerová	Beumer
Větrovcová	Větrovec
Tabachová	Tabach
Šabalová	Šabala
Bezdomniková	Bezdomnikov
Bezdíčková	Bezdíček
Bezeková	Bezek
Bezemková	Bezemek
Bezoldová	Bezold
Kirchhofová	Kirchhoff
Megová	Mega, Meg
Bezručková	Bezručka, Bezručko
Bezpalcová	Bezpalec
Bečkeová	Bečka, Bečko
Bezůšková	Bezuška
Bezvodová	Bezvoda
Věčorková	Věčorek
Větříšková	Větříšek
Sílová	Síla
Síkorová	Síkora
Beňušová	Beňuš
Beňáčková	Benáček
Kioussiová	Koussi
Bečvaříková	Bečvařík
Beškeová	Beška
Beňasová	Beňas
Síkelová	Síkela
Beňadíková	Beňadík
Bialasová	Bialas, Bilas
Bialková	Bialek, Bilak, Biala
Bialoňová	Bialoň
Bialystoková	Bialystok
Séquardtová	Sequardt
Bibiová	Bibi
Bibikoffová	Bibikoff
Sáezová	Sáiz
Bidlasová	Bidlas
Bidermanová	Biderman, Bidermann
Bidláková	Bidlák
Kilkoonová	Kilkoon
Meilová	Meili
Meistrová	Meister
Száthmáryová	Szathmáry
Říháčková	Říháček
Biedlová	Biedl
Všetíčková	Všetíček
Biegunová	Biegun
Melanová	Melana
Bielinová	Bilin, Bilina
Bieleszová	Bielesz
Bieberlová	Bieberle
Bidmonová	Bidmon
Bielczyková	Bielczyk
Melbourneová	Melbourne
Melechová	Melech
Sztuchlíková	Stuchlík
Bierhausová	Bierhaus
Říhošková	Říhošek
Biegelová	Biegel
Biermannová	Biermann
Řápková	Řápek
Řičánková	Řičánek
Řádková	Řádek
Szikorová	Szikora
Kieneová	Kien
Bilalová	Bilal, Bilala
Vůjtková	Vůjtek
Řihánková	Řihánek
Řiháčková	Řiháček
Bijedičová	Bijedič
Bighamová	Bigham
Bildtová	Bildt, Bild
Melichárková	Melichárek
Billová	Bill, Billa, Billy, Bille
Bilesová	Bles
Szarvasová	Szarvas
Melisová	Melis
Szavayová	Szalay
Řezníčková	Řezníček
Řežábková	Řežábek
Řeřábková	Řeřábek
Billenová	Bille
Melkonenová	Melkonen
Melkusová	Melkus
Melkesová	Melkes
Melkettová	Melkett
Khaylová	Khail
Bilodeauová	Bilodeau
Bilsonová	Bilson
Bilohuščínová	Bilohuščín
Bilová	Bil, Bilo, Bilá, Billa
Biniasová	Binias
Biniová	Bini
Řepová	Řepa
Řehánková	Řehánek
Řeháčková	Řeháček
Řehůřková	Řehůřek
Syřínková	Syřínkův
Melíšková	Melíšek
Sysalová	Sisal
Řeholová	Řehola
Řehounková	Řehounek
Sypalová	Sypal
Řehnová	Řehna
Binová	Bin, Bina, Bini
Synáčková	Synáč
Biolková	Biolek
Synovcová	Synovec
Řebíčková	Řebíček
Mendíková	Mandík
Mengeová	Menger
Kestřánková	Kestřánek
Birgusová	Birgus
Wadeová	Wade
Mensingrová	Mensinger
Birkelandová	Birkeland
Menoušková	Menoušek
Kerseová	Kers
Bisahová	Bisaha
Sykáčková	Sykáček
Menzová	Menc
Sydorová	Sidor
Biseková	Bisek
Biskupcová	Biskupec
Merchantová	Marchant
Swiftová	Swift
Swintonová	Swindon
Ďuríčková	Ďuríček
Bissellová	Bissell
Merinová	Merino
Merová	Mer, Mero, Mere, Merv, Merz
Kerestéšová	Keresteš
Switová	Svit
Merlínová	Merlin
Kereková	Kerka, Kerk
Kerekéšová	Kerekeš
Swardová	Skard
Bitvarová	Bitvar
Bittová	Bitta, Bitto
Biwottová	Biwott
Svíteková	Svítek, Světík
Walchová	Walcha, Walch
Biňovcová	Biňovec
Bičáková	Bičák
Bičišťová	Bičiště
Bjelicová	Bjelica
Svrčková	Svrček
Bjedovová	Bjedov
Bjorgenová	Björgen
Björforsová	Björfors
Bjoergenová	Bjoergen
Blachaová	Blacha
Blachová	Blach, Blacha
Svojtková	Svojtek
Svášková	Svášek, Svácha, Sváček
Sváčková	Sváček
Svojšová	Svojše
Meszarosová	Meszáros
Kendalová	Kenda
Blackwoodová	Blackwood
Metelová	Metal
Metelcová	Metelec
Kempová	Kemp, Kempo, Kempe
Metková	Metek
Blahošová	Blahoš
Blahoušková	Blahoušek
Blahovcová	Blahovec
Blahetová	Blaheta
Blahnová	Blahna
Kelíšková	Kelíšek
Svitáčková	Svitáček
Blahůšková	Blahůšek
Metzlerová	Mettler
Blahunková	Blahunek, Blahůnek
Blaháčková	Blaháček
Blahútová	Blahút, Blahůt, Blahut
Blaiveová	Blaive
Blanchardová	Blanchard
Blakeleyová	Blakeley
Blakelyová	Blakely
Blahušková	Blahuška
Waleová	Walek
Blaiseová	Blaise
Blandová	Blanda
Blanchettová	Blanchett, Blanchet
Kejžarová	Kejhar
Svašková	Svašek, Svacha
Walková	Walek
Blascová	Blasco, Blasko
Blasbergová	Blasberg
Blancková	Blanck
Blanářová	Blanář
Blankersová	Blankers
Svatková	Svatek, Svata
Mezsárosová	Meszáros
Kejklíčková	Kejklíček
Blauová	Blau
Sušánková	Sušánek
Blatoňová	Blatoň
Blaštíková	Blaštík
Blaščáková	Blaščák
Blatová	Blata, Blato
Meškiová	Meška
Sušírová	Sušír
Kedroníčková	Kedroníček
Michalcová	Michalec
Bledelová	Bledel
Bledyová	Bledy
Bleckmannová	Bleckmann
Bleasdaleová	Bleasdale
Blecherová	Blecher
Kebrdlová	Kebrdle
Sušerová	Sušer
Waloszková	Waloszek
Bleicherová	Bleicher
Bleierová	Bleier, Blei
Michalíčková	Michalíček, Michalčík
Kaštánková	Kaštánek
Keblúšková	Keblúšek
Waltzová	Waltz
Blighová	Bligh
Blimlová	Bliml
Surmanová	Surman
Blokešová	Blokeš
Blodigová	Blodig
Blohoňová	Blohoň
Blohmannová	Blohmann
Blocková	Block, Blocký
Michlíčková	Michlíček
Kašpárková	Kašpárek
Kašpírková	Kašpírek, Kašperka, Kašperko
Surmová	Surma
Bloomfieldová	Bloomfield
Surovcová	Surovka
Blondinová	Blondin
Blondová	Blonda, Blond
Blondeauová	Blondeau
Kašparcová	Kašparec, Kašparda
Kařízková	Kařízek
Bloudková	Bloudek
Blowová	Blow
Blouinová	Blouin
Bloudíčková	Bloudíček
Blumbergaová	Blumberg
Blountová	Blount
Blomkvistová	Blomkvist
Blomová	Blom
Michálková	Michálek
Kačírková	Kačírek, Kačík
Surattová	Surat
Kačmáčková	Kačmáček
Blumensteinová	Blumenstein
Blumentrittová	Blumentritt
Blížilová	Blížil
Blytheová	Blythe
Blábolilová	Blábolil
Blätterbauerová	Blätterbauer
Blättermannová	Blattmann
Bláhovcová	Bláhovec, Bláhovka
Kačenová	Kačena, Kača, Kačenka
Blštáková	Blšták, Blšťák
Bobeková	Bobek
Blómkvistová	Blomkvist
Blöchlová	Blöchl
Blumenthálová	Blumenthal
Summová	Summa
Bobisudová	Bobisud, Bobysud
Bobotová	Bobo
Kawabataová	Kawamata
Mihalceová	Mihalec
Bobíšková	Bobíšek
Bobrová	Bobr
Miffková	Mifka
Bobáňová	Bobáň
Bobrukiewiczová	Bobrukiewicz
Mikitinová	Mikita
Mijanovičová	Mihanovič
Kavčáková	Kavčák
Kaválková	Kaválek
Kavalová	Kavale
Bocianová	Bocian
Bochníčková	Bochníček
Bocherová	Boch
Kavánková	Kavánek
Kavijová	Kavi
Kavalířová	Kavalíř
Sulimová	Sula
Bochenková	Bochenko, Bochenek
Suledrová	Sula
Bochezová	Boc
Bocheneková	Bochenek
Bockstefelová	Bockstefel
Bocksteffelová	Bocksteffel
Bociánová	Bocián, Bocian
Mikolášková	Mikolášek
Mikovcová	Mikovec
Bodiová	Bodi
Bodečková	Bodeček
Bodasová	Bod
Bocánová	Bocán
Sulimaová	Sula
Mikulincová	Mikulinec
Mikulcová	Mikulec
Mikulandová	Mikulanda
Kaublová	Kauble
Bodenová	Boden
Bodzsarová	Bodzsar
Boděrová	Boděra
Boereeová	Boeree
Boehringerová	Boehringer
Suitnerová	Soutner
Boelová	Boel, Boël
Boganimová	Boganim
Bodžárová	Bodžár
Boesová	Boese
Boeseová	Boese
Mikuláčková	Mikuláček
Katová	Kata, Kat, Kato, Katha, Katov
Sudková	Sudek
Bogačevová	Bogačev
Bogaňová	Bogaň
Bogatajová	Bogataj
Boerreová	Boerre
Bogdalíková	Bogdalík
Bogapovová	Bogapov
Bogorová	Bogor
Bogdálková	Bogdálek
Bogdánová	Bogdán, Bogdan
Boggsová	Boggs
Kasáčková	Kasáček
Kataová	Kata, Katada, Katan
Suchánková	Suchánek
Bogdanowiczová	Bogdanowicz
Bogdanovičová	Bogdanovič
Bogenová	Bogen
Bogoljubovová	Bogoljubov
Bogdanovová	Bogdanov
Bogdaňová	Bogdaň
Mikšíčková	Mikšíček
Bogleová	Bogle
Boguschová	Bogusch
Bogárová	Bogár
Bogáňová	Bogáň
Boguszová	Bogusz
Sucháčková	Sucháček
Suchopárková	Suchopárek
Kasslerová	Kassner, Kassel
Bohdálková	Bohdálek
Bohanusová	Bohanus, Bohan, Bohanos
Wautersová	Waters
Wattersová	Waters
Střížková	Střížek
Bohunková	Bohunka, Bohuna, Bohuněk
Bohatcová	Bohatec
Bohoňková	Bohoněk
Karásková	Karásek, Karaska
Milcová	Milec, Milda, Mild
Kasiková	Kasikov
Milavcová	Milavec
Bohuslávková	Bohuslávky
Wawrzyczková	Wawrzyczek
Boitierová	Boi
Boitorová	Boito
Boisselierová	Boisselier
Bohuňková	Bohuněk, Bohunka
Bohánková	Bohánek
Bohůnková	Bohůnek, Bohánek
Milaniová	Milanič
Karčová	Kačer
Střádalová	Strádal
Boháčková	Boháček
Bojarkinová	Bojarkin
Bojarskichová	Bojarski
Boiffinová	Boiffin
Bojanovová	Bojanov, Bojana
Karschová	Ka
Karvánková	Karvánek
Milenková	Milenka
Bokrošová	Bokroš
Bokserová	Bokser, Bocker
Bokišová	Bokiš
Bokajová	Bokaj
Bokorová	Bokoro
Bokotová	Bokota, Boko
Bokuová	Bok
Bolardtová	Bolardt, Bolard
Bokšeflová	Bokšefl
Bolaňosová	Bolaňos
Bokšová	Bokš, Bokša, Boška
Bokšteflová	Bokštefl, Bokšefl
Mildorfová	Milda
Střelečková	Střeleček, Střeleč
Stýjskalová	Stýskal
Boledovičová	Boledovič
Karpíšková	Karpíšek
Stěhulová	Stěhula, Stěhule
Boldenová	Bolden, Borden, Bowden
Boldiová	Boldi
Karonová	Karo
Bolečková	Boleček
Stögrová	Stöger
Bolkiahová	Bolkiah
Bolinová	Bolina, Bolinka
Karlíčková	Karlíček, Karlík
Bolková	Bolka, Bolko
Bomarová	Bomar, Boma
Stárková	Stárek, Stára
Státníková	Stádník
Karlovcová	Karlovec, Karlovka, Karlov
Boltíková	Boltík
Bolvanová	Bolvan
Karhánková	Karhánek
Bonelová	Bonello
Bondorová	Bondor, Bondo
Bonasová	Bonas
Karliková	Karlik, Kalčik
Bongardová	Bongard
Bondarová	Bondar
Karezová	Kařez
Karffová	Ka
Bonnaireová	Bon
Boninová	Bonino, Bonini
Bonková	Bonk, Bongo
Kardashianová	Kardashian
Bončková	Bonček
Karbonová	Karba
Strýčková	Strýček
Stržínková	Stržínek
Miláčková	Miláček
Stryalová	Strya
Borchmannová	Bochmann
Karabáčková	Karabáček
Milčáková	Milčák
Stránilová	Stránil
Borensteinová	Borenstein
Borerrová	Borer
Borejová	Borej
Bordáčová	Bordáč
Boremanová	Boreman
Borenová	Boren
Karabcová	Karabec
Borgiová	Borgia, Borg, Borgo
Borgenová	Borgen
Borečková	Boreček
Borgerová	Borger, Bürger
Kapsová	Kapsa
Kaprálková	Kaprálek
Borhyiová	Borhy
Borhyová	Borhy
Boriková	Borik
Borgulová	Borgula
Strupková	Strupek
Weingärtnerová	Weingartner
Borkovcová	Borkovec
Borkovičová	Borkovič, Berkovič
Borkalová	Borkala
Borkerová	Borker
Kapounková	Kapounek
Kaplánková	Kaplánek
Miová	Mia, Mio, Mi, Min, Mius, Moi, Mil
Stropková	Stropek
Bormansová	Bormans, Borman
Borlettiová	Borletti
Borlová	Borl, Borel, Boll
Bormanová	Borman, Bormann, Bierman
Borková	Bork
Weisrová	Weis
Bornová	Born, Borno, Borna, Biron
Bornerová	Börner, Bierner, Bonner, Burner
Miroová	Miro, Miron, Mir
Strnádková	Strnádek
Borovcová	Borovec, Borov
Borossová	Boross
Borotová	Boro
Borovinšeková	Borovinšek
Strnadlová	Strnadel
Borová	Bor, Bora, Boro, Borov, Boros, Borg
Kantůrková	Kantůrek
Strháková	Strbák
Borsiková	Borsik, Bors
Borseková	Borsek
Kantorková	Kantorek
Strejčková	Strejček
Bortlíčková	Bortlíček
Bortoliová	Bortoli
Bortová	Bort
Borstová	Borst
Borsányiová	Borsányi, Borsanyi
Bortniková	Bortnik
Borutová	Borut, Boruta
Strelcová	Strelka, Strelec
Borčová	Borč
Boršková	Boršek
Borísková	Borisek, Borýsek
Borýsková	Borýsek
Strašilová	Strašil
Straňková	Straněk, Stranka
Wellmanová	Wellmann
Stračánková	Stračánek
Stračárová	Stračár
Borňáková	Borňák
Borščyková	Borščyk
Misárková	Misárek
Kananová	Kanin
Bosnyaková	Bosnyak
Bosomová	Bisom
Bosová	Bosa, Bose
Bosmanová	Bosman
Bosniaková	Bosnyak
Boskovičová	Boskovič
Boswellová	Boswell
Boszczyková	Boszczyk
Čížová	Číža, Číž
Bosseová	Bosse, Bossen
Bostwicková	Bostwick
Bossongová	Bossong
Stradějová	Straděj
Bosticková	Bostick
Stradenová	Strada
Kampová	Kampa, Kamp
Bothmaová	Both
Botellaová	Botella
Bosáčková	Bosáček
Boséová	Bosé, Bose
Bothmerová	Bothmer
Mittelmanová	Mittelmann
Boubeníčková	Boubeníček
Botínová	Botín
Botlová	Bolt
Botošová	Boboš
Botlíková	Botlík
Čížková	Čížek
Strachová	Strach
Stoszková	Stoszek
Čítková	Čítek
Čírtková	Čírtek
Bouaziziová	Bouazizi
Botwinová	Botvin
Boubalová	Boubal
Boubelová	Boubela
Kamenzová	Kamenz, Kama
Kameníčková	Kameníček
Bottová	Botto, Bitto
Bouchertová	Boucher
Bouchetová	Bouchet
Botíková	Botík, Bobík
Bouchardová	Bouchard
Bouberlová	Bouberle
Boucková	Bouck, Bouček
Boucová	Bouc
Bouilhaguetová	Bouilhaguet
Mitáčková	Mitáček
Boudíková	Boudík
Bourdinová	Bourdin
Bourdyová	Bourdy
Boultonová	Boulton
Kalášková	Kalášek
Kalášová	Kalaš
Kalíšková	Kalíšek
Kalábková	Kalábek
Čuřínová	Čuřín, Čeřín
Bournová	Bourn, Bourne
Čálková	Čálek
Bourková	Bourek, Boura
Mičánková	Mičánek
Miňková	Minka, Minko
Bourguignonová	Bourguignon
Bourgesová	Bourges
Boutyová	Boudy
Bousková	Bousek, Bous
Mičudová	Mičuda
Mičunková	Mičunek
Kalousková	Kalousek, Kalous
Stoklásková	Stoklásek
Bouzová	Bouza, Bouz, Bouda
Bouzaová	Bouza
Boučková	Bouček
Bouwmeesterová	Bouwmeester
Bouzková	Bouzek, Bouza
Bowermanová	Bowerman
Bowaterová	Bowater
Boweová	Bowe
Stojarová	Stojan
Čunková	Čunek, Čung
Mišincová	Mišinec, Mičinec
Kallatová	Kalla
Boxanová	Box
Bowserová	Bowser
Bowyeová	Bowie
Bowerová	Bower
Bowersová	Bowers
Bowesová	Bow
Bowieová	Bowie
Boylová	Boyle
Boysenová	Boysen
Boyerová	Boyer
Boytonová	Boyton
Boyeová	Boyes
Boydenová	Boyden
Kalmíková	Kalčík
Kaliánková	Kalianko
Bočová	Boč
Bočáková	Bočák, Bobák
Bočánková	Bočánek
Bozemanová	Bozeman, Boseman
Boëlová	Boël
Bozková	Bozak
Bozděková	Bozděk
Čubíková	Čupík
Stiskalová	Stiskala
Čtvrtníčková	Čtvrtníček
Bočánová	Bočáň, Bočan
Bočkajová	Bočkaj
Čtveráčková	Čtveráček, Čtverák
Bočáňová	Bočáň, Bobáň, Bogáň
Mištinová	Miština
Mišurcová	Mišurec
Bočeková	Boček, Bořek, Božek
Bořková	Bořek
Bořánková	Bořánek, Bogánek, Bočánek
Bořkovcová	Bořkovec
Bošinová	Bošina, Bobina
Wertheimrová	Wertheim, Wertheimer
Miščová	Miška
Kalibová	Kalibos
Bošuková	Bošuk
Božetěchová	Božetěch
Wessellová	Wessels
Boščíková	Boščík
Čoová	Čo, Čou, Čon
Božeková	Božek, Boček
Božanovová	Božanov
Čoudková	Čoudek
Čoupková	Čoupek
Čorňáková	Čerňák
Čotková	Četka
Brabazonová	Brabazon
Brabcová	Brabec
Božová	Bož, Božka, Božák
Božoňová	Božoň
Božková	Božka, Božek
Mladcová	Mlada
Kalhusová	Kalmus, Kalkus, Kalfus
Stiburková	Stiburek
Stibůrková	Stibůrek
Člupková	Člupek
Čmejrková	Čmejrek
Brablíková	Brablík
Braamová	Bra
Brabencová	Brabenec
Brablcová	Brablc
Brablecová	Brablec
Mlatečková	Mlateček
Brachánková	Brachánek
Bracháčková	Bracháček
Brachovcová	Brachovec
Bracqová	Bracq
Mlejnková	Mlejnek
Mlsová	Mlsna
Mládková	Mládek
Bragaová	Braga
Braginová	Bragin
Bradáčková	Bradáček
Kakáčková	Kakáček
Mlčková	Mlček
Brandesová	Brandes
Čistjakovová	Čisťjakov
Brambasová	Brambas
Brandisová	Brandis
Kaisrová	Kaizr, Kaizer, Kaiser, Kaizar, Kaisa
Brandstätterová	Brandstätter
Brandtlová	Brandtl, Brandel
Mociková	Mocík
Kahancová	Kahan
Kahánková	Kahánek, Kakánek
Brantnerová	Brantner
Brantolová	Brantol
Brantalová	Brantál
Brantlyová	Brantly
Brantlíková	Brantlík
Kahovcová	Kahovec
Brasherová	Brasher
Kadérková	Kaderka
Kadubcová	Kadubec
Moeová	Moa
Činovcová	Činov
Brassányová	Brassány
Bratová	Bret
Kadláčková	Kadláček
Kadlčková	Kadlček
Kadlousková	Kadlousek
Bratušeková	Bratušek
Bratrychová	Bratrych
Stefaniová	Stefani, Stefanie
Steelová	Stela
Braunbocková	Braunbock
Braudová	Braud
Braxatorisová	Braxatoris
Braxtonová	Braxton
Bravencová	Bravenec
Čiháčková	Čiháček
Kacálková	Kacálek
Kadlečková	Kadleček
Kadeřábková	Kadeřábek
Kadeřávková	Kadeřávek
Kadlicová	Kadlic
Mohnhauptová	Mohn
Brauseová	Brause
Brazierová	Brazier
Bravermanová	Braverman
Kacířová	Kacíř
Staňkovičová	Stankovič
Stavělová	Stavěl
Whitelová	White
Bredalová	Bredal
Bredeová	Breden
Brebisová	Brebis
Staňková	Staněk, Staňa, Stanko
Kabourková	Kabourek
Kabrlová	Kabrle
Mokráčková	Mokráček
Brehmerová	Brehmer
Čeňková	Čeněk
Breenová	Breen
Čečková	Čeček
Kabíčková	Kabíček
Kacafírková	Kacafírek
Stavarovičová	Starovič
Bredowová	Bredow
Kaberlová	Kabele, Kabelka, Kabela
Moldová	Mold
Čečilová	Čečil
Breletová	Brelet
Breitwieserová	Breitwieser
Bremontová	Bremont
Bremová	Brem
Breitenfeldová	Breitenfeld
Jívová	Java, Jáva
Moličová	Možič
Moliková	Molík
Breníková	Breník
Brendzová	Brendza
Brenerová	Brener
Brengleová	Brengle
Brethová	Bret
Bretová	Bret
Bressonová	Bresson
Starkošová	Starkov
Jášková	Jášek, Jaška, Jaško
Jírovcová	Jírovec
Brettschneidrová	Brettschneider
Breuelová	Breuer
Bretschneiderová	Bretschneider
Brettfeldová	Brettfeld
Brezňáková	Brezňák
Breznenová	Breznen
Járová	Jára, Jáma, Jáva
Jílková	Jílek
Mombasová	Mombasa
Molčová	Molča, Molka
Molzerová	Mölzer
Momotová	Momo
Molčíková	Molčík
Stapeová	Stape, Stap
Čerňová	Čerňův
Červínková	Červínek, Červín
Červíčková	Červíček, Červík
Červová	Červa
Brhlíková	Brhlík, Bršlík
Bricqová	Bricq, Brick
Jásková	Jásek
Staníčková	Staníček, Staník
Stančevičová	Stankevič
Stansfieldová	Stanfield
Brightmanová	Brightman
Brickerová	Bricker
Moncmanová	Moncmann
Červencová	Červenka
Černěnková	Černěnko
Brindzáková	Brindzák
Momutová	Mom
Juříčková	Juříček, Juríček
Juřinová	Juřina, Jurina
Briscová	Brisk
Brinkmanová	Brinkmann
Brinkemová	Brink
Stanerová	Stanner, Stan
Bristowová	Bristow
Brisudová	Brisuda
Brisová	Bris, Brise
Brizendineová	Brizendine
Jurčková	Jurček
Brndiarová	Brndiar
Brlicová	Brlica
Stafordová	Stafford
Černíčková	Černíček
Broadwellová	Broadwell
Broadyová	Broady
Broadfootová	Broadfoot
Černošáková	Černošák
Černušáková	Černušák
Juránková	Juránek
Jurásková	Jurásek
Juráčková	Juráček
Brnová	Brno
Brnčálová	Brnčál
Černošová	Černoš, Černoch, Černýš
Brochová	Broch, Boch, Bloch
Jurášková	Jurášek, Juráček
Juríčková	Juríček, Juříček, Jurčík
Brodzáková	Brodzka
Monsportová	Monsport
Jurníčková	Jurníček
Juroszková	Juroszek
Brodníčková	Brodníček
Brodová	Broda, Brod
Brodieová	Brodie
Černová	Černo, Černov
Broichová	Broich
Broncová	Bronec
Černostová	Černosta
Srkalová	Srkal
Srholcová	Srholec
Brontëová	Brontë
Brončeková	Bronček
Junová	Jun, Juna, Juno, June, Jung
Jurczková	Jurczek
Juračáková	Jurčák
Srníčková	Srníček
Černegová	Černega
Černeková	Černek, Černík
Černišenková	Černušenko
Černilová	Černil
Junorová	Junior
Junáková	Junák
Montilletová	Mon
Junášková	Junášek
Broscheová	Brosche
Brothánková	Brothánek, Brotánek
Brotánková	Brotánek
Julínková	Julínek
Broušková	Broušek, Brousek, Brouček
Spěváčková	Spěváček
Broučková	Brouček
Černačová	Černáč
Broulímová	Broulím, Broulík
Brozová	Broz, Broza
Moravcová	Moravec, Morava
Morathová	Mora
Wilczková	Wilczek
Brožkovcová	Brožek
Brožková	Brožek
Brožovičová	Brožovič
Brožajová	Brož
Juklíčková	Juklíček, Juklík
Čepčorová	Čepčor
Čeporanová	Čeporan
Brožíčková	Brožíček
Bruchmilová	Bruchmil
Brucháčková	Brucháček
Morcinková	Morcinek
Brudňáková	Brudňák, Brudňak
Moriceová	Mořice, Moric
Jozífková	Jozífek
Sporerová	Spörer
Brtníčková	Brtníček, Brtnička
Čeperová	Čepera
Čepelíková	Čepelík
Čepková	Čepek
Brumková	Brumek
Splavcová	Splavec
Mosbacherová	Mosbacher
Moráčková	Moráček
Brundageová	Brundage
Brunnocková	Brunnock
Wilková	Wilt
Jouklová	Joukl
Jouzková	Jouzek, Jouza
Brunetová	Brunete
Brunelová	Brunel
Brunenová	Bruen
Brunová	Brun, Brunn, Bruna, Bruno, Brune
Brunsová	Bruns, Brunn
Josefová	Josef, Josefa, Josefi
Spenceová	Spencer
Spielmanová	Spielmann
Čenková	Čenda
Čenová	Čenda, Čenla
Willeová	Wille
Jorníčková	Jorníček
Spadeová	Spade
Bryolová	Bryol
Mothaová	Mota
Motejlková	Motýlek, Motýl
Spalová	Spal, Spala
Brzicová	Brzica
Brzesková	Brzesko, Brzeski
Brzková	Brzek
Brábková	Brábek
Čelmáková	Čermák
Čeloudová	Čeloud
Mothová	Mott
Mostková	Mostek, Most
Jolyová	Joly
Brömmelová	Brömmel
Brávková	Brávek
Bránišová	Brániš, Braniš
Brázdovičová	Brázda
Bráborcová	Bráborec
Součková	Souček
Sovíčková	Sovíček
Brániková	Bráník
Brányiková	Brányik
Brúderová	Brüder
Bräuerová	Bräuer, Bruer, Brauer, Breuer
Brňová	Brňo
Brňáková	Brňák
Brčková	Brčko
Brüllová	Brüll
Soušková	Soušek
Johánková	Johánek
Moussová	Mauss
Wiltschová	Wilt
Sovjaková	Sojka
Brůjová	Brůj, Brůjův
Bršlíková	Bršlík
Brücherová	Brecher, Blücher
Brücková	Brück, Brücke, Bruck
Brňovjáková	Brňovják
Bubalová	Bubalus
Bubancová	Bubanec
Buberníková	Buberník
Brůčková	Brůček
Brůžková	Brůžek, Brůža
Mourečková	Moureček
Mourková	Mourek, Mour
Mourová	Mour, Moor
Mouralová	Moural
Moureauová	Moureau
Jochymková	Jochymek
Bubeníčková	Bubeníček
Jochcová	Jochec, Joch
Jochumová	Joch
Jobánková	Jobánek
Sosnovcová	Sosnovec
Bubrlová	Bubrle
Bubílková	Bubílek
Winellová	Win
Bubnárová	Bubnár
Bubáková	Bubák, Bubáč, Bubík
Čecháčková	Čecháček
Jiříkovicová	Jiříkovice
Jiříčková	Jiříček
Sosnová	Sosna
Soulková	Soulek
Jirůšková	Jirůšek
Jiřišťová	Jiřiště, Jiřišta
Jiřincová	Jiřinec, Jiřinka, Jiřina, Jiřice
Sorrensenová	Sorensen
Čechmánková	Čechmánek
Buchholzová	Buchholz
Jiroušková	Jiroušek
Jirovcová	Jirovec
Jiroutková	Jiroutek
Jirousková	Jirousek
Buchvaldová	Buchvald
Čačíková	Čačík, Čařík, Čaník
Buckinghamová	Buckingham
Čaňková	Čaněk, Čaník
Bucháčková	Bucháček
Častvajová	Častvaj
Jirdásková	Jirdásek, Jirásko
Jiránková	Jiránek
Jiráčková	Jiráček
Jirášková	Jirášek
Moňáková	Molák
Buczková	Buczek
Sopoušková	Sopoušek
Možnárová	Možnar
Jiroudková	Jiroudek
Somogyiová	Somogy
Sontagová	Sonntag
Sonnková	Sonnek
Buckmanová	Buckman
Čarková	Čarek
Moštková	Moštek
Mošťková	Moštěk
Jináčková	Jináček
Budweisserová	Budweisser
Budová	Buda, Budo, Bud, Budva, Boda, Budov, Bouda
Budošová	Budoš
Mravcová	Mravec
Mrakešová	Mrakoš
Jindáčková	Jindáček
Jindráčková	Jindráček, Jindrák
Budínková	Budínka, Budín, Budinka
Budíšková	Budík
Budzáková	Budzyk
Čankajšková	Čankajšek
Solterová	Solte
Buffiniová	Buffini
Čamková	Čamek
Bufordová	Buford
Mrovcová	Mrovec
Ježková	Ježek
Sollárová	Solár
Wittková	Wittek, Witt, Witti
Buiová	Bui
Buissonová	Buisson
Mrůzková	Mrůzek
Mrzílková	Mrzílek
Mrózková	Mrozka, Mrózek, Mrůzek
Čadílková	Čadík, Čadílek
Bujárková	Bujárek, Buďárek
Bujnochová	Bujnoch
Čadková	Čadek, Čadca
Bujnošková	Bujnošek, Bujnoch
Bujoková	Bujok
Bukovecová	Bukovec
Jeřábková	Jeřábek, Jeřáběk
Ječmínková	Ječmínek
Bujáčková	Bujáček
Bukáčková	Bukáček
Bukóciová	Bukóci
Bukovičová	Bukovič
Buksová	Buksa, Buska, Busk
Bukvaldová	Bukvald
Čabová	Čaba, Čabův
Buková	Buk, Buka, Bukov, Buča, Buč
Mudranincová	Mudraninec
Bulavová	Bulava
Bulgerová	Bulger, Burger
Bulawová	Bulawa
Bulatovičová	Bulatovič
Bulanderová	Bulander
Bulanová	Bulan
Bulantová	Bulant
Sokolíčková	Sokolíčko
Wohlgemutová	Wohlmut
Wohryzková	Wohryzek
Bulsarová	Bulsar
Bulgakovová	Bulgakov
Bultasová	Bultas
Bullová	Bull, Bulla
Buláková	Bulák, Burák
Bumbalíková	Bumbalík
Bumbarisová	Bumbaris
Bulánková	Bulánek, Bulánka
Bulušková	Bulušek
Bulíčková	Bulíček, Bělíček
Sojičová	Somič
Jeschková	Jeschke
Jestříbková	Jestříbek
Woldová	Wolde
Bundchenová	Bundchen, Bündchen
Jeslínková	Jeslínek
Buntonová	Bunton
Sochůrková	Sochůrek
Sochorcová	Sochorec
Bunkeová	Bunke, Bunček
Bunková	Bunč, Bunt, Bunga
Bundilová	Bundil
Bundová	Bunda
Jeroušková	Jeroušek
Sobíšková	Sobíšek
Buquoyová	Buquoy
Wolkrová	Wolker
Wollerová	Wöller
Bunčková	Bunček, Bunč
Jeriová	Jerie
Burantová	Burant
Sobalová	Soba
Munzová	Münz, Mund, Muns
Snížková	Sněžka, Snížek
Worthová	Worth
Worlová	Worel
Burdetteová	Burdett, Burdet
Burelová	Burel, Burela
Burdigová	Burdi
Jenčková	Jenček
Jentschková	Jentschke
Jentschová	Jentzsch
Burghardtová	Burghardt, Burghard
Smýkalová	Smýkal, Smékal
Smítalová	Smítal
Burgessová	Burgess
Smíšková	Smíšek
Buriová	Buri, Bury
Buriánková	Buriánek, Buryánek
Buriancová	Burianec
Burianková	Burianek
Burjačoková	Burjačok
Murayová	Murai
Muraiová	Murai, Muri, Mur, Mura
Jenečková	Jeneček, Jenček
Jendrísková	Jendrísek
Úředníčková	Úředníček
Burkovcová	Burkovec
Murinová	Murin
Muričová	Mučič
Muricová	Muric, Muryc
Jelinková	Jelinek
Jemeljanovová	Jemeljanov
Smrčeková	Smrček
Burmistrovová	Burmistrov
Burmesterová	Burmester
Burlandová	Burland
Muroňová	Muroň
Jelénková	Jelének, Jelínek, Jelenka
Jelínková	Jelínek
Smolařová	Smolař
Burseová	Burde
Smolarková	Smolarek
Burnsteinová	Burnstein
Burová	Bura, Burov, Bure, Burg
Burseyová	Bursey
Burwellová	Burwell
Burstonová	Burston
Bursáková	Bursák
Smetová	Smet
Úlovcová	Úlovec
Burýtková	Burýtek
Burýšková	Burýšek, Buryška, Buryšek
Burčeková	Burček
Jelečková	Jeleček
Muselová	Musel, Musela
Buryová	Bury
Buschbaumová	Buchsbaum
Musatová	Musa
Smartová	Smart
Jedrýsková	Jedrysek
Butnaruová	Butnaru
Buttová	Butta, Butt
Butterfieldová	Butterfield
Smažilová	Smažil
Jašúrková	Jašúrek
Jechoutková	Jechoutek
Jechová	Jech, Jecha, Jecho
Muthová	Mutt
Sládečková	Sládeček
Sládková	Sládek
Musálková	Musálek
Musílková	Musílek
Jebáčková	Jebáček
Jačenková	Jaček
Jačimovičová	Jakimovič
Jebousková	Jebousek
Jebálková	Jebálek
Slováčková	Slováček
Buusová	Bus, Buzu, Buš
Buvalová	Buvala, Bulava
Buxtonová	Buxton
Wynneová	Wynne
Buzicová	Buzic, Buzice
Buzková	Buzek
Jazariová	Jazairi
Javůrková	Javorka
Jašíčková	Jašíček
Jašurková	Jašurek, Jašúrek
Jaworková	Javorka
Bučoková	Bučok
Slonková	Slonek
Buďová	Buďa, Buda
Mutterová	Muster
Mutonová	Muta, Mutov
Javurková	Javurek, Javůrek
Bučánková	Bučánek
Bušovová	Bušov
Bušková	Buškov, Bušek
Javorová	Javora, Javor
Mušálková	Mušálek
Buťáková	Buťák, Běťák, Buňák, Bulák
Slezáčková	Slezáček, Slezák
Bužková	Bužek, Bužík
Bušáková	Bušák, Bučák, Bubák
Mužíčková	Mužíček
Mykerinová	Mykerin
Jasonová	Jason, Jasan
Slepcovová	Slepcov
Slepicová	Slepica
Bystřičanová	Bystřičan
Bynesová	Bynes
Jarůšková	Jarůšek, Jaruška
Slavíčková	Slavíček, Slavík
Slavotínková	Slavotínek
Slepánková	Slepánek
Jaroňková	Jaroněk
Myslivečková	Mysliveček
Bábalová	Bába
Bzdýlová	Bzdýl
Bytešníková	Bytešník
Bytnarová	Bytnar, Bitnar
Bábiková	Bábík
Myslilová	Myslil
Bábíková	Bábík, Babík
Báchorová	Báchor
Bábíčková	Bábíček, Babíček
Bábková	Bábek
Bádalová	Bádal, Badal
Jaroszová	Jarosz
Jaroušková	Jaroušek
Slancová	Slanec
Slaneyová	Slaný
Bártková	Bártko, Bártek, Bartko
Bársonyová	Bársony
Bártíčková	Bárčík
Jarcová	Jarque, Jarča, Jarka
Jarolímková	Jarolímek
Bárdosová	Bárdos
Bárdošová	Bárdoš
Bárkányiová	Bárkány
Bébarová	Bébar, Bebar
Bárnetová	Bárnet, Barnet
Bärtlová	Bärtl, Bártl
Báťková	Baťka
Bátrlová	Bátrla
Bählerová	Bühler
Bálková	Bálek, Balko
Bándyová	Bandy
Májíčková	Májíček, Majíček
Janůrková	Janůrek
Jarková	Jarka, Jarča, Jarek
Skřivánková	Skřivánek
Slakrová	Slakr
Bäumerová	Baumer
Bíbrová	Bíbr
Bícová	Bíca
Bérešová	Béreš, Bereš
Bétancourtová	Betancourt
Slabihoudková	Slabihoudek
Skůčková	Skůček
Jančárková	Jančárek
Mánková	Mánek, Manka
Bíliková	Bílik, Bilik, Bělik
Máčelová	Máčel, Máčela
Máčková	Máček
Jančálková	Jančálek
Bódiová	Bódi, Bodi
Bísková	Bísek
Janďourková	Janďourek, Jandourek
Janírková	Janírek
Janásková	Janásek, Jansák
Skučková	Skuček
Bílová	Bíl, Bíla, Bílka
Bónová	Bon
Bóžiková	Božik
Bíziková	Bízik, Bízek
Bízková	Bízek, Bíza
Bökerová	Böker
Böllerová	Böller
Bömerová	Bomer
Skuhrovcová	Skuhrovec
Bögerlová	Bögerl
Böttgerová	Böttger
Böserová	Böser
Yamashitová	Yamashita
Bürglová	Bürgl
Janulková	Janulek
Janteková	Jante
Yanagiová	Yan
Skrbková	Skrbek
Janoszková	Janoszek
Janošcová	Janošec
Janoštáková	Janošťák, Janšák
Mählerová	Mahler
Bürknerová	Bürkner
Běhálková	Běhálek
Běhůnková	Běhůnek, Běhúnek
Běhulová	Běhula
Běhunková	Běhunek
Běhunčíková	Běhunčík, Behunčík
Běhalíková	Běhalík
Bělehradová	Bělehrad
Bělehrádková	Bělehrádek
Bělejová	Bělej
Běhounková	Běhounek
Bělicová	Bělica, Bělice
Běliková	Bělik
Bělešová	Běleš
Méunierová	Meunier
Mílová	Míl, Míla, Mil
Míkovcová	Míkovec
Janoušková	Janoušek, Januška
Janovcová	Janovec, Janov
Běloušková	Běloušek
Běloubková	Běloubek
Bělounková	Bělounek
Janosiová	Janos
Jankásková	Jankásek
Skotnicová	Skotnice
Běláčková	Běláček
Bělunková	Bělunek
Běšťáková	Běšťák, Běťák, Bešťák
Janiššová	Janiš
Jankovcová	Jankovec
Mírová	Míra, Mira, Myra
Skopcová	Skopec
Skokánková	Skokánek
Skipalová	Skipala, Skypala
Skipperová	Skipper
Sklenárová	Sklenár
Březovičová	Březovič
Mítková	Mítek
Jandásková	Jandásek, Janásek
Jandáčková	Jandáček
Janiczková	Janiczek
Sklenáková	Sklenák
Březovjáková	Březovják
Břežková	Březka
Břeňková	Břeněk, Břeň
Březáčková	Březáček, Březák
Jandejsková	Jandejsek
Janesová	Janas, Jans, Jan
Břinková	Brink
Břínková	Břínek
Břoušková	Břoušek
Břicháčková	Břicháček
Bůchová	Bůcha, Boch
Bůšková	Bůcha, Bůček
Bříštělová	Bříštěla
Bůžková	Bůžek
Bžatková	Bžatek
Bůbelová	Bůbela
Skalleová	Skala, Skalbe
Cabejšková	Cabejšek
Jampílková	Jampílek
Jandourková	Jandourek
Míšková	Míšek
Mórová	Mora
Míšová	Míša
Cacková	Cacek
Cadburyová	Cadbury
Jambůrková	Jambůrek
Jakůbková	Jakůbek, Jakúbek
Sivošová	Sivoš
Sivoková	Sivok
Youngsová	Young
Yorkeová	York
Cafourková	Cafourek
Jakšlová	Jakš
Mühlemannová	Mühlemann, Mühl
Mühlhanslová	Mühlhansl
Mühlhauserová	Mühlhauser
Sirůčková	Sirůček
Jakubíčková	Jakubíček, Jakubčík, Jakubičko
Jalásková	Jalásek
Cakirová	Cakir
Mündlerová	Mündl
Mühlšteinová	Mühlstein
Mühlstejnová	Mühlstein
Sirotková	Sirotek
Sirelliová	Sirelli
Jakubcová	Jakubec, Jakubka
Jakrlová	Jackl
Siowersová	Siewers
Yusufová	Yusuf
Münzrová	Münzer, Münz
Mědílková	Mědílek
Calmanová	Calmann
Yvonová	Yvon
Calnanová	Calmann
Calábková	Calábek
Jakerlová	Jakerle
Mžourková	Mžourek
Jadrníčková	Jadrníček
Campionová	Campin
Simicová	Simic
Simionatová	Simion
Nabílová	Nabíl
Nadymáčková	Nadymáček, Nadýmáček
Silvestrová	Silvestr, Silvester, Silvestro, Silvestre
Silvermanová	Silverman
Zachlederová	Zachleder
Zachrlová	Zachrla
Canková	Cang
Jacháčková	Jacháček
Jachková	Jachek
Jabůrková	Jabůrek
Jablůnková	Jablůnka
Ištvancová	Ištvanec
Silvarová	Silvar
Silnicová	Silnice, Silnica
Ištvánková	Ištvánek, Ištván
Ištánková	Ištánek
Capoušková	Capoušek
Capriolová	Caprio
Silbersteinová	Silberstein, Silverstein
Capůrková	Capůrek
Silavová	Sila
Caraiová	Carya
Cargillová	Cargill
Nairoová	Nair
Najerová	Najer
Ivánková	Ivánek, Iván
Sigmuntová	Sigmund
Zahradníčková	Zahradníček
Zahradová	Zahrada
Zahoříková	Záhořík
Iveyová	Ivey
Carillová	Cara
Sidotová	Sido
Siechová	Sicha
Sidonisová	Sidon
Sidorjaková	Sidorjak, Sidorják
Carnajevová	Carnajev
Ivancová	Ivanco, Ivanec, Ivanko
Sichrová	Sicher
Sibřinová	Sibřina
Carrereová	Carrera
Napolitanová	Napolitano
Nannisová	Nanni
Shánělová	Sháněl, Scháněl
Carstensenová	Carstensen
Carstensová	Carstens
Casanová	Casas
Siaová	Siao
Shifferová	Schiffer
Narovcová	Narovec
Islerová	Isler
Nasrínová	Nasír
Castejová	Casta
Sheuflerová	Scheufler
Shellyová	Shelly
Nastaseová	Nastase
Nataleová	Natale
Shanonová	Shannon
Sharpeová	Sharpe
Cattrallová	Cattrall
Shalalová	Shala
Seňková	Seňko, Seněk
Našincová	Našice
Cejlová	Cejl
Cejpková	Cejpek
Seylerová	Seiler
Zaorálková	Zaorálek
Zanottová	Zanetto
Seyatová	Seat
Seydelová	Seidel
Zanottiová	Zanetti
Načeradcová	Načeradec
Ionová	Ion, Iona, Ión
Zaplatílková	Zaplatílek
Zapletálková	Zapletálek
Zaplatilková	Zaplatilek
Zapotilová	Zapotil
Cellová	Celli
Zardoová	Zarda
Ceplechová	Ceplecha
Nedveděvová	Nedvedův
Nedvídková	Nedvídek
Zasadilová	Zasadil
Zaripová	Zaripov
Cermonová	Cerman
Senzová	Senza
Serbousková	Serbousek
Nedomlelová	Nedomlel
Neelová	Néel
Nefová	Neva, Nevo, Nen
Zatřepálková	Zatřepálek
Cetlová	Cetl
Neilsonová	Neilson
Semšová	Sema
Neilandová	Neil
Indráčková	Indráček
Nekulová	Nekula
Nekutová	Nekut
Zayaková	Zajak
Nekorancová	Nekoranec
Začalová	Začal
Chalhoubová	Chalhoub
Imríšková	Imríšek
Chalupníčková	Chalupníček
Zbahnová	Zbahna
Immrová	Imro
Chanelová	Chanel
Nemšová	Nemeš
Zbružová	Zbruž
Zbuzková	Zbuzek
Zbránková	Zbránek
Zbrojová	Zbroj
Zbrožková	Zbrožek
Illingrová	Illinger
Ilková	Ilko, Ilka, Ilek, Ilk
Charousková	Charousek, Charous
Neprášková	Neprášek
Zdanovcová	Zdanovec
Neriusová	Neri, Neris
Ilečková	Ileček
Sehnálková	Sehnálek
Nesbitová	Nesbit
Nesládková	Nesládek
Nesová	Nesa
Segatiová	Sega
Ihnačincová	Ihnačinec
Chemišincová	Chemišinec
Cheníčková	Cheníček
Chenoehová	Chen
Cherryhová	Cherry
Secová	Seck
Sebránková	Sebránek
Sechovcová	Sechovec, Sechov
Nevařilová	Nevařil
Zdychyncová	Zdychynec
Nevolová	Nevole
Nevinsová	Nevins
Zděnovcová	Zděnovec
Chlebcová	Chlebec, Chlebda
Chlebečková	Chlebeček
Schülerová	Schöler
Chlapková	Chlapek
Chladková	Chlad
Ianová	Ian, Iona
Chlebovcová	Chlebovec, Chlebov
Chlebková	Chlebek
Chlebníčková	Chlebníček
Hůsková	Hůsek
Hůtová	Hůla
Hůlovcová	Hůlovec
Schánilcová	Schánilec
Zedková	Zedek
Chlomková	Chlomek
Hříbková	Hříbek, Hříba
Chládková	Chládek
Chlíbcová	Chlíbec
Chloupková	Chloupek
Zedníčková	Zedníček
Chlupáčková	Chlupáček
Hřebíčková	Hřebíček
Chmelíčková	Chmelíček
Chmurová	Chum, Chur
Hýsková	Hýsek
Hýlová	Hyl
Hýnová	Hyna, Heno
Chmelová	Chmela, Chmel
Chocholoušková	Chocholoušek
Chocholoušová	Chocholouš
Höllingerová	Hollinger
Hüblerová	Hybler
Chodorová	Chodora
Chocholáčková	Chocholáček
Chocholáčová	Chocholák
Chodilová	Chod
Chodníčková	Chodníček
Schumichrastová	Schumichrast
Hörmanová	Hörmann
Schulczová	Schultz
Hógelová	Hügel
Hísková	Hísek
Hämmerleová	Hammerle
Nečásková	Nečásek
Schořálková	Schořálek
Zeleňáková	Zelenák
Chorvátová	Chorvát, Chorvat
Chotková	Chotek
Hátlová	Hátle
Hásková	Hásek, Háskov
Häuslová	Hujsl
Schonerová	Schöner
Schovancová	Schovanec
Chotová	Choc
Chovánková	Chovánek
Chovancová	Chovanec
Chramcová	Chramcov
Chovanečková	Chovaneček
Zelníčková	Zelníček
Chrapková	Chrapek, Chrápek
Hájíčková	Hájíček, Hajíček
Hálková	Hálek, Halka, Halko
Chrastová	Chrasta, Chrast, Chrást
Hádková	Hádek, Háda
Hyová	Hey
Chrasteková	Chrasta, Chrástek
Schnyderová	Schnider
Hyánková	Hyánek
Christlová	Christel
Christinová	Christin, Christina, Christine, Christen
Zemancová	Zemanec
Chromečková	Chromeček, Chromeč
Chromková	Chromek
Zemánková	Zemánek
Hyjánková	Hyjánek, Hyánek
Schlehová	Schlech
Chrtková	Chrtek, Chrt
Schlossarková	Schlossarek, Schlossar
Chroustková	Chroust, Chroustek
Hušková	Huska, Hučko
Schindlová	Schandl
Chržová	Chrz
Chrástková	Chrástek, Chrást, Chráska
Niederlová	Niederle
Chuchvalcová	Chuchvalec
Chungová	Chung, Cheng, Ching
Chudarová	Chudara
Huňáčková	Huňáček
Zetková	Zetek, Zeta
Chudárková	Chudárek
Chudáčková	Chudáček
Churánková	Churánek
Churáčková	Churáček
Scheuterová	Scheuer
Chvalková	Chvalka, Chvalek, Chvalko, Chválek
Chvilíčková	Chvilíček
Chvalíková	Chvalík
Schettová	Schettl
Huttrová	Hutter
Hutníková	Hutnik
Schelleová	Schelle, Schell, Schele
Chwistková	Chvistek
Chybová	Chyba, Chába, Chaba
Chvostová	Chvosta
Chvílíčková	Chvílíček
Chvístková	Chvístek
Chválková	Chválek
Chytílková	Chytílek
Husárková	Husárek
Huterová	Huber, Hutter, Huger
Zhejbalová	Zhejbal
Zeťová	Zeta
Scheiderová	Scheid, Scheidler
Chábková	Chábek
Chýlková	Chýlek, Chýla
Huserová	Hus
Schafferusová	Schaffer
Zicháčková	Zicháček
Cibíčková	Cibíček, Cibiček
Cibulcová	Cibulec
Hurdálková	Hurdálek
Scacchiová	Sacchi
Scalerová	Scala
Niklová	Nikl, Nikel
Hunyadiová	Hunyadi
Cigánková	Cigánek
Ziegová	Ziege
Humňalová	Humňal
Zielencová	Zielenec
Cilečková	Cileček
Cilínková	Cilínek
Cimbolincová	Cimbolinec
Sašinová	Sašin, Sasina
Humpolíčková	Humpolíček
Cimbůrková	Cimbůrek
Humlíčková	Humlíček
Zientková	Zientek
Sayrová	Sayre
Hulčíková	Hulčík
Nikšová	Nick
Hulánová	Holán, Helán
Hulcová	Hulec, Hulka
Savageová	Savage
Savincová	Savinec
Ciprysová	Ciprys
Ciprušová	Cipruš
Hulenová	Hulena, Hule
Hujíčková	Hujíček
Hulejová	Huleja
Saudková	Saudek
Sattranová	Satran
Ninovová	Nino, Ninove
Zigáčková	Zigáček
Zijáová	Zija
Satohová	Sato
Huffová	Hoff
Claretová	Clare
Hudousková	Hudousek
Clarkeová	Clarke
Claudelová	Claudel
Sassová	Sass
Hubová	Huba, Hub, Houba
Hudečková	Hudeček
Hubálková	Hubálek
Hudková	Hudek
Hudcová	Hudec
Sarkozyová	Sarkozy, Sarközy, Sarkózy
Hubáčková	Hubáček, Hubáč
Hubschová	Hübsch
Clicquotová	Clicquot
Clementsová	Clement
Clementeová	Clement, Clemente
Hrůzková	Hrůzek, Hrůza
Clokeová	Clowe
Closeová	Close, Clos
Ničková	Nič, Nick
Hrádková	Hrádek
Hrčemová	Hrček
Sanínová	Sanín
Saníová	Saní, Sání, Saník
Santerrová	Santer
Hrábková	Hrábek, Hrabko, Hráček
Hrušová	Hruša, Hruš
Hruzková	Hruzek, Hruza
Codeová	Code, Cod, Coda
Sanitriková	Sanitrik
Hrozová	Hroza
Hrozínková	Hrozínek
Nohavcová	Nohavec
Nohovcová	Nohovec
Cojocarová	Cojocaru
Hrtánková	Hrtánek
Zimková	Zimko, Zimek
Hroncová	Hronec
Hrozková	Hrozek
Hrouzková	Hrouza, Hrouz
Sandsová	Sands
Sandorová	Sandor
Colettová	Colette, Coletti
Zimáčková	Zimáček
Hrovatová	Hrovat
Hroníčková	Hroníček
Sandbergová	Sandberg
Sanderová	Sander, Sandero
Hromková	Hromek, Hrma
Hrnčiříiková	Hrnčiřík
Hrodková	Hrodek
Columbová	Columbus, Columbo, Colomba
Hrnčiariková	Hrnčiarik
Hrnčiarová	Hrnčiar
Comptonová	Compton
Hrkalová	Hrkal
Hrnčárková	Hrnčárek
Hricová	Hric, Hrica
Hrdoušková	Hrdoušek
Hrdlicová	Hrdlic
Samaková	Samak
Samcová	Samko
Connellyová	Connelly
Samašová	Samaš
Hrehová	Hreha
Samardzichová	Samardzich
Constantinesková	Constantinescu
Coombsová	Coombs
Hrbáčková	Hrbáček
Hrbková	Hrbek
Hrazánková	Hazánek
Hrazdílková	Hrazdílek
Coorsová	Coors
Hraníčková	Hraníček, Hraník
Hradílková	Hradílek
Salihová	Sališ
Nosálková	Nosálek
Noskovová	Noskov
Nosková	Nosek, Nos
Hradilková	Hradilek, Hradil
Corneillová	Corneille
Coriová	Coria, Cori
Hrachovcová	Hrachovec
Nousková	Nousek
Hradcová	Hradec
Cortinová	Cortina
Corsariová	Corsair
Notová	Nota, Noto, Nola
Hrabáčková	Hrabáček, Hrabčák
Hoštová	Hošta, Hošt, Holta
Hoštáková	Hosták
Hrabálková	Hrabálek
Hrabánková	Hrabánek
Salavcová	Salavec
Hrabincová	Hrabinec
Hrabcová	Hrabec
Hošťálková	Hošťálek
Hoštálková	Hoštálek, Hošťálek
Salamánková	Salamánek
Salašová	Salaš, Salas
Novellová	Novell, Novella
Hořánková	Hořánek, Holánek
Hořínková	Hořínek
Hořáková	Hořák, Horák
Sakaová	Sakala
Cotillardová	Cotillard
Courtlandová	Court
Courtová	Court
Cousinsová	Cousins
Coyneová	Coyne
Hovězáková	Hovězák
Hověžáková	Hověžák, Hovězák
Crandallová	Crandall
Saherová	Saha
Nováčková	Nováček
Houseová	House
Houšťková	Houštka, Houška, Houštěk
Zmožková	Zmožek
Sagetová	Sage
Creeková	Creek
Houčková	Houček
Nuhlíčková	Nuhlíček
Housová	Housa
Sagerová	Sage
Crhounková	Crhounek
Safínová	Safín
Crhonková	Crhonek
Houfková	Houfek
Hotárková	Hotárek
Houdková	Houdek, Houda
Sadová	Sada, Sado, Sade
Sadoňová	Sadoň
Sadílková	Sadík, Sadílek
Nulíčková	Nulíček
Hotovcová	Hotovec
Saekiová	Saeki
Hosteková	Hostek
Hostýnková	Hostýnek
Hostášková	Hostášek
Hostanová	Hostan
Hostková	Hostek
Nutilová	Nutil
Sadiková	Sadikov
Znamenáčková	Znamenáček
Nurmiová	Nurmi
Horálková	Horálek
Horáčková	Horáček
Hoskovcová	Hoskovec
Horovitzová	Horowitz
Horňáčková	Horňáček, Hornáček
Culková	Culek
Sabadinová	Sabadin
Cunninghamová	Cunningham
Nyklíčková	Nyklíček
Růžková	Růžek, Růža, Růčka
Růžová	Růža, Ráža
Curtissová	Curtiss
Cupáková	Cupák
Curryová	Curry
Cushmanová	Cushman
Růťová	Růta
Nábělková	Nábělek
Horníčková	Horníček
Rýdová	Rýda, Rýdl
Rýdelová	Rýdel, Rýdlo, Rydel, Rýda
Cvrčková	Cvrček
Cvíčková	Cvíček
Nádeníčková	Nádeníček
Röszlerová	Rössler
Cymorková	Cymorek
Rösselová	Rossel
Zoubelová	Zoubele
Zoubková	Zoubek
Horejsková	Horejsek
Nárovcová	Nárovec
Cyrilová	Cyril
Náprstková	Náprstek
Horehleďová	Horehleď
Hoplíčková	Hoplíček
Czabová	Csaba, Chaba
Czapková	Czapek
Zrcková	Zrcek
Zourková	Zourek, Zour
Zounková	Zounek
Rönschová	Rösch
Hopmansová	Hopman
Czetmayerová	Czetmayer
Honzíčková	Honzíček, Honzík
Némethyová	Németh
Czudková	Czudek
Cábalová	Cabala, Cabal, Cába
Czyžová	Czyž, Czýž
Honzová	Honz, Honza, Honzl, Hons
Honková	Honč, Honek, Honěk, Hong, Hont
Honalová	Honal, Hon
Honsárková	Honsárek
Ráčková	Ráček
Rázková	Rázek
Cílková	Cílka, Cílek
Cásková	Cásek
Nórisová	Noris
Níčová	Nič, Nýč, Neč
Císková	Císek
Ráthová	Rath
Dadová	Dada, Dáda
Dadonová	Dadonov, Dadone
Dahlmanová	Dahlmann
Holíčková	Holíček
Holárková	Holárek
Holásková	Holásek
Ráiová	Rain
Zrůbková	Zrůbek
Němcová	Němec, Němce
Holénková	Holínek
Holáčková	Holáček
Holášková	Holášek
Holánková	Holánek
Rábková	Rábek, Rábca, Rába
Němčicová	Němčice
Němčičová	Němčice
Holubcová	Holubec, Holub
Holubková	Holubek
Holoubková	Holoubek
Holopírková	Holopírek
Holtová	Holt, Holta
Holomojová	Holomoj
Holovčáková	Holovčák
Damcová	Damm
Ryšánková	Ryšánek
Damová	Dam, Damo, Damův
Damková	Damek
Rymerová	Rimer, Remer, Römer
Rypáčková	Rypáček
Obdržálková	Obdržálek
Holomelová	Holomel
Holomková	Holomek
Danečková	Daneček
Danesová	Danas
Zubcová	Zubko
Holeštová	Holešta
Holingrová	Holinger
Obrechtová	Obrecht
Ryjáčková	Ryjáček
Danysová	Danys, Danis
Danová	Dana, Dan, Danov, Dano, Dane
Daníšková	Daníšek, Daniška
Daníčková	Daníček
Zubíčková	Zubíček, Zubík
Daněčková	Daněček
Rybníkářová	Rybnikář
Dardennová	Dardenne
Darebníčková	Darebníček
Rybníčková	Rybníček
Rybařová	Rybař, Rybář
Rybáčková	Rybáček
Holarová	Hola
Darová	Dara, Daro, Dare
Dashová	Dasha
Ochranová	Ochranov
Ochránková	Ochránek
Hohnová	Höhn
Ružinová	Ružín
Zuevová	Zujev
Hofírková	Hofírek
Davisová	Davis, Davids, Dawis
Davieová	Davies
Hoferková	Hoferek
Ruxová	Rus
Dačičová	Dačič, Dača
Davídková	Davídek, Davidko
Dačová	Dač, Dača
Daďová	Dada, Daňa
Odrobinová	Odrobina
Hodoušková	Hodoušek
DeGeneresová	DeGeneres
Dayanová	Day
Dazová	Dada
Dašková	Dako, Dašek
DeLayová	DeLay
Dařílková	Dařílek
Daříčková	Daříček
Deaneyová	Dean
Dařbujánová	Dařbuján
Deatonová	Deaton
Hodysová	Hodis
Rutková	Rut
Rutherová	Rutter, Rutar
Hodiánková	Hodiánek
Hodková	Hodek
Oharková	Oharek
Dejmková	Dejmek
Deitchová	Deitch
Zurerová	Zumer, Zuber, Zubera
Delaneyová	Delaney
Deirová	Deira
Ohmanová	Ohmann
Ohnutková	Ohnutek
Zuvačová	Zubač
Zurynková	Zurynek
Zurýnková	Zurynek
Hnaníčková	Hnaníček
Hlúšková	Hlúšek, Hluško
Hlůžová	Hlůže
Hnídková	Hnídek
Hlůšková	Hlůšek
Zuzjaková	Zuzák
Zuzanaková	Zuzanka
Zuzánková	Zuzánek
Rupešová	Rupeš, Rubeš
Rupcová	Rupec
Demišová	Demiš
Hlubůčková	Hlubůček
Demová	Dema
Rupertová	Rupert, Rudert
Deneová	Dene
Deneuvová	Deneuve
Denevueová	Deneuve
Oklešťková	Okleštěk, Okleštek
Okrouhlicová	Okrouhlica, Okrouhlice
Hloušková	Hloušek
Hloužková	Hloužek
Hložková	Hložek
Denisovová	Denisov
Hlubučková	Hlubuček
Hlubková	Hlubek
Zvolánková	Zvolánek
Rulíšková	Rulíšek, Rulík
Depetrisová	Depetris
Derenová	Dera
Dercová	Derc, Derco
Zvoníčková	Zvoníček
Oktábcová	Oktábec
Hlohová	Hloh
Hlobilková	Hlobil
Derrová	Derc, Derner, Derka
Dernová	Dern
Denčevová	Denčev
Desaiová	Desai
Deržmíšková	Deržmíšek
Hlavníčková	Hlavníček
Rudyšarová	Rudišar
Desortová	Dezort
Hlaváčková	Hlaváček
Rudošová	Ruda
Deusová	Deus
Hlahůlková	Hlahůlek
Hlasivcová	Hlasivec
Oldová	Olda
Olejníčková	Olejníček, Olejník
Devlinová	Devlin, Delvin
Deverová	Devera
Devosová	Devo
Hjelmová	Hjelm
Hladílková	Hladílek, Hladík
Hladečková	Hladeček
Diamandisová	Diamandis
Diallová	Diallo
Diatlová	Dietl
Diblíčková	Diblíček, Diblík
Rubanová	Ruman
Rubáčková	Rubáček
Rubková	Rubek
Ruckerová	Rücker
Hirmerová	Himmer
Hirnerová	Hinner
Oliweriusová	Oliverius
Diekmanová	Diekmann
Zwyrtková	Zwyrtek
Rožníčková	Rožníček
Zábranková	Zábrana
Záborcová	Záborec
Himmlová	Himl
Dimitrová	Dimitr, Dimiter, Dimitra
Rošková	Roško, Rošek, Roš
Rošlapilová	Rošlapil
Dimitrivová	Dimitri, Dimitr
Rozínková	Rozínek
Ročárková	Ročárek
Rošarová	Roš
Hilmanová	Hilmand
Rozsývalová	Rozsíval
Rozprýmová	Rozprým
Ročková	Roček
Záhorcová	Záhorec, Záhorka
Rozkydálková	Rozkydálek
Rozkovcová	Rozkovec
Hieková	Hieke
Divilková	Divilek
Divíšková	Divíšek
Divílková	Divílek
Royalová	Royal
Roweová	Role
Heřmánková	Heřmánek
Hečová	Heča
Dlabáčková	Dlabáček
Ondroušková	Ondroušek
Rovnerová	Rozner
Zátopková	Zátopek
Rovašová	Rolava
Doanová	Doan
Dobišková	Dobiš
Ondřejčková	Ondrejček
Hetmánková	Hetmánek
Roupcová	Roupec, Roupa
Rougová	Rough
Rousková	Rousek, Rous
Roubíčková	Roubíček, Roubík
Roubínková	Roubínek
Roubcová	Roubec
Dobrotinová	Dobrotín
Dobrotová	Dobrota
Heršálková	Heršálek
Ondrůšková	Ondrůšek, Ondruška
Ondráčková	Ondráček, Odráček
Dobíšková	Dobíšek
Dobsonová	Dobson
Hertzová	Hertz
Zídková	Zídek, Zíd
Rothbauerová	Rotbauer
Herová	Hero, Hera, Herka, Herc, Herm
Rosůlková	Rosůlek
Zúbková	Zúbek
Roszkopfová	Rosskopf
Dobšíčková	Dobšíček
Herringová	Herring
Herremanová	Herman
Opasková	Opasek
Rostová	Rost
Zůbková	Zůbek
Dofková	Dofek
Rotenová	Rose, Rosen
Rossnerová	Rössner, Rosner
Dojáčková	Dojáček
Dohnálková	Dohnálek
Opršalová	Opršal, Opršál
Opršálová	Opršál
Opíchalová	Opíchal, Opichal
Herfortová	Herford
Roskovcová	Roskovec
Dolejšková	Dolejšek
Hercová	Herc, Herck
Oravcová	Oravec
Dolečková	Doleček
Doležílková	Doležílek
Doležálková	Doležálek
Rosenauová	Rose
Rosenthalová	Rosenthal
Dolníčková	Dolníček
Herajnová	Herajt
Ronková	Ronek, Rončka
Rootová	Roo
Ropková	Ropek
Ronnová	Runn
Domanjová	Doman
Hendricksová	Hendrick
Domabylová	Domabyl
Dombková	Dombek
Dominová	Domin, Domina
Dominiková	Dominik
Orjabincová	Orjabinec
Oriešková	Oriešek
Hemzáčková	Hemzáček
Domorázková	Domorázek
Helísková	Helísek
Helíšková	Helíšek
Helásková	Helásek
Rolinsová	Rolins
Rolečková	Roleček
Orlová	Orel, Orle
Orozsová	Orosz
Hellová	Hell, Hella
Donátková	Donátek
Rokůsková	Rokůsek
Donnellyová	Donnelly
Donnelová	Donnell
Doornaertová	Doorn
Heligová	Helige
Rojíčková	Rojíček, Rojík
Ortesová	Ordesa
Roiderová	Raider
Rohrichová	Rohr
Dorniková	Dornič, Dornička, Dornica
Orálková	Orálek
Hejrová	Hejra
Hejtmanová	Hejtman
Hejtíková	Hejtík
Dorrová	Dort, Dorn, Dore
Dorseyová	Dorsey
Dorovskichová	Dorovski, Dorovskij
Rohlederová	Rohleder
Osenová	Osex
Heiserová	Heise
Osbourneová	Osbourne, Osborne
Osbournová	Osbourn, Osbourne
Hejlková	Hejlek
Hejlíčková	Hejlíček, Hejlík
Dostálková	Dostálek
Rodninovová	Rodinov
Douderová	Doudera
Doubková	Doubek
Heinemanová	Heinemann
Hejdušková	Hejdušek
Doupovcová	Doupovec
Osifová	Osif
Robková	Robek
Doveová	Dove
Dousková	Dousek
Robaová	Rob, Rosa
Dozorcová	Dozorec
Heilmanová	Heilmann
Došková	Došek
Robejšková	Robejšek
Dočkálková	Dočkálek
Drabičšáková	Drabiščák
Oslancová	Oslanec
Oslizlová	Oslizlo
Hefková	Hefek
Dragilová	Dražil
Osmanová	Osman
Heerová	Heyer
Drapalová	Drápal, Drapa
Rittová	Ritt, Ritta, Rit
Ospálková	Ospálek
Osová	Oss
Drastichová	Drastich
Hecová	Heka, Heda
Hebrová	Hebr, Hebra
Osterlohová	Osterloh
Headová	Head
Riosová	Ries, Riis, Ri
Drechsslerová	Drechsler
Drchalová	Drchal
Hašplová	Hašpl
Hašová	Haša, Haš, Hach, Hasa, Hacha
Drbušková	Drbušek
Dreiseitlová	Dreiseitl
Haškovcová	Haškovec, Haškov
Hašková	Hašek, Hačko, Hacha, Hach
Haštabová	Haštaba
Haňáčková	Haňáček, Hanáček
Haňáková	Haďák, Hanák, Halák
Drejslová	Drejsl
Drholcová	Drholec
Hazáková	Haďák
Hawleyová	Hawley
Hawnová	Hawen
Ringerová	Ringer, Ringler
Drijverová	Driver
Drndálková	Drndálek
Ostřížková	Ostřížek
Drkulová	Drkula
Drlíčková	Drlíček, Drlík
Driverová	Driver
Drobiličová	Drobilič
Drobilková	Drobil
Drobilíková	Drobilík
Drobečková	Drobeček
Havranková	Havránek, Havran, Havránka
Havlénová	Havlen, Havlín
Drobílková	Drobílek
Droběnová	Droběna
Drobíková	Drobík
Rinaldiová	Rinald
Ringelová	Ringel, Ryngel
Havelcová	Havelec, Havelka
Havlovicová	Havlovic
Haverlandová	Havelland, Hawerland
Havlásková	Havlásek
Otrubová	Otruba
Drobková	Drobek, Drobec
Drotárová	Drotár
Drobcová	Drobec
Drubková	Drubek
Drsová	Drs
Otradovcová	Otradovec
Rimbaudová	Rimbaud
Rimesová	Rimes
Havasová	Havas
Hauzírková	Hauzírek
Otčenášková	Otčenášek
Hauová	Haug, Hauf
Riglová	Rygl
Drábková	Drábek
Dráždilová	Dráždil
Držmíšková	Držmíšek
Drážníková	Drážník
Oudová	Oude
Hattenstadová	Hattestad
Dubcová	Dubec
Dubanová	Dubany
Oukropcová	Oukropec
Ouředníčková	Ouředníček
Hassová	Hassa, Hasse
Hasselbergerová	Haselberger
Hasová	Hasa, Hasna, Hase, Hasek
Dubovová	Dudov
Riefenstahlová	Riefenstahl
Rieraová	Rier
Rideová	Ridel
Riderová	Rider
Duchková	Duchek
Ducháčková	Ducháček
Dudarová	Dular
Dudešková	Dudešek
Ricottiová	Rico
Dudáčková	Dudáček
Očásková	Očásek
Harčáriková	Harčarik
Ozábalová	Ozábal
Harvánková	Harvánek
Očenášková	Očenášek
Harásková	Harásek, Haraska
Dugasová	Dukas
Duffková	Duffek, Duff
Dukasová	Dukas
Dujíčková	Dujíček
Ošlejšková	Ošlejšek
Paceltová	Pacelt
Paceová	Pace, Pape
Dukátníková	Dukátník
Richtersová	Richter
Dulovcová	Dulovec
Harrissonová	Harisson
Dulínková	Dulínek
Dumková	Dumek
Dundáčková	Dundáček
Pachnarová	Pachner
Paculová	Pacula
Harnová	Harna
Dunajová	Dunaj
Dunleyová	Dunley
Packerová	Packer
Packová	Pecka
Harmáčková	Harmáček, Harmáčkův
Harmanová	Herman
Durajová	Duraj
Paersonová	Pearson
Haringaová	Haring
Rhodeová	Rhode
Durdilová	Durdil
Durosová	Duro
Hardimanová	Hardman
Harejková	Harýk
Rezková	Rezek, Reza
Paigeová	Paige, Paiger
Harbichová	Harbich
Harbáčková	Harbáček
Reynková	Reynek
Reytharová	Reithar
Dusová	Dus
Duspivová	Duspiva
Dušová	Duša
Dušánková	Dušánek, Dubánek
Harazímová	Harazím
Pajurková	Pajurek, Pajůrek
Harasimová	Harazim
Palauová	Palau
Retinová	Retin
Retková	Rečka
Dušková	Dušek, Dušta
Hančičová	Hančič, Hanč, Hančička
Hanáčková	Hanáček, Haňáček
Hanzlíčková	Hanzlíček, Hanzlík
Hanzová	Hanz, Hanzl, Hanzi
Hanzálková	Hanzálek
Dymáčková	Dymáček, Dimáček
Palinková	Palinek, Palínek, Pašinka
Palivcová	Palivec
Hantuchová	Haltuch
Palečková	Paleček
Hansová	Hans, Hansa, Hansl
Dziadkowiecová	Dziadkowiec
Dzubáková	Džubák
Hanousková	Hanousek
Hanoušková	Hanoušek
Hannová	Hann, Hanna, Hanno, Hanne
Hankovcová	Hankovec
Paloušková	Palouš
Rendleová	Rendl
Dítětová	Dítě
Haničincová	Haničinec
Remková	Remco, Rema
Děckuláčková	Děckuláček
Remencová	Rema
Dědourková	Dědourek
Dědečková	Dědeček
Dědicová	Dědice
Děrgelová	Děrgel
Palátková	Palák
Hamáčková	Hamáček
Palusgová	Paulas
Rejčová	Rejč
Dřevojánková	Dřevojánek
Rejšková	Rejšek, Rejcha
Rejthárková	Rejthárek
Rejlková	Rejlek
Rejsková	Rejsek
Paltrowová	Paltrow
Hamzíková	Hamsík
Panajotovová	Panajotov
Důrová	Dora, Dura
Pancová	Panec
Panašová	Panaš, Paneš
Pancerová	Pancer
Hamerová	Hamer, Hamera, Hammer
Reiková	Reiko
Hamatiová	Hama
Hamariová	Hamara
Reicheová	Reicher
Halíčková	Halíček
Džubarová	Džubara
Halátková	Halátek, Halák
Haláčková	Haláček, Halčák
Halášková	Halášek
Pantůčková	Pantůček
Džurbanová	Durban
Reheová	Reh
Pantálková	Pantálek
Haltůfová	Haltuf
Halousková	Halousek
Regnierová	Régnier
Halmichová	Halbich
Paníčková	Paníček
Panýrková	Panýrek, Panýr
Redlichová	Redlich
Ebermannová	Ebermann
Panáčková	Panáček, Panáč
Pančáková	Penčák
Halkovová	Holkov
Recová	Rea
Halimová	Halim, Halima, Halm, Halmo
Papalová	Papas, Papa
Halimiová	Halimi
Papadakisová	Papadakis
Papiová	Papin
Papoušková	Papoušek
Rašticová	Raští
Rebcová	Rebec
Halamíčková	Halamíček
Papáčková	Papáček, Papák
Paprskářová	Paprskář
Rašinová	Rašín
Eddyová	Eddy
Ražková	Račko
Halamková	Halámka, Halamek
Haknová	Haken
Razzaková	Razzák, Razzakov
Edmondsová	Edmond
Hajíčková	Hajíček
Hakimová	Hakim, Hakím
Raušová	Rauš
Rauterová	Rauter
Rayeová	Ray
Hajsová	Hais
Hajnerová	Hainer
Raunerová	Rainer
Parfenovová	Parfenov
Haindlová	Hainzl
Hajdušková	Hajdušek, Hajdůško
Hajderová	Haider
Efmertová	Emmert
Hainová	Hain
Haiserová	Hais
Parková	Park, Perka
Egerthová	Egert
Parisienová	Parisi
Parobková	Parobek
Parolková	Parolek
Ehrmanová	Ehrmann
Raspová	Raspe
Eichelbergerová	Eichelberger
Eichelmanová	Eichelmann
Hadámková	Hadámek
Hadáčková	Hadáček
Paroulková	Paroulek
Eickhoffová	Eichhoff
Paráčková	Paráček, Parák
Hadincová	Hadinec, Hadinka
Rancová	Ranko, Rank
Randýsková	Randýsek
Randáčková	Randáček
Randleová	Randl
Paserová	Passer
Pascaová	Pascal
Eisertová	Eiser
Hachová	Hacha, Hach, Hácha
Paschkeová	Paschek
Parýzková	Parýzek
Rambousková	Rambousek, Rambous
Habrovcová	Habrovec
Habrová	Habr
Pasiárová	Pasiar
Ekmanová	Ekman
Haberlová	Haberle
Ekštejnová	Ekštein
Pastulová	Pastula
Pastýřiková	Pastýřík
Pastoreková	Pastorek
Pastušková	Pastucha
Habelová	Habala
Rajnošková	Rajnošek, Rajnoch
Rajnincová	Rajninec
Eldebrinková	Eldebrink
Rajzlová	Raizl
Rajčincová	Rajčinec
Haakerová	Haacker
Rajdová	Raida, Raid, Rajdo
Rajfová	Rajm, Raaf
Gřešková	Gřešek, Greško
Güdelová	Gödel
Ragglová	Ra, Rangl
Raimrová	Raim
Eliášková	Eliášek, Elišák
Gébová	Geba, Geb
Gíbalová	Gibal
Paukrtová	Paukert
Raděvová	Radův
Gášková	Gášek
Gášpárová	Gašpár
Gálíčková	Gálíček, Galíček
Gábrišová	Gabriš
Radvancová	Radvanec
Elsnicová	Elsnic, Elznic
Paulíčková	Paulíček
Gáberová	Gaber
Eltomová	Elmo
Gyllenhaallová	Gyllenhaal
Pauová	Pau, Paul
Paučková	Pauček, Pauč
Elčknerová	Elčkner
Radnicová	Radnice
Eminová	Ema
Pavková	Pavko
Pavelcová	Pavelec, Pavelka
Pavljučenkovová	Pavljučenkov
Enceová	Ende, Enke
Pavlincová	Pavlinec
Guseová	Gus
Pavlousková	Pavlousek
Pavlovcová	Pavlovec
Pavlušová	Pavluš, Pavluša, Pavlus
Enderlová	Enderle, Endler, End
Endarová	Ender, End, Ende, Enda, Endo, Endre
Endalová	Endal, Endala
Endoová	Endo, End
Endóová	Endo, End
Endrlová	Endrle, Endl
Radimcová	Radimec, Radim
Pavlosková	Pavlosek
Pavlínová	Pavlín, Pavlína
Radanovová	Radinov, Radenov
Engelbartová	Engelbart
Pavlíňová	Pavlín
Pavlásková	Pavlásek
Gunnová	Gunn
Englišová	Engliš, Englich
Rachůnková	Rachůnek
Pawlitová	Pavlita
Pazirová	Pazik
Entlerová	Endler
Entlová	Endl
Ensslinová	Enslin
Rabštejnková	Rabštejnek, Rabštejn
Paňáková	Panák, Paťák
Pačová	Paka
Paštéková	Pašteka, Paštěka
Guilianová	Guiliani
Pařízková	Pařízek
Erdinová	Erdin
Quellová	Quelle
Erbová	Erbe, Erba, Erbo
Epifanová	Epifanés
Peceková	Peck, Pecker
Eretová	Erot
Pearsonová	Pearson
Pechancová	Pechanec
Pecháčková	Pecháček
Pechoušková	Pechoušek
Pechkeová	Pechke
Pechánková	Pechánek
Půchová	Pácha, Půchov
Půjčílková	Půjčílek
Pechočiáková	Pecha
Pecoldová	Pecold
Grünová	Grün, Grüna
Grúberová	Gruber
Grófová	Grof
Erychlebová	Erychleb
Erošová	Eros
Erlichová	Erlich
Erlová	Erle, Era
Gryczová	Grácz
Grácová	Gráč
Příbková	Příbek
Gruszová	Gruss
Grusmanová	Grusmann
Grygárková	Grygárek
Pejlová	Peale
Přehnalová	Přehnal
Esfandiariová	Esfandiari
Grunfeldová	Grünfeld
Grunová	Grun, Gruna, Grund
Espinová	Espino
Grubbová	Grabb
Essayarová	Essay
Pňáčková	Pňáček
Přecechtílková	Přecechtílek
Pěchoučková	Pěchouček
Pejšková	Pejšek
Pekárková	Pekárek
Pěkníková	Pěkník, Pěník
Pěgřímková	Pěgřímek
Pěluchová	Pělucha
Peleščenková	Peleška
Pöllová	Púll
Pelcmanová	Pelcman
Peldová	Pelda
Pellsová	Pells
Gronová	Grone, Gran
Píšalová	Píšala, Píša, Píš
Píšanová	Píšan, Pišan
Písáčková	Písačka
Píšťková	Píštěk, Píšť
Grmolcová	Grmolec
Písaříková	Pisařík
Peloušková	Peloušek
Pelová	Pell, Pella, Pele
Pérecová	Perec
Pírová	Pírka
Pelíšková	Pelíšek
Pávcová	Pávec
Pášmová	Pášma, Pácha
Pávková	Pávek
Pánková	Pánek, Panek, Panka
Grenvillová	Grenville
Páleníčková	Páleníček
Gregárková	Gregárek
Gregůrková	Gregůrek
Pennyová	Penny
Peníšková	Peníšek, Peniška
Exlová	Ekl
Pepperbergová	Pepperberg
Peregrinová	Peregrin
Grebeníčková	Grebeníček
Ezerová	Eser
Fabiánková	Fabiánek
Puravcová	Puravec
Grancová	Granec
Purkyňová	Purkyně
Purkrábková	Purkrábek
Fagulcová	Fagulec
Pernová	Perná
Punová	Puno
Faiklová	Faitl, Faigl
Perroneová	Perrone, Perron
Perovičová	Perovič
Gradyová	Grady, Gray
Gracová	Graca, Grace
Pukovcová	Pukovec
Fajlová	Fajl
Falcmanová	Falkman
Pulkrábková	Pulkrábek
Gowardová	Godard
Pucová	Puk
Faltejsková	Faltejsek
Faltinová	Faltín
Faltýsková	Faltýsek
Perécová	Perec
Gottová	Gott, Gotti, Gatt, Gatto
Gottsmannová	Gottmann
Fandlová	Fandl, Fantl
Fandáková	Fandák
Puchová	Poch
Fandelová	Fandel
Fanderlíková	Fanderlík
Fanová	Fana, Fan, Fano, Fanta, Fane
Fangová	Fang
Faniniová	Fanin
Psárová	Psáry
Fantusová	Fantys
Fanfulová	Fanfule
Ptáčková	Ptáček
Gosseová	Gossec
Farinaová	Farian
Petirová	Petir
Petersmannová	Petermann
Psohlavcová	Psohlavec
Gorlová	Gole, Görl, Goll
Průšková	Průšek, Průša
Farrowová	Farr
Farrellová	Farrell
Petkovičová	Petkovič
Prágerová	Prager
Farářová	Falář
Prášková	Prášek
Prémová	Prem
Gonová	Gono
Przeczková	Przeczek
Petroušková	Petroušek
Petrofová	Petrof
Petruchová	Petrucha
Petrovcová	Petrovec, Petrovka
Petrovicová	Petrovic, Petrovice
Petrovičová	Petrović, Petrovic
Prucková	Prucek
Pružincová	Pružinec
Petrásková	Petrásek
Petráčková	Petráček
Petruželová	Petružela
Prudková	Prudek
Fedotkinová	Fedotkin
Feherová	Féher
Feikusová	Feik, Feiks
Goldbacherová	Goldbach
Petržílková	Petržílek
Prousková	Prousek
Prskavcová	Prskavec
Provostová	Provost
Proňková	Proněk
Fejlková	Fejlek
Provázková	Provázek
Provazníčková	Provazníček
Provazová	Provaz
Provodová	Provod
Petöová	Peto, Pete
Prosková	Prosek, Pros, Prost
Felingerová	Feininger
Felicienová	Felician
Feminová	Femina
Fencíková	Fenčík
Proroková	Prorok
Prosíková	Prosík, Prosek
Propšová	Propš
Gläsnerová	Glasner
Prokýšková	Prokýšek
Prokůpková	Prokůpek
Ferbrová	Ferber
Pečeňová	Pečeň, Pečeňa
Glöcklová	Glöckl
Glombíková	Glumbík
Glombíčková	Glombíček
Prokopcová	Prokopec
Glossopová	Glossop, Gloss
Ferrelová	Ferrer, Ferrera
Pešicová	Pešice
Pešinová	Pešina
Peťová	Peťa, Péťa
Peťulová	Petula
Festeová	Feste
Pritchardová	Pritchard
Gladišivová	Gladiš
Princeová	Prince, Princ
Fešárková	Fešárek
Fialeková	Fiala, Fialka
Ficková	Ficek, Fic
Gižová	Giga
Prečková	Prček
Girlová	Girl
Fignerová	Finger
Figerová	Fider
Gintherová	Ginter
Fikrlová	Fikrle
Gilová	Gil, Gila, Gilo
Filevová	Fila
Fikáčková	Fikáček
Gilleová	Gille, Gill
Filippovová	Filipov, Filipův
Filipinová	Filipiny
Pidrmanová	Pidrman
Gieszmanová	Gieszmann
Fillmorová	Fillmore
Filimonová	Filemon
Filleryová	Filler
Preiszlerová	Preissler, Prajzler, Prajzner
Filsáková	Filsák
Filipínová	Filipiny, Filipína
Filsaková	Filsak, Filsák
Giecková	Giecek
Pravcová	Pravec
Filíčková	Filík
Filásková	Filásek
Filáčková	Filáček
Fineová	Fine, Fines, Fina, Fin, Finek
Prauzová	Praus
Pierseová	Piers
Piersonová	Piers
Pietruchová	Pietruch
Pietrzyková	Pietrzyk
Pietropaolová	Pietropaolo
Pietrasová	Pietras
Finsterlová	Finsterle
Prasková	Prasek
Prantlová	Prantl, Plant, Partl
Pragrová	Prager
Prajzová	Prajz, Prajza
Pijáčková	Pijáček
Pietraszová	Pietrasz
Pigulová	Pigula, Pikula
Piherová	Pihera
Pikeová	Pike
Pilcherová	Pilcher, Pilch
Prachalová	Prchal
Fislová	Fils, Fišl
Fixová	Fix
Fiňková	Finěk, Finka
Fiurášková	Fiurášek
Fizerová	Fisera
Fišárková	Fišárek
Pošvicová	Pošvice
Pošvářová	Pošvář
Pilnáčková	Pilnáček, Pilňáček
Pilňáčková	Pilňáček, Pilnáček
Pimková	Pimek
Pozníčková	Pozníček
Pilvousková	Pilvousek
Pineauová	Pineau
Pinerová	Pinar
Gerberová	Gerber
Flekalová	Flekal
Flekačová	Flekač
Fleknová	Flekna
Pozdníčková	Pozdníček
Povrová	Povr
Povová	Pova
Považancová	Považanec
Floodová	Flo, Floyd
Fleurysová	Fleury
Poupětová	Poupě
Poulíčková	Poulíček
Potůčková	Potůček
Floryová	Flor
Flousková	Flousek
Postrelová	Postler
Pothová	Pot
Potenteová	Potente
Piperková	Piper, Piperek, Pipek
Pipková	Pipek, Pippa
Foaová	Foe
Posířilová	Posířil
Piroutková	Piroutek
Poseyová	Posey
Poseltová	Poselt
Fogliová	Foglie
Postelová	Postel
Pospíšková	Pospíšek
Foldýnová	Foldyna
Fojtášková	Fojtášek
Fojtíčková	Fojtíček, Fojtík
Posoldová	Posolda
Posová	Posa
Fojtová	Fojta, Fojt, Fojtů, Fajt
Poslová	Posl
Posavádová	Posavád
Gedeónová	Gedeon
Gecková	Gecko
Fondová	Fonda
Foltová	Folta
Portherová	Porter
Piskáčková	Piskáček
Gašpárková	Gašpárek
Gazárková	Gazárek
Porošinová	Porošin
Forejtková	Forejtek
Pitorová	Pitor
Popílková	Popílek
Poprová	Poppr, Poper, Pop
Formánková	Formánek
Formáčková	Formáček
Popková	Popek
Fornůsková	Fornůsek
Pitterová	Pitter, Pittera
Poová	Pova, Poe
Popadincová	Popadinec
Ponteová	Ponte
Forýtková	Forýtek
Fortuneová	Fortune
Fousková	Fousek, Fous
Pitronová	Pitra
Gaurová	Gaura
Pivcová	Pivec
Gaubová	Gaube
Ponceová	Ponce
Foučková	Fouček
Pivarčiová	Pivarči
Pitulová	Pitule
Pivovarová	Pivovar
Pondělíčková	Pondělíček
Poncová	Ponec, Penc
Fraiová	Frais
Pivková	Pivka, Pivko, Pivek
Gatesová	Gates
Frameová	Frame, Fram
Framerová	Frame
Gaspárová	Gaspar
Pišinová	Pisin, Pišinka
Gasnárková	Gasnárek
Francisková	Francisko
Pišniková	Pišinka
Pišťáčková	Pišťáček, Pišťák
Garnczarzová	Garncarz
Placzková	Placzek
Plamínková	Plamínek
Poláčková	Poláček
Fraňková	Franko, Franěk, Franka
Polášková	Polášek
Garbinová	Garmin, Garšin
Freemannová	Freimann
Fredericková	Frederick
Polomisová	Polomis
Freibergaová	Freiberg
Poljaková	Poljakov
Freivaldová	Freiwald
Plaváčková	Plaváček
Plavinová	Plavina
Plavcová	Plavec
Platznerová	Platz
Poliačková	Polička
Frenchová	Frenc
Plašilová	Plašil
Gambová	Gamma, Gampa
Frgálová	Frgal
Galásková	Galásek
Galíčková	Galíček
Friedanová	Fried
Fridová	Frid, Frido, Frida
Polačiková	Poláčik
Plesarová	Plesar
Plekancová	Plekanec
Frimmelová	Frimmel
Poledníčková	Poledníček, Poledník
Pletánková	Pletánek
Plecháčková	Plecháček
Frišmanová	Fišman
Fromková	Fromek
Frolcová	Frolec
Plischková	Plischke
Galandauerová	Galandauer
Pojedincová	Pojedinec
Poiréeová	Poireé
Pohůnková	Pohánka
Froňková	Froněk, Fronk
Plodková	Plodek
Plodrová	Plodr
Gajdůšková	Gajdůšek
Gajdušková	Gajdušek
Fryčková	Fryček, Fryč
Pohorelcová	Pohorelec
Pohunková	Pohunek
Pluháčková	Pluháček
Frýdková	Frýdek, Frýd
Plošková	Plocek
Pludková	Pludek
Podškubková	Podškubek
Podroužková	Podroužek
Fuglíčková	Fuglíček
Fukárková	Fukárek
Fulbová	Fulb, Fulda
Fulnečková	Fulneček
Plíšková	Plíšek
Plášková	Plášek
Gabauerová	Gabauer
Furiková	Furik
Gabaldonová	Gabaldon
Plšková	Plšek
Fürsterová	Füster, Fürst
Furišová	Furiš
Fučková	Fuka, Fuček
Fusarová	Fusa
Fusková	Fusek
Futerová	Futre
Pochylová	Pochylý, Pochylá
Podhorcová	Podhorec
Fuňáková	Fuňák
Fíčková	Fíček
Fáčková	Fáček
Viestová	Viest, Vieste
Vikeová	Vike, Vicek
Lejsková	Lejsek
Vilamová	Vilm
Vilagosová	Világos
Viganová	Vičan
Šuchová	Šuch, Šucha
Chiová	Chi, Chia, Chin
Kicová	Kika
loupežníková	loupežník
Cichoňová	Cichoň
švakrová	švakr
Boczková	Boczek
Bohmová	Bohm, Bohma, Böhm
Borchová	Boch
Eklová	Ekl
Bornemiszaová	Bornemisza
Tiková	Tikovice
Šmaková	Šmak, Šmakov
Baravoková	Baravok
Odrová	Odra, Odry
Juhová	Juha, Juh
Hiová	Hiva
Dobroslávková	Dobroslávek
Černajová	Černaj, Černaja
Srncová	Srnec, Srnka
Otradovicová	Otradovice
Barracloughová	Barraclough
Hrmová	Hrma, Hrmo
Cavaniová	Cavani
Bicková	Bicek
Beručašviliová	Beručašvili
Černoušková	Černoušek
Drncová	Drnec
Eibová	Eiba, Eib
Linsenhoffová	Lins
Bochová	Boch, Boc, Bochov
Ochová	Och, Ochův
Těsnohlídková	Těsnohlídek
Holobrádková	Holobrádek
Bäckmanová	Bäckman, Backman, Böckmann, Bockmann
Koková	Kok, Koko, Koča
Šmátralová	Šmátrala
Shorová	Shore, Shorný
Mrocková	Mock
Černohlávková	Černohlávek
Lvová	Lev
Křivová	Křiva
Breckenridgeová	Breckenridge
Buchová	Bucha, Buch
Blackshawová	Blackshaw
Ehmová	Ehl
vrchňová	vrchný, vrch, vrchně, vrchní
vechtrová	vechtr
pošmistrová	pošmistr
Klapperstorchová	Klapperstorch
Bělohoubková	Bělohoubek
Eisenbergerová	Eisenberg
Ehrenbergrová	Ehrenberger
