léčba	BATCH-2	N	léč b a	
chodba	BATCH-2	N	chod ba	
potřeba	BATCH-2	N	po třeb a	
třeba	BATCH-2	D	třeba	
palba	BATCH-2	N	pal ba	
bomba	BATCH-2	N	bomb a	
nádoba	BATCH-2	N	nádoba	???
doba	BATCH-2	N	dob a	
choroba	BATCH-2	N	chor ob a	
stavba	BATCH-2	N	sta vba	???
služba	BATCH-2	N	služ ba	
olympiáda	BATCH-2	N	olympiáda	
nálada	BATCH-2	N	ná lad a	
rada	BATCH-2	N	rada	
řada	BATCH-2	N	řad a	
záda	BATCH-2	N	zád a	
středa	BATCH-2	N	střed a	
věda	BATCH-2	N	věd a	
rejda	BATCH-2	N	rejd a	
amanda	BATCH-2	N	amanda	
Dynda	BATCH-1		Dynd a
miliarda	BATCH-2	N	miliard a	
drda	BATCH-2	N	drda	
buda	BATCH-2	N	buda	
pravda	BATCH-2	N	prav da	
vražda	BATCH-2	N	vražd a	
hvězda	BATCH-2	N	hvězd a	
jízda	BATCH-2	N	jízd a	
praha	BATCH-2	N	praha	
plocha	BATCH-2	N	ploch a	
kniha	BATCH-2	N	knih a	
Pedicia	BATCH-1		Pedici a
georgia	BATCH-2	N	georgia	
Bania	BATCH-1		Bani a
Swietenia	BATCH-1		Swieteni a
slavia	BATCH-2	N	slavia	
faja	BATCH-2	N	faja	??? slovensky?
rossija	BATCH-2	N	rossija	???
sonja	BATCH-2	N	sonja	
čubka	BATCH-2	N	čub ka	
dojačka	BATCH-1		doj ač k a
zatáčka	BATCH-2	N	za táč ka	
Dyjička	BATCH-1		Dyj ičk a
odmalička	BATCH-2	D	od mal ičk a	
mandlička	BATCH-2	N	mandl ičk a	
Štiavnička	BATCH-1		Štiav n i čk a
šperkovnička	BATCH-1		šperk ovnič k a
cestička	BATCH-2	N	cest ič k a	
lavička	BATCH-2	N	lavič ka	
družička	BATCH-2	N	druž ičk a	
hromádka	BATCH-2	N	hromád ka	
přehlídka	BATCH-2	N	pře hlíd k a	
prohlídka	BATCH-2	N	pro hlíd ka	
zdaleka	BATCH-2	D	z dal ek a	
technika	BATCH-2	N	techn ika	
monika	BATCH-2	N	monika	
afrika	BATCH-2	N	afrika	
matika	BATCH-2	N	matik a	
pneumatika	BATCH-2	N	pneumatik a	
politika	BATCH-2	N	politik a	
germanistika	BATCH-2	N	german ist ik a	
kořalka	BATCH-2	N	kořalka	???
spisovatelka	BATCH-2	N	s pis ovatelka	???
manželka	BATCH-2	N	manžel ka	??? vtipny, presmycka
automobilka	BATCH-2	N	automobil ka	
medulka	BATCH-1		medul k a
půlka	BATCH-2	N	půl k a	
tačanka	BATCH-1		tačank a
Bystričanka	BATCH-1		Bystr ič an k a
dominikánka	BATCH-1		dominik án ka
branka	BATCH-2	N	bran ka	
jízdenka	BATCH-2	N	jízd en ka	
myšlenka	BATCH-2	N	myšl enka	
mapka	BATCH-2	N	map ka	
Župka	BATCH-1		Žup k a
ploténkářka	BATCH-1		plotén k ář k a
sbírka	BATCH-2	N	s bír ka	
šířka	BATCH-2	N	šíř k a	
veleinkvizitorka	BATCH-1		vele inkviz it or k a
audiopáska	BATCH-1		audio pás k a
češka	BATCH-2	N	češka	???
deska	BATCH-2	N	deska	
Krutská	BATCH-1		Krut sk á
hruška	BATCH-2	N	hruška	
Žižlavská	BATCH-1		Žižlav sk á
Moťovská	BATCH-1		Moť ovsk á
Hubatka	BATCH-1		Hub at k a
látka	BATCH-2	N	látka	
památka	BATCH-2	N	památ ka	
matka	BATCH-2	N	matk a	
jitka	BATCH-2	N	jitka	
desítka	BATCH-2	N	desít ka	
jednotka	BATCH-2	N	jednotka	???
smrtka	BATCH-2	N	s mr tka	
částka	BATCH-2	N	část ka	
Šťástka	BATCH-1		Šťást k a
prvoligistka	BATCH-1		prv o lig ist k a
cyklistka	BATCH-1		cykl ist k a
kanoistka	BATCH-1		kano ist k a
špatnůstka	BATCH-1		špatn ůst k a
mouka	BATCH-2	N	mouk a	
ruka	BATCH-2	N	ruk a	
ohlávka	BATCH-2	N	o hláv k a	
nechápavka	BATCH-1		ne cháp a v k a
rychloucpávka	BATCH-1		rychl o u cp á vk a
videonahrávka	BATCH-2	N	video na hrá v ka	
pohovka	BATCH-2	N	po hov ka	
Klenovka	BATCH-1		Klen ov k a
žárovka	BATCH-2	N	žár ov k a	
zubrovka	BATCH-1		zubr ov k a
obrazovka	BATCH-2	N	ob raz ov ka	
položka	BATCH-2	N	po lož ka	
tužka	BATCH-2	N	tuž ka	
šála	BATCH-2	N	šál a	
Korbela	BATCH-1		Korbel a
včela	BATCH-2	N	včel a	
zcela	BATCH-2	D	z cel a	
pupila	BATCH-1		pupil a
ella	BATCH-2	N	ella	
škola	BATCH-2	N	škol a	
kontrola	BATCH-2	N	kontrol a	
perla	BATCH-2	N	perl a	
gaula	BATCH-2	N	gaula	
makromolekula	BATCH-2	N	makro molekula	
trula	BATCH-1		trul a
uršula	BATCH-2	N	uršul a	
Buttula	BATCH-1		Buttul a
reklama	BATCH-2	N	reklam a	
noema	BATCH-1		noem a
téma	BATCH-2	N	téma	
vzpříma	BATCH-2	D	vz přím a	
firma	BATCH-2	N	firm a	
hana	BATCH-2	N	han a	
adriana	BATCH-2	N	adriana	
strana	BATCH-2	N	stran a	
ivana	BATCH-2	N	ivana	
učebna	BATCH-2	N	uč ebn a	
poradna	BATCH-2	N	po rad n a	
scéna	BATCH-2	N	scén a	
proměna	BATCH-2	N	pro měn a	
směna	BATCH-2	N	s měn a	
prodloužená	BATCH-1		pro dlouž en á
žena	BATCH-2	N	žen a	
Cigna	BATCH-1		Cign a
základina	BATCH-1		zá klad in a
edina	BATCH-2	N	edina	
hodina	BATCH-2	N	hodina	
rodina	BATCH-2	N	rod in a	
halina	BATCH-2	N	halina	
ulehlina	BATCH-1		u leh l in a
hlína	BATCH-2	N	hlín a	
rostlina	BATCH-2	N	rost lin a	
omrzlina	BATCH-2	N	o mrz lin a	
opričnina	BATCH-1		opričn in a
kateřina	BATCH-2	N	kateřina	
menšina	BATCH-2	N	menš in a	
gilotina	BATCH-2	N	gilotina	
ruština	BATCH-2	N	ruš tin a	
mýtina	BATCH-2	N	mýt ina	
potravina	BATCH-2	N	po trav ina	
plavkovina	BATCH-1		plav k ovin a
rovina	BATCH-2	N	rovin a	
svítilna	BATCH-2	N	svít iln a	
přípona	BATCH-2	N	pří pon a	
železárna	BATCH-2	N	želez árn a	
mučírna	BATCH-2	N	muč írn a	
koruna	BATCH-2	N	korun a	
zrovna	BATCH-2	D	z rovn a	
střižna	BATCH-2	N	střiž na	
možná	BATCH-2	D	mož ná	
Anthozoa	BATCH-1		Anthozo a
evropa	BATCH-2	N	evrop a	
pára	BATCH-2	N	pár a	
sara	BATCH-2	N	sara	
dcera	BATCH-2	N	dcera	
kariéra	BATCH-2	N	kariéra	
kamera	BATCH-2	N	kamera	
nevěra	BATCH-2	N	ne věr a	
jiskra	BATCH-2	N	jiskr a	
Churriguerra	BATCH-1		Churriguerr a
petra	BATCH-2	N	petra	
zítra	BATCH-2	D	zítra	
Nátjašástra	BATCH-1		Nátjašástr a
sestra	BATCH-2	N	sestr a	
kostra	BATCH-2	N	kost ra	
struktura	BATCH-2	N	struktur a	
trasa	BATCH-2	N	tras a	
kapsa	BATCH-2	N	kaps a	
husa	BATCH-2	N	husa	
Bavsa	BATCH-1		Bavs a
vrata	BATCH-2	N	vrat a	
četa	BATCH-2	N	čet a	
cigareta	BATCH-2	N	cigaret a	
Cucurbita	BATCH-1		Cucurbit a
realita	BATCH-2	N	real ita	
flexibilita	BATCH-2	N	flexibilit a	
jezuita	BATCH-2	N	jezuit a	
univerzita	BATCH-2	N	univerzita	
projekta	BATCH-2	N	projekta	
varianta	BATCH-2	N	varianta	???
jednota	BATCH-2	N	jedn ot a	
hodnota	BATCH-2	N	hod not a	
jistota	BATCH-2	N	jist ota	
prostota	BATCH-2	N	prostota	
puberta	BATCH-2	N	puberta	
cesta	BATCH-2	N	cest a	
turista	BATCH-2	N	turista	
spousta	BATCH-2	N	spoust a	
ústa	BATCH-2	N	úst a	
Madoqua	BATCH-1		Madoqua
zábava	BATCH-2	N	zá bav a	
Lukava	BATCH-1		Luk av a
Bobrava	BATCH-1		Bobrav a
kráva	BATCH-2	N	kráv a	
příprava	BATCH-2	N	pří prav a	
ostrava	BATCH-2	N	ostrav a	
Ryšavá	BATCH-1		Ryš av á
představa	BATCH-2	N	před sta v a	
eva	BATCH-2	N	eva	
sleva	BATCH-2	N	s lev a	
moskva	BATCH-2	N	moskva	
Valbusaová	BATCH-1		Valbusa ov á
kubcová	BATCH-2	N	kubc ov á	
Nosticová	BATCH-1		Nostic ov á
Streisandová	BATCH-1		Streisand ov á
budova	BATCH-2	N	bud ova	
Paigeová	BATCH-1		Paige ov á
Ryschichová	BATCH-1		Ryschich ov á
Samardzichová	BATCH-1		Samardzich ov á
Aldworthová	BATCH-1		Aldworth ov á
Lesňáková	BATCH-1		Les ň ák ov á
Blažeková	BATCH-1		Blaž ek ov á
Ferulíková	BATCH-1		Ferul ík ov á
Hutníková	BATCH-1		Hut ník ov á
Věžníková	BATCH-1		Věž ník ov á
Škorpíková	BATCH-1		Škorp ík ov á
Litvíková	BATCH-1		Litv ík ov á
Durajková	BATCH-1		Durajk ov á
Jampílková	BATCH-1		Jampíl k ov á
Hromková	BATCH-1		Hrom k ov á
Koubínková	BATCH-1		Koub ínk ov á
Dunková	BATCH-1		Dun k ov á
Oriešková	BATCH-1		Orieš k ov á
Zoubelová	BATCH-1		Zoubel ov á
Šteglová	BATCH-1		Štegl ov á
bellová	BATCH-2	N	bellová	
McConnellová	BATCH-1		Mc Connell ov á
Zellová	BATCH-1		Zell ov á
krylová	BATCH-2	N	kryl ov á	
Križmová	BATCH-1		Křižm ov á
obnova	BATCH-2	N	ob nov a	
penová	BATCH-2	N	pen ov á	
supernova	BATCH-2	N	super nova	
znova	BATCH-2	D	znova	
Fišarová	BATCH-1		Fišar ov á
Mühlerová	BATCH-1		Mühler ov á
geislerová	BATCH-2	N	geisler ov á	
Gloserová	BATCH-1		Gloser ov á
Juhasová	BATCH-1		Juhas ov á
Stilesová	BATCH-1		Stiles ov á
Kieransová	BATCH-1		Kierans ov á
Lepšová	BATCH-1		Lepš ov á
Miliusová	BATCH-1		Milius ov á
Tabartová	BATCH-1		Tabart ov á
Goepfertová	BATCH-1		Goepfert ov á
bitva	BATCH-2	N	bi tva	???
vrstva	BATCH-2	N	vrstv a	
Gaza	BATCH-1		Gaz a
tuberkulóza	BATCH-2	N	tuberkulóza	
neuróza	BATCH-2	N	neuróz a	
palyza	BATCH-2	N	palyza	
saab	BATCH-2	N	saab	
--------------------	BATCH-2			
chléb	BATCH-2	N	chléb	
klub	BATCH-2	N	klub	
zub	BATCH-2	N	zub	
pohyb	BATCH-2	N	po hyb	
Zobač	BATCH-1		Zob a č
posluchač	BATCH-2	N	po sluch ač	
Sagnac	BATCH-1		Sagnac
upínač	BATCH-1		u pín a č
hráč	BATCH-2	N	hrá č	
střelec	BATCH-2	N	střel ec	
Cibulec	BATCH-1		Cibul ec
rámec	BATCH-2	N	rám ec	
meč	BATCH-2	N	meč	
šrumec	BATCH-2	N	šrumec	
slepenec	BATCH-2	N	s lep en ec	
zločinec	BATCH-2	N	zlo čin ec	
jedinec	BATCH-2	N	jedin ec	
konec	BATCH-2	N	konec	
jablonec	BATCH-2	N	jablonec	
herec	BATCH-2	N	her ec	
čtverec	BATCH-2	N	čtver ec	
živec	BATCH-2	N	ži vec	???
Sokolovec	BATCH-1		Sokol ov ec
Karachánovec	BATCH-1		Karachán ov ec
mřížovec	BATCH-1		mříž ov ec
švec	BATCH-2	N	š vec	
věc	BATCH-2	N	věc	
Katrič	BATCH-1		Katrič
měsíc	BATCH-2	N	měsíc	
tisíc	BATCH-2	N	tisíc	
Krumholc	BATCH-1		Krumholc
nemoc	BATCH-2	N	ne moc	
proč	BATCH-2	D	proč	
kouč	BATCH-2	N	kouč	
olomouc	BATCH-2	N	olomouc	
pryč	BATCH-2	N	pryč	
cad	BATCH-2	N	cad	???
překlad	BATCH-2	N	pře klad	
například	BATCH-2	D	na pří klad	
příklad	BATCH-2	N	pří klad	
předpoklad	BATCH-2	N	před po klad	
nad	BATCH-2	A	nad	
ipad	BATCH-2	N	ipad	
případ	BATCH-2	N	pří pad	
rád	BATCH-2	D	rád	
pohled	BATCH-2	N	po hled	
hned	BATCH-2	D	hned	
uprostřed	BATCH-2	D	u pro střed	
teď	BATCH-2	D	teď	
odpověď	BATCH-2	N	od po věď	
klid	BATCH-2	N	klid	
android	BATCH-2	N	android	
žid	BATCH-2	N	žid	
Island	BATCH-1		Island
Neuland	BATCH-1		Neuland
fond	BATCH-2	N	fond	
bod	BATCH-2	N	bod	
záchod	BATCH-2	N	zá chod	
schod	BATCH-2	N	s chod	
od	BATCH-2	A	od	???
pod	BATCH-2	A	pod	
porod	BATCH-2	N	po rod	
návod	BATCH-2	N	ná vod	
obvod	BATCH-2	N	ob vod	
důvod	BATCH-2	N	dů vod	
steward	BATCH-2	N	steward	
Eskifjord	BATCH-1		Eskifjord
rekord	BATCH-2	N	rekord	
Slabihoud	BATCH-1		Slabihoud
proud	BATCH-2	N	proud	
osud	BATCH-2	N	o sud	
dlouhodobě	BATCH-2	D	dlouh o dob ě	
třízubě	BATCH-1		tř í zub ě
likvidace	BATCH-2	N	likvid ace	
instalace	BATCH-2	N	in stal ace	
regulace	BATCH-2	N	regul ace	
informace	BATCH-2	N	in form ace	
generace	BATCH-2	N	gener ace	
operace	BATCH-2	N	oper ace	
práce	BATCH-2	N	práce	
reprezentace	BATCH-2	N	re prezent ace	
situace	BATCH-2	N	situace	
inovace	BATCH-2	N	inov ace	
realizace	BATCH-2	N	real izace	???
výrobce	BATCH-2	N	vý rob ce	
srdce	BATCH-2	N	srdc e	
tradice	BATCH-2	N	tradic e	
velice	BATCH-2	D	vel ic e	
ulice	BATCH-2	N	ulic e	
stanice	BATCH-2	N	sta nice	
Hubenice	BATCH-1		Hub en ic e
soukenice	BATCH-1		souk en ic e
stupnice	BATCH-2	N	stup n ice	
vesnice	BATCH-2	N	ves nice	???
setnice	BATCH-1		set ni c e
Patrice	BATCH-1		Patric e
sice	BATCH-2	D	sice	
částice	BATCH-2	N	část ic e	
lavice	BATCH-2	N	lav ic e	
borovice	BATCH-2	N	bor ov ic e	
Černýšovice	BATCH-1		Čern ýš ov ic e
dvojče	BATCH-2	N	dvoj če	
akce	BATCH-2	N	akc e	
projekce	BATCH-2	N	projekce	
sankce	BATCH-2	N	sankce	
funkce	BATCH-2	N	funkc e	
konstrukce	BATCH-2	N	kon struk ce	
zájemce	BATCH-2	N	zá jem ce	
finance	BATCH-2	N	financ e	
licence	BATCH-2	N	licence	
tendence	BATCH-2	N	tendence	
polyvalence	BATCH-1		poly valenc e
kompetence	BATCH-2	N	kompetenc e	
dokonce	BATCH-2	D	do konc e	
zástupce	BATCH-2	N	zá stup ce	
děvče	BATCH-2	N	děv če	
Chlívce	BATCH-1		Chlív c e
pohromadě	BATCH-2	D	po hromad ě	
garde	BATCH-2	N	garde	
všude	BATCH-2	D	všude	
pozdě	BATCH-2	D	pozd ě	
Krohe	BATCH-1		Krohe
propodruhé	BATCH-1		pro po druh é
policie	BATCH-2	N	policie	
akcie	BATCH-2	N	akcie	
elektroencefalografie	BATCH-1		elektr o encefal o graf i e
kinematografie	BATCH-2	N	kinemat o graf ie	
legie	BATCH-2	N	legie	
strategie	BATCH-2	N	strategie	
metodologie	BATCH-2	N	metod o log ie	
adenotomie	BATCH-2	N	adenotomie	???
británie	BATCH-2	N	británie	
annie	BATCH-2	N	annie	
olympie	BATCH-2	N	olympie	
galerie	BATCH-2	N	galer ie	
také	BATCH-2	D	také	
dále	BATCH-2	D	dále	
dokonale	BATCH-2	D	do kon al e	
stále	BATCH-2	D	stá l e	
bible	BATCH-2	N	bibl e	
podle	BATCH-2	D	po dle	
náhle	BATCH-2	D	náhl e	
tamhle	BATCH-2	D	tam hle	
přituhle	BATCH-1		při tuh l e
chvíle	BATCH-2	N	chvíl e	
vztekle	BATCH-2	D	vz tek l e	
obvykle	BATCH-1		ob vyk l e
zadřímle	BATCH-1		za dřím l e
dole	BATCH-2	D	dol e	
role	BATCH-2	N	role	
cibule	BATCH-2	N	cibul e	
vůle	BATCH-2	N	vůl e	
vyžle	BATCH-2	N	vyžle	
země	BATCH-2	N	zem ě	
zřejmě	BATCH-2	D	zř ejm ě	
zvadaně	BATCH-1		z vad a n ě
zešlehaně	BATCH-1		ze šleh a n ě
stejkaně	BATCH-1		s tejk a n ě
zachrápaně	BATCH-1		za chráp a n ě
vechvátaně	BATCH-1		ve chvát a n ě
zmetaně	BATCH-1		z met a n ě
deptaně	BATCH-1		dept a n ě
odškrabávaně	BATCH-1		od škrab á v a n ě
rozpodávaně	BATCH-1		roz po d á v a n ě
zaslýchávaně	BATCH-1		za slých á v a n ě
vykulhávaně	BATCH-1		vy kulh á v a n ě
odstříkávaně	BATCH-1		od střík á v a n ě
nažbleptávaně	BATCH-1		na žblept á v a n ě
zavlačovávaně	BATCH-1		za vlač ová v a n ě
zkrvácovávaně	BATCH-1		z krv ác ová v a n ě
posvěcovávaně	BATCH-1		po svěc ová v a n ě
přerazítkovávaně	BATCH-1		pře raz í tk ová v a n ě
znovunastolovávaně	BATCH-1		znovu na stol ová v a n ě
zgalvanovávaně	BATCH-1		z galvan ová v a n ě
předeklarovávaně	BATCH-1		pře de klar ová v a n ě
zahmuřovávaně	BATCH-1		za hmuř ová v a n ě
zbarvovávaně	BATCH-1		z barv ová v a n ě
aprovizovávaně	BATCH-1		a pro viz ová v a n ě
vkluzovávaně	BATCH-1		v kluz ová v a n ě
obrábívaně	BATCH-1		ob ráb í v a n ě
zasklívaně	BATCH-1		za skl í v a n ě
uválcovaně	BATCH-1		u vál c ova n ě
strachovaně	BATCH-1		strach ova n ě
prostohovaně	BATCH-1		pro stoh ova n ě
kadmiovaně	BATCH-1		kadmi ova n ě
rámečkovaně	BATCH-1		rám eč k ova n ě
zhubičkovaně	BATCH-1		z hub ičk ova n ě
odsvazkovaně	BATCH-1		od s vaz k ova n ě
přimalovaně	BATCH-1		při mal ova n ě
šmoulovaně	BATCH-1		šmoul ova n ě
domapovaně	BATCH-1		do map ova n ě
vměšovaně	BATCH-1		v měš ova n ě
zbarokisovaně	BATCH-1		z barok isova n ě
zadrátovaně	BATCH-1		za drát ova n ě
obletovaně	BATCH-1		ob let ova n ě
odřazovaně	BATCH-1		od řaz ova n ě
ohražovaně	BATCH-1		o hraž ova n ě
kvantizovaně	BATCH-1		kvant izova n ě
zutrakvizovaně	BATCH-1		z utrakv izova n ě
pravděpodobně	BATCH-2	D	pravd ě podob n ě	
částečně	BATCH-2	D	část eč n ě	
skutečně	BATCH-2	D	skuteč n ě	
lokučně	BATCH-1		lokuč n ě
odpoledne	BATCH-2	N	od pole dne	
přechodně	BATCH-2	D	pře chod n ě	
hodně	BATCH-2	D	hod n ě	
přírodně	BATCH-2	D	pří rod n ě	
parasoudně	BATCH-1		para soud n ě
osudně	BATCH-2	D	osud n ě	
přeúhořeně	BATCH-1		pře úhoř e n ě
bratřeně	BATCH-1		bratř en ě
otevřeně	BATCH-2	D	ote vř en ě	
zrohovatěně	BATCH-1		z roh ovat ě n ě
dodiveně	BATCH-1		do div en ě
povoženě	BATCH-1		po vož en ě
stejně	BATCH-2	D	stejn ě	
kokálně	BATCH-1		kok ál n ě
šmrdlatelně	BATCH-1		šmrdl a teln ě
zoufávatelně	BATCH-1		zouf á v a teln ě
rozposlouchávatelně	BATCH-1		roz po slouch á v a teln ě
uzdvihávatelně	BATCH-1		u zdvih á v a teln ě
zatoulávatelně	BATCH-1		za toul á v a teln ě
okousávatelně	BATCH-1		o kous á v a teln ě
zakolotávatelně	BATCH-1		za kol ot á v a teln ě
přesévávatelně	BATCH-1		pře s é v á v a teln ě
zarajcovávatelně	BATCH-1		za rajc ová v a teln ě
zledovávatelně	BATCH-1		z led ová v a teln ě
centrifugovávatelně	BATCH-1		centr i fug ová v a teln ě
vtipkovávatelně	BATCH-1		vtip k ová v a teln ě
posilovávatelně	BATCH-1		po sil ová v a teln ě
šumovávatelně	BATCH-1		šum ová v a teln ě
galvanovávatelně	BATCH-1		galvan ová v a teln ě
doproviňovávatelně	BATCH-1		do pro viň ová v a teln ě
zacupovávatelně	BATCH-1		za cup ová v a teln ě
zašpárovávatelně	BATCH-1		za špár ová v a teln ě
zakademičťovávatelně	BATCH-1		z akadem ič ť ová v a teln ě
přeminiaturizovávatelně	BATCH-1		pře miniatur izová v a teln ě
trvávatelně	BATCH-1		trv á v a teln ě
tábořívatelně	BATCH-1		táboř í v a teln ě
zasvěcovatelně	BATCH-1		za svěc ova teln ě
zbrakovatelně	BATCH-1		z brak ova teln ě
zaočkovatelně	BATCH-1		za oč k ova teln ě
zaprognostikovatelně	BATCH-1		za pro gno st ik ova teln ě
vyhandrkovatelně	BATCH-1		vy handrk ova teln ě
zakřížkovatelně	BATCH-1		za kříž k ova teln ě
oflitrovatelně	BATCH-1		o flitr ova teln ě
odkmotrovatelně	BATCH-1		od kmotr ova teln ě
navypravovatelně	BATCH-1		na vy prav ova teln ě
přelézatelně	BATCH-1		pře léz a teln ě
přebásnitelně	BATCH-1		pře básn i teln ě
umařitelně	BATCH-1		u mař i teln ě
zvalašitelně	BATCH-1		z valaš i teln ě
mísitelně	BATCH-1		mís i teln ě
lopotitelně	BATCH-1		lopot i teln ě
křápnutelně	BATCH-1		křáp nu teln ě
volně	BATCH-2	D	vol n ě	
významně	BATCH-2	D	vý znam n ě	
dvojdenně	BATCH-1		dv oj den n ě
uštipně	BATCH-1		u štip n ě
postupně	BATCH-2	D	po stup n ě	
superúsporně	BATCH-1		super ú spor n ě
turné	BATCH-2	N	turné	
strašně	BATCH-2	D	straš n ě	
přesně	BATCH-2	D	přesn ě	
malátně	BATCH-1		malát n ě
špatně	BATCH-2	D	špatn ě	
málopočetně	BATCH-1		mál o po čet n ě
včetně	BATCH-2	D	v čet n ě	
arogantně	BATCH-2	D	arogantn ě	
jednotně	BATCH-2	D	jedn ot n ě	
vlastně	BATCH-2	D	vlast n ě	
šestnáctimístně	BATCH-1		šest náct i míst n ě
průmyslověprávně	BATCH-1		prů mysl ov ě práv n ě
chladnokrevně	BATCH-2	D	chladn o krev n ě	
vlivně	BATCH-1		v liv n ě
relativně	BATCH-2	D	relat ivn ě	
kurzovně	BATCH-1		kurz ovn ě
kuchyně	BATCH-2	N	kuchyn ě	
bohyně	BATCH-2	N	boh yně	
smíchotvorkyně	BATCH-1		smích o tvor kyn ě
převážně	BATCH-2	D	pře váž n ě	
běžně	BATCH-2	D	běž ně	
obtížně	BATCH-2	D	ob tíž n ě	
SkyEurope	BATCH-1		Sky Europe
dobře	BATCH-2	D	dobř e	
zvíře	BATCH-2	N	zvíř e	
Aurore	BATCH-1		Aurore
dvojhlase	BATCH-1		dv oj hlas e
třicetiosmiletě	BATCH-1		tř i cet i osm i let ě
dvěstěpadesátiletě	BATCH-1		dv ě st ě pa desát i let ě
určitě	BATCH-2	D	urč it ě	
dítě	BATCH-2	N	dít ě	
cívkovitě	BATCH-1		cív kovitě
náležitě	BATCH-1		ná lež it ě
ještě	BATCH-2	D	ještě	
útočiště	BATCH-2	N	ú toč išt ě	
rašeliniště	BATCH-1		rašelin išt ě
letiště	BATCH-2	N	let išt ě	
parkoviště	BATCH-2	N	park ov iště	
vřesoviště	BATCH-1		vřes ov išt ě
prostě	BATCH-2	D	prost ě	
zabuchnutě	BATCH-1		za buch nu t ě
dopnutě	BATCH-1		do p nu t ě
zdravě	BATCH-1		zdrav ě
právě	BATCH-2	D	práv ě	
vypočítavě	BATCH-1		vy po čít av ě
hnědozrzavě	BATCH-1		hněd o zrz av ě
lehkovznětlivě	BATCH-1		lehk o vz nět liv ě
záznamuchtivě	BATCH-1		zá znam u cht iv ě
koncově	BATCH-1		konc ov ě
petrolejově	BATCH-1		petrolej ov ě
vysílačkově	BATCH-1		vy síl ač k ov ě
jesličkově	BATCH-1		jesl ičk ov ě
vyjížďkově	BATCH-1		vy jížď k ov ě
žebérkově	BATCH-1		žebér k ov ě
kapavkově	BATCH-1		kap av k ov ě
dvojplánově	BATCH-1		dv oj plán ov ě
marihuanově	BATCH-1		marihuan ov ě
pilinově	BATCH-1		pil in ov ě
nově	BATCH-2	D	nov ě	
clonově	BATCH-1		clon ov ě
zvonově	BATCH-1		zvon ov ě
svítiplynově	BATCH-1		svít i plyn ov ě
stratosférově	BATCH-1		strat o sfér ov ě
fluorově	BATCH-1		fluor ov ě
pětadvaceticentimetrově	BATCH-1		pět a dva cet i centi metr ov ě
dvouapůlmetrově	BATCH-1		dv ou a půl metr ov ě
sametově	BATCH-1		samet ov ě
brízově	BATCH-1		bríz ov ě
vé	BATCH-2	N	vé	???
lowe	BATCH-2	N	lowe	
praxe	BATCH-2	N	praxe	
fototaxe	BATCH-1		fot o tax e
televize	BATCH-2	N	televize	
lze	BATCH-2	V	lze	
rekonverze	BATCH-1		re kon verz e
pouze	BATCH-2	D	pouz e	
Bransouze	BATCH-1		Bransouz e
Budiáf	BATCH-1		Budiáf
paragraf	BATCH-2	N	paragraf	
kontrareliéf	BATCH-1		kontra reliéf
josef	BATCH-2	N	josef	
Berhof	BATCH-1		Berhof
Brownrigg	BATCH-1		Brown rigg
Anlongveng	BATCH-1		Anlongveng
blog	BATCH-2	N	blog	
Nyberg	BATCH-1		Nyberg
vztah	BATCH-2	N	vz tah	
prach	BATCH-2	N	prach	
úspěch	BATCH-2	N	ú spě ch	
Bartoch	BATCH-1		Bartoch
povrch	BATCH-2	N	po vrch	
duch	BATCH-2	N	duch	
příběh	BATCH-2	N	pří běh	
sníh	BATCH-2	N	sníh	
trh	BATCH-2	N	trh	
parth	BATCH-2	N	parth	
neznabůh	BATCH-2	N	nezna bůh	
markrabí	BATCH-1		markrab í
přihlédací	BATCH-1		při hléd a c í
přiklekací	BATCH-1		při klek a c í
tiskací	BATCH-1		tisk a c í
přilínací	BATCH-1		při lín a c í
onačí	BATCH-1		onač í
nakapací	BATCH-1		na kap a c í
šplechtací	BATCH-1		šplecht a c í
zůstávací	BATCH-1		zůst áv a c í
vklopýtávací	BATCH-1		v klopýt á v a c í
zaněcovávací	BATCH-1		za něc ová v a c í
zeškareďovávací	BATCH-1		ze škareď ová v a c í
plechovávací	BATCH-1		plech ová v a c í
ocejchovávací	BATCH-1		o cejch ová v a c í
zahajduchovávací	BATCH-1		za hajduch ová v a c í
vychovávací	BATCH-1		vy chov á v a c í
ukojovávací	BATCH-1		u koj ová v a c í
přetitulkovávací	BATCH-1		pře titul k ová v a c í
sáňkovávací	BATCH-1		sáň k ová v a c í
zařemeslovávací	BATCH-1		za řemes l ová v a c í
zatravňovávací	BATCH-1		za trav ň ová v a c í
ignorovávací	BATCH-1		ignor ová v a c í
germanisovávací	BATCH-1		german isová v a c í
diskreditovávací	BATCH-1		dis kredit ová v a c í
sesazovávací	BATCH-1		se saz ová v a c í
senzitizovávací	BATCH-1		senz it izová v a c í
dooplozovávací	BATCH-1		do o ploz ová v a c í
doplácívací	BATCH-1		do plác í v a c í
třeštívací	BATCH-1		třešt í v a c í
skladovací	BATCH-2	A	s klad ovací	???
odháčkovací	BATCH-1		od háč k ova c í
stromečkovací	BATCH-1		strom eč k ova c í
hubičkovací	BATCH-1		hub ičk ova c í
vmilovací	BATCH-1		v mil ova c í
vyplemeňovací	BATCH-1		vy plemeň ova c í
dosamodefinovací	BATCH-1		do sam o de fin ova c í
vypárovací	BATCH-1		vy pár ova c í
besemerovací	BATCH-1		besemer ova c í
prokšeftovací	BATCH-1		pro kšeft ova c í
experimentovací	BATCH-1		experiment ova c í
zjalovovací	BATCH-1		z jalov ova c í
přisněžovací	BATCH-1		při sněž ova c í
odsouvací	BATCH-1		od souv a c í
nebezpečí	BATCH-2	N	ne bezp eč í	
řadicí	BATCH-2	A	řad ic í	
medici	BATCH-2	N	medici	???
plácající	BATCH-1		plác aj íc í
zdající	BATCH-1		zd aj íc í
hafající	BATCH-1		haf aj íc í
obsílající	BATCH-1		ob síl aj íc í
připomínající	BATCH-2	A	při po mín aj íc í	
vepřádávající	BATCH-1		ve přád á v aj íc í
říhávající	BATCH-1		říh á v aj íc í
překlopýtávající	BATCH-1		pře klopýt á v aj íc í
žlábkovávající	BATCH-1		žláb k ová v aj íc í
štrajkovávající	BATCH-1		štrajk ová v aj íc í
párkovávající	BATCH-1		pár k ová v aj íc í
usmykovávající	BATCH-1		u smyk ová v aj íc í
zatrénovávající	BATCH-1		za trén ová v aj íc í
uvězňovávající	BATCH-1		u věz ň ová v aj íc í
vytopovávající	BATCH-1		vy top ová v aj íc í
přikupovávající	BATCH-1		při kup ová v aj íc í
vymezerovávající	BATCH-1		vy mezer ová v aj íc í
dekretovávající	BATCH-1		dekret ová v aj íc í
komentovávající	BATCH-1		koment ová v aj íc í
troštovávající	BATCH-1		trošt ová v a j íc í
zřizovávající	BATCH-1		z řiz ová v aj íc í
přinožovávající	BATCH-1		při nož ová v aj íc í
dospívající	BATCH-2	A	do spí vaj íc í	
zavázívající	BATCH-1		za váz í v aj íc í
vězívající	BATCH-1		věz í v aj íc í
obmýšlející	BATCH-1		ob mýšl ej íc í
následující	BATCH-2	A	ná sled uj íc í	
explodující	BATCH-2	A	explod uj íc í	
natahující	BATCH-2	A	na tah uj íc í	
ucrkující	BATCH-1		u crk uj íc í
flámující	BATCH-2	A	flám uj íc í	
flastrující	BATCH-1		flastr uj íc í
demonstrující	BATCH-2	A	demonstr ujíc í	???
zchmuřující	BATCH-1		z chmuř uj íc í
ohlušující	BATCH-2	A	o hluš uj íc í	
znečišťující	BATCH-2	A	zne čišť uj íc í	
hybridizující	BATCH-1		hybrid iz uj íc í
sympatizující	BATCH-2	A	sympat iz uj íc í	
soutěžící	BATCH-2	A	sou těž íc í	???
toužící	BATCH-2	A	touž ící	???
vedoucí	BATCH-2	N	ved oucí	
mluvčí	BATCH-2	N	mluv čí	???
prostředí	BATCH-2	N	pro střed í	
Yehudi	BATCH-1		Yehudi
souhvězdí	BATCH-2	N	sou hvězd í	
Hidvegi	BATCH-1		Hidvegi
údolí	BATCH-2	N	ú dol í	
okolí	BATCH-2	N	o kol í	
cherimoli	BATCH-1		cherimoli
nakládání	BATCH-2	N	na klád ání	
obléhání	BATCH-2	N	ob léh án í	
nanaříkání	BATCH-1		na na řík á n í
vypejkání	BATCH-1		vy pejk á n í
zamrňoukání	BATCH-1		za mrňouk á n í
zadudlání	BATCH-1		za dudl á n í
vzdělání	BATCH-2	N	vz děl án í	
vysílání	BATCH-2	N	vy síl án í	
přepínání	BATCH-2	N	pře pín ání	
porovnání	BATCH-2	N	po rovn ání	
paní	BATCH-2	N	pan í	
obmetání	BATCH-1		ob met á n í
vmítání	BATCH-1		v mít á n í
zacupotání	BATCH-1		za cup ot á n í
vhoukávání	BATCH-1		v houk á v á n í
zatykávání	BATCH-1		za tyk á v á n í
vzdělávání	BATCH-2	N	vz děl áv án í	
svolávání	BATCH-1		s vol á v á n í
proklímávání	BATCH-1		pro klím á v á n í
vykonávání	BATCH-2	N	vy kon áv án í	
zachropotávání	BATCH-1		za chrop ot á v á n í
slejvávání	BATCH-1		s lej vá v á n í
napajcovávání	BATCH-1		na pajc ová v á n í
souřaďovávání	BATCH-1		sou řaď ová v á n í
reemigrovávání	BATCH-1		re e migr ová v á n í
nasekýrovávání	BATCH-1		na sekýr ová v á n í
přeputovávání	BATCH-1		pře put ová v á n í
zjalovovávání	BATCH-1		z jalov ová v á n í
komunizovávání	BATCH-1		komun izová v á n í
vyluzovávání	BATCH-1		vy luz ová v á n í
používání	BATCH-2	N	pou ží vání	
využívání	BATCH-2	N	vyu ží v án í	
zpracování	BATCH-2	N	z prac ová n í	
financování	BATCH-2	N	financ ová n í	
přikrčování	BATCH-1		při krč ová n í
zagajdování	BATCH-1		za gajd ová n í
chování	BATCH-2	N	chov án í	
opakování	BATCH-2	N	opakování	
doštrikování	BATCH-1		do štrik ová n í
fáborkování	BATCH-1		fábor k ová n í
pískování	BATCH-1		písk ová n í
kralování	BATCH-2	N	kral ování	
nakladatelování	BATCH-1		na klad a tel ová n í
zprůchodňování	BATCH-1		z prů chod ň ová n í
oslňování	BATCH-2	N	o slň ová n í	
dotěsňování	BATCH-1		do těsň ová n í
zmonolitňování	BATCH-1		z mono lit ň ová n í
doštupování	BATCH-1		do štup ová n í
vyšetřování	BATCH-2	N	vy šetř ov án í	
zlicitování	BATCH-1		z licit ová n í
dosalutování	BATCH-1		do salut ová n í
poskytování	BATCH-2	N	po skyt ová n í	
vyplavování	BATCH-2	N	vy plav ov án í	
zakonzervování	BATCH-1		za konzerv ová n í
zvalorizování	BATCH-1		z valor izová n í
relativizování	BATCH-1		relat iv izová n í
svatební	BATCH-2	A	svateb n í	
stavební	BATCH-2	A	sta veb n í	
nadační	BATCH-2	A	nadač n í	
dedikační	BATCH-1		dedik ač n í
regulační	BATCH-2	A	regul ační	???
formační	BATCH-1		form ač n í
informační	BATCH-2	A	in form ač n í	
sváteční	BATCH-2	A	svát eč n í	
pouliční	BATCH-2	A	po ulič ní	
zahraniční	BATCH-2	A	za hran ič n í	
zásadní	BATCH-2	A	zá sad ní	
odpolední	BATCH-2	A	od pol e dn í	
poslední	BATCH-2	A	po sled n í	
ústřední	BATCH-2	A	ú střed ní	
spodní	BATCH-2	A	spod n í	
podvodní	BATCH-2	A	pod vod n í	
plynovodní	BATCH-1		plyn o vod n í
původní	BATCH-2	A	pů vod ní	
vodní	BATCH-2	A	vod ní	
znovupohřbení	BATCH-1		z nov u po hřb en í
splácení	BATCH-2	N	s plác ení	
naobtáčení	BATCH-1		na ob táč e n í
přesvědčení	BATCH-2	N	pře svěd čen í	
nasvícení	BATCH-2	N	na svíc en í	
naproudění	BATCH-1		na proud ě n í
připojení	BATCH-2	N	při poj en í	
vysvětlení	BATCH-2	N	vy svět lení	???
kamení	BATCH-2	N	kamen í	
zranění	BATCH-2	N	z ran ění	
doplnění	BATCH-2	N	do pln ěn í	
zastoupení	BATCH-2	N	za stoup en í	
páření	BATCH-2	N	pář en í	
záření	BATCH-2	N	zář en í	
vyjádření	BATCH-2	N	vy jádř en í	
rozšíření	BATCH-2	N	roz šíř en í	
zahašení	BATCH-1		za haš en í
vynášení	BATCH-2	N	vy náš en í	
nadšení	BATCH-2	N	na dš en í	
tušení	BATCH-2	N	tuš en í	
zvýšení	BATCH-2	N	z výš ení	???
rezavění	BATCH-1		rez av ě n í
stanovení	BATCH-2	N	stanovení	???
ochlazení	BATCH-2	N	o chlaz ení	
sezení	BATCH-2	N	sez ení	
vězení	BATCH-2	N	věz en í	
zatížení	BATCH-2	N	za tíž ení	???
nahození	BATCH-2	N	na hoz en í	
akvarijní	BATCH-2	A	akvarij n í	
legální	BATCH-2	A	legál ní	
sociální	BATCH-2	A	soc iální	???
parciální	BATCH-2	A	parciál ní	
lokální	BATCH-2	A	lok ální	
emocionální	BATCH-2	A	emoc ionáln í	???
personální	BATCH-2	A	person ál n í	
centrální	BATCH-2	A	centr ální	
centrolecitální	BATCH-1		centr o lecit ál n í
kapitální	BATCH-1		kapitál n í
intelektuální	BATCH-2	A	intelekt uál n í	
extrémní	BATCH-2	A	extrémní	
dvoutýdenní	BATCH-2	A	dvou týden n í	
moderní	BATCH-2	A	mod ern í	
herní	BATCH-2	A	her n í	
severní	BATCH-2	A	sever n í	
jezerní	BATCH-2	A	jezer n í	
horní	BATCH-2	A	hor n í	
lesní	BATCH-2	A	les ní	
delikátní	BATCH-2	A	delikátní	
ostatní	BATCH-2	A	ostatn í	
státní	BATCH-2	A	stát n í	
výpočetní	BATCH-2	A	vý po čet n í	
letní	BATCH-2	A	let ní	
inkontinentní	BATCH-2	A	in kontinent n í	
koncertní	BATCH-2	A	koncert n í	
vlastní	BATCH-2	A	vlast n í	
zvláštní	BATCH-2	A	zvláštní	
dopravní	BATCH-2	A	do prav ní	
správní	BATCH-2	A	správ ní	
církevní	BATCH-2	A	církev ní	
předarchivní	BATCH-1		před arch iv n í
ostentativní	BATCH-2	A	ostentativní	???
aktivní	BATCH-2	A	akt iv n í	
sportovní	BATCH-2	A	sport ovn í	
cestovní	BATCH-2	A	cest ov n í	
první	BATCH-2	A	prv n í	
nyní	BATCH-2	D	nyní	
ložní	BATCH-1		lož n í
konfúzní	BATCH-1		kon fúz n í
při	BATCH-2	A	při	
porúří	BATCH-2	N	po rúř í	
tehdejší	BATCH-2	A	tehd ejší	
sebeučenější	BATCH-1		seb e uč en ějš í
další	BATCH-2	A	další	
Faluši	BATCH-1		Faluši
zaštiřikavší	BATCH-1		za štiřik a vš í
zrevokovavší	BATCH-1		z re vok ova vš í
prokormidlovavší	BATCH-1		pro kormidl ova vš í
donastřelovavší	BATCH-1		do na střel ova vš í
uštelovavší	BATCH-1		u štel ova vš í
dooslňovavší	BATCH-1		do o slň ova vš í
zaštupovavší	BATCH-1		za štup ova vš í
zalažírovavší	BATCH-1		za lažír ova vš í
zakantorovavší	BATCH-1		za kant or ova vš í
zmineralisovavší	BATCH-1		z mineral isova vš í
zheroizovavší	BATCH-1		z hero izova vš í
odsystematizovavší	BATCH-1		od systém at izova vš í
vytermovázavší	BATCH-1		vy term o váz a vš í
zrakouštěvší	BATCH-1		z rakouš t ě vš í
odvlnivší	BATCH-1		od vln i vš í
ohodnotivší	BATCH-1		o hodn ot i vš í
vevléknuvší	BATCH-1		ve vlék nu vš í
obemknuvší	BATCH-1		obe mk nu vš í
zabrnknuvší	BATCH-1		za brnk nu vš í
pojetí	BATCH-2	N	po j et í	???
století	BATCH-2	N	sto let í	
setí	BATCH-2	N	se tí	
použití	BATCH-2	N	po u ži tí	
naštěstí	BATCH-2	D	na štěst í	
štěstí	BATCH-2	N	štěst í	
příští	BATCH-2	A	příští	
ústí	BATCH-2	N	úst í	
rozhodnutí	BATCH-2	N	roz hodn ut í	???
leknutí	BATCH-2	N	lek nutí	
ztrpknutí	BATCH-1		z trpk nu t í
ukousnutí	BATCH-1		u kous nu t í
dobytí	BATCH-2	N	do by tí	
pohlaví	BATCH-2	N	po hlav í	
skálolezectví	BATCH-1		skál o lez ec tv í
tkalcovnictví	BATCH-1		tka lc ovnic tv í
odvětví	BATCH-2	N	od větv í	
těhotenství	BATCH-2	N	těhoten ství	
hospodářství	BATCH-2	N	hospod ář ství	
vítězství	BATCH-2	N	vítěz ství	
množství	BATCH-2	N	množství	
čaroděj	BATCH-2	N	čar o děj	
náboj	BATCH-2	N	ná boj	
boj	BATCH-2	N	boj	
pokoj	BATCH-2	N	pokoj	
nápoj	BATCH-2	N	ná poj	
zdroj	BATCH-2	N	zdroj	
přístroj	BATCH-2	N	pří stroj	
vývoj	BATCH-2	N	vý voj	
svůj	BATCH-2	A	svůj	
Januszcak	BATCH-1		Januszc ak
náklaďák	BATCH-2	N	ná klaď ák	
rodák	BATCH-2	N	rod ák	
jak	BATCH-2	N	jak	
voják	BATCH-2	N	voj ák	
tlak	BATCH-2	N	tlak	
útlak	BATCH-2	N	ú tlak	
vědmák	BATCH-1		věd m ák
bošňák	BATCH-2	N	bošň ák	
pak	BATCH-2	D	pak	
hořák	BATCH-2	N	hoř ák	
tak	BATCH-2	D	tak	
Křivák	BATCH-1		Křiv ák
žák	BATCH-2	N	žák	
polibek	BATCH-2	N	po lib ek	
šesteráček	BATCH-1		šest er áč ek
němeček	BATCH-2	N	němeč ek	
pláneček	BATCH-1		plán eč ek
koneček	BATCH-2	N	koneč ek	
balíček	BATCH-2	N	bal íček	
pavlíček	BATCH-2	N	pavl íč ek	???
svědek	BATCH-2	N	svěd ek	
strojek	BATCH-2	N	stroj ek	
nedopalek	BATCH-2	N	ne do pal ek	
spolek	BATCH-2	N	spol ek	
zdeněk	BATCH-2	N	zdeněk	
navenek	BATCH-2	D	na ven ek	
pavilónek	BATCH-1		pavilón ek
ústupek	BATCH-2	N	ú stup ek	
oříšek	BATCH-2	N	oříš ek	
jarůšek	BATCH-2	N	jarůšek	
počátek	BATCH-2	N	po čát ek	
užitek	BATCH-2	N	u ži tek	
vztek	BATCH-2	N	vz tek	
člověk	BATCH-2	N	člověk	???
obrázek	BATCH-2	N	ob ráz ek	
kroužek	BATCH-2	N	krouž ek	
mladík	BATCH-2	N	mlad ík	
Vráblík	BATCH-1		Vrábl ík
vandlík	BATCH-1		vandl ík
konečník	BATCH-2	N	koneč n ík	
konvenčník	BATCH-1		kon venč ník
zpovědník	BATCH-2	N	zpo věd ník	???
Mehelník	BATCH-1		Mehelník
věrolomník	BATCH-2	N	věr o lomn ík	
dymník	BATCH-1		dym ník
zákoník	BATCH-2	N	zá kon ík	
Vetešník	BATCH-1		Veteš ník
sanktusník	BATCH-1		sanktus ník
kotník	BATCH-2	N	kotník	
věstník	BATCH-2	N	věstn ík	
poutník	BATCH-1		pout ník
protivník	BATCH-2	N	protiv n ík	
následovník	BATCH-2	N	ná sled ov ník	
hektometrovník	BATCH-1		hekto metr ov ník
Lasík	BATCH-1		Las ík
vašík	BATCH-2	N	vašík	
okamžik	BATCH-2	N	okamžik	
Klenk	BATCH-1		Klenk
trénink	BATCH-2	N	trén ink	
trunk	BATCH-1		trunk
nárok	BATCH-2	N	ná rok	
rok	BATCH-2	N	rok	
park	BATCH-2	N	park	
přefuk	BATCH-1		pře fuk
kluk	BATCH-2	N	kluk	
zvuk	BATCH-2	N	zvuk	
Repeal	BATCH-1		Repeal
real	BATCH-2	N	real	
potenciál	BATCH-2	N	potenc iál	
šakal	BATCH-2	N	šakal	
kanál	BATCH-2	N	kanál	
personál	BATCH-2	N	person ál	
podkrál	BATCH-1		pod král
decibel	BATCH-2	N	deci bel	
ocel	BATCH-2	N	ocel	
model	BATCH-2	N	model	
Jokel	BATCH-1		Jokel
obratel	BATCH-2	N	ob rat el	
uživatel	BATCH-2	N	u ži vatel	
stěžovatel	BATCH-2	N	stěž ova tel	
obyvatel	BATCH-2	N	o by vatel	???
učitel	BATCH-2	N	uč itel	???
velitel	BATCH-2	N	vel itel	
přítel	BATCH-2	N	přítel	
pavel	BATCH-2	N	pavel	
detail	BATCH-2	N	detail	
díl	BATCH-2	N	díl	
pospíšil	BATCH-2	N	po spíš il	
Vymlátil	BATCH-1		Vy mlát i l
Bordwell	BATCH-1		Bordwell
protokol	BATCH-2	N	protokol	
Slovpol	BATCH-1		Slovpol
smysl	BATCH-2	N	s mysl	
úmysl	BATCH-2	N	ú mysl	
krokodýl	BATCH-2	N	krokodýl	
adam	BATCH-2	N	adam	
amsterodam	BATCH-2	N	amsterodam	
telegram	BATCH-2	N	telegram	
program	BATCH-2	N	pro gram	
Krám	BATCH-1		Krám
tam	BATCH-2	D	tam	
mimochodem	BATCH-2	D	mimo chod em	
Heem	BATCH-1		Heem
parfém	BATCH-2	N	parfém	
arnhem	BATCH-2	N	arnhem	
nájem	BATCH-2	N	ná jem	
problém	BATCH-2	N	problém	
kolem	BATCH-2	D	kol em	
sem	BATCH-2	D	sem	
systém	BATCH-2	N	systém	
zatím	BATCH-2	D	zatím	
předtím	BATCH-2	D	před tím	
podzim	BATCH-2	N	pod zim	
film	BATCH-2	N	film	
jenom	BATCH-2	D	jen om	
dům	BATCH-2	N	dům	
muzeum	BATCH-2	N	muzeum	
kolegium	BATCH-2	N	kolegium	
centrum	BATCH-2	N	centr um	
rozum	BATCH-2	N	roz um	
daň	BATCH-2	N	daň	
jean	BATCH-2	N	jean	
jan	BATCH-2	N	jan	
plán	BATCH-2	N	plán	
roman	BATCH-2	N	roman	
forman	BATCH-2	N	forman	
Hlučíňan	BATCH-1		Hluč íň an
pan	BATCH-2	N	pan	
pán	BATCH-2	N	pán	
beran	BATCH-2	N	beran	
Moskvan	BATCH-1		Moskv an
venkovan	BATCH-2	N	ven k ov an	
caen	BATCH-2	N	caen	
ben	BATCH-2	N	ben	
den	BATCH-2	N	den	
povodeň	BATCH-2	N	po vod eň	
týden	BATCH-2	N	týden	
nejen	BATCH-2	D	ne jen	
jen	BATCH-2	N	jen	
člen	BATCH-2	N	člen	
mnohočlen	BATCH-1		mnoh o člen
abdomen	BATCH-1		abdomen
Miettinen	BATCH-1		Miettinen
stupeň	BATCH-2	N	stup eň	
Sundgren	BATCH-1		Sundgren
píseň	BATCH-2	N	pí seň	
zároveň	BATCH-2	D	zá roveň	
úroveň	BATCH-2	N	ú rov eň	
john	BATCH-2	N	john	
megasráččin	BATCH-1		mega sráč č in
tetiččin	BATCH-1		tet ičč in
Liberečančin	BATCH-1		Libereč an č in
Seychelančin	BATCH-1		Seychel an č in
westmančin	BATCH-1		west man č in
Robinsončin	BATCH-1		Robinson č in
zločin	BATCH-2	N	zlo čin	
plavkařčin	BATCH-1		plav k ař č in
skorokomisařčin	BATCH-1		skoro komis ař č in
Beneščin	BATCH-1		Beneš č in
ortopedistčin	BATCH-1		orto ped ist č in
soudružčin	BATCH-1		sou druž č in
protein	BATCH-2	N	protein	
Kájín	BATCH-1		Kájín
Rogožkin	BATCH-1		Rogožk in
turmalín	BATCH-2	N	turmalín	
colin	BATCH-2	N	colin	
karolínin	BATCH-2	A	karolínin	
spoluběžkynin	BATCH-1		spolu běž kyn in
maltodextrin	BATCH-1		malto dextr in
Gauguin	BATCH-1		Gauguin
benzín	BATCH-2	N	benzín	
hofmann	BATCH-2	N	hofmann	
Pfeffermann	BATCH-1		Pfeffer mann
Kreuzmann	BATCH-1		Kreuz mann
chalcedon	BATCH-1		chalcedon
telefon	BATCH-2	N	telefon	
region	BATCH-2	N	region	
kamion	BATCH-1		kamion
šampion	BATCH-2	N	šampion	
slon	BATCH-2	N	slon	
aspoň	BATCH-2	D	aspoň	
alespoň	BATCH-2	D	alespoň	
maddison	BATCH-2	N	maddison	
maraton	BATCH-2	N	maraton	
klaun	BATCH-2	N	klaun	
Krhoun	BATCH-1		Krh oun
plyn	BATCH-2	N	plyn	
co	BATCH-2	D	co	
avokádo	BATCH-2	N	avokádo	
do	BATCH-2	A	do	???
hnízdo	BATCH-2	N	hnízd o	
video	BATCH-2	N	video	
čecho	BATCH-2	N	čecho	???
dlouho	BATCH-2	D	dlouh o	
rerio	BATCH-1		rerio
flavio	BATCH-2	N	flavio	
brdečko	BATCH-1		brd ečk o
německo	BATCH-2	N	německo	???
Dubíčko	BATCH-1		Dub í čk o
tričko	BATCH-2	N	tričko	
daleko	BATCH-2	N	dalek o	
riziko	BATCH-2	N	riziko	
Ranko	BATCH-1		Rank o
česko	BATCH-2	N	čes k o	
měřítko	BATCH-2	N	měř ítko	???
dřívko	BATCH-2	N	dřív k o	
málo	BATCH-2	N	mál o	
turbodmychadlo	BATCH-2	N	turbo dmych adl o	
divadlo	BATCH-2	N	div adlo	
sídlo	BATCH-2	N	sídl o	
čelo	BATCH-2	N	čel o	
tělo	BATCH-2	N	těl o	
kolo	BATCH-2	N	kol o	
světlo	BATCH-2	D	světl o	
kouzlo	BATCH-2	N	kouzl o	
tomo	BATCH-2	N	tomo	
koleno	BATCH-2	N	kolen o	
jméno	BATCH-2	N	jmén o	
víno	BATCH-2	N	vín o	
jasno	BATCH-2	D	jas n o	
jaro	BATCH-2	N	jaro	
ňadro	BATCH-2	N	ňadr o	
skoro	BATCH-2	D	skoro	
pro	BATCH-2	A	pro	
nitro	BATCH-2	N	nitro	
centro	BATCH-2	N	centro	
pseudotěleso	BATCH-1		pseudo těl es o
těleso	BATCH-2	N	těl es o	
léto	BATCH-2	N	lét o	
takto	BATCH-2	D	takto	???
procento	BATCH-2	N	procent o	
často	BATCH-2	D	čast o	
místo	BATCH-2	N	míst o	
sto	BATCH-2	N	sto	
amaretto	BATCH-1		amarett o
prosciutto	BATCH-1		prosciutt o
auto	BATCH-2	N	auto	
kladivo	BATCH-2	N	klad ivo	
ministerstvo	BATCH-2	N	minister stv o	
železo	BATCH-2	N	želez o	
tip	BATCH-2	N	tip	
výkop	BATCH-2	N	vý kop	
dar	BATCH-2	N	dar	
zigar	BATCH-1		zigar
lékař	BATCH-2	N	lék ař	
zmatkář	BATCH-1		z mat k ář
loutkař	BATCH-1		loutk ař
kancelář	BATCH-2	N	kancelář	
dolar	BATCH-2	N	dolar	
čtenář	BATCH-2	N	čt en ář	
vajnar	BATCH-2	N	vajnar	
akcionář	BATCH-2	N	akcion ář	
pár	BATCH-2	N	pár	
oltář	BATCH-2	N	oltář	
budvar	BATCH-2	N	budvar	
vývar	BATCH-2	N	vý var	
šíbr	BATCH-1		šíbr
kédr	BATCH-1		kédr
Hefler	BATCH-1		Hefler
Höfler	BATCH-1		Höfler
průměr	BATCH-1		prů měr
designer	BATCH-2	N	designer	???
harper	BATCH-2	N	harper	
charakter	BATCH-2	N	charakter	
alister	BATCH-2	N	alister	
Forster	BATCH-1		Forster
sever	BATCH-2	N	sever	
server	BATCH-2	N	server	
pakr	BATCH-1		pakr
tábor	BATCH-2	N	tábor	
profesor	BATCH-2	N	profes or	
organizátor	BATCH-2	N	organiz átor	
kondenzátor	BATCH-2	N	kondenz átor	
motor	BATCH-2	N	motor	
receptor	BATCH-2	N	receptor	
makrokonvertor	BATCH-1		makro kon ver t or
prostor	BATCH-2	N	prostor	
trevor	BATCH-2	N	trevor	
parametr	BATCH-2	N	parametr	
galvanometr	BATCH-1		galvan o metr
občas	BATCH-2	D	ob čas	
čas	BATCH-2	N	čas	
alias	BATCH-2	N	alias	
vlas	BATCH-2	N	vlas	
dumas	BATCH-2	N	dumas	
zápas	BATCH-2	N	zá pas	
kotas	BATCH-2	N	kotas	
proces	BATCH-2	N	proces	
děs	BATCH-2	N	děs	
james	BATCH-2	N	james	
Someš	BATCH-1		Someš
útes	BATCH-2	N	ú tes	
faktis	BATCH-1		faktis
ježíš	BATCH-2	N	ježíš	
miloš	BATCH-2	N	miloš	
vznos	BATCH-1		vz nos
letos	BATCH-2	D	let os	
gryphus	BATCH-2	A	gryphus	
grotius	BATCH-2	N	grotius	
vkus	BATCH-2	N	vkus	
cyklus	BATCH-2	N	cykl us	
organismus	BATCH-2	N	organismus	
komunismus	BATCH-2	N	komunis mus	
plutokratismus	BATCH-1		plut o krat ism us
konzervativismus	BATCH-1		konzerv at iv ism us
obrus	BATCH-1		o brus
myš	BATCH-2	N	myš	
rys	BATCH-2	N	rys	
karafiát	BATCH-2	N	karafiát	
zpékat	BATCH-1		z pék a t
uštěkat	BATCH-1		u štěk a t
přivydělat	BATCH-1		při vy děl a t
postulát	BATCH-2	N	postulát	
hmat	BATCH-1		hmat
formát	BATCH-2	N	form át	
šampionát	BATCH-2	N	šampionát	
tentokrát	BATCH-2	D	tento krát	
akorát	BATCH-2	D	akorát	
trať	BATCH-2	N	trať	
návrat	BATCH-2	N	ná vrat	
odsát	BATCH-1		od s á t
stať	BATCH-2	N	stať	
propovídávat	BATCH-1		pro po víd á v a t
rozcmrndávat	BATCH-1		roz cmrnd á v a t
šlehávat	BATCH-1		šleh á v a t
otejkávat	BATCH-1		o tejk á v a t
přibobtnávat	BATCH-1		při bobtn á v a t
zatlapávat	BATCH-1		za tlap á v a t
posrávat	BATCH-1		po sr á v a t
vyvstávat	BATCH-1		vy v st á v a t
rozchytávat	BATCH-1		roz chyt á v a t
karbovávat	BATCH-1		karb ová v a t
shybovávat	BATCH-1		s hyb ová v a t
agovávat	BATCH-1		agov á v a t
dosahovávat	BATCH-1		do sah ová v a t
fóliovávat	BATCH-1		fóli ová v a t
špekovávat	BATCH-1		špek ová v a t
zaskřínkovávat	BATCH-1		za skřín k ová v a t
vyceňovávat	BATCH-1		vy ceň ová v a t
ordinovávat	BATCH-1		ordin ová v a t
odrapovávat	BATCH-1		od rap ová v a t
navarovávat	BATCH-1		na var ová v a t
metaforizovávat	BATCH-1		meta for izová v a t
okategorizovávat	BATCH-1		o kategor izová v a t
rychlonabíjívat	BATCH-1		rychl o na bíj í v a t
ložívat	BATCH-1		lož í v a t
převerbovat	BATCH-1		pře verb ova t
prohlubovat	BATCH-2	V	pro hlub ova t	
skrečovat	BATCH-1		skreč ova t
tkalcovat	BATCH-1		tka lc ova t
vymycovat	BATCH-2	V	vy myc ova t	
nainstalovat	BATCH-2	V	na in stal ova t	
zaneprazdňovat	BATCH-1		za ne prazdň ova t
proskloňovat	BATCH-1		pro s kloň ova t
objasňovat	BATCH-1		ob jas ň ova t
zkvalitňovat	BATCH-2	V	z kvalit ň ova t	
vystresovat	BATCH-1		vy stres ova t
zmythologisovat	BATCH-1		z myth o log isova t
zageneralisovat	BATCH-1		za general isova t
debitovat	BATCH-1		debit ova t
doindentovat	BATCH-1		do indent ova t
odstartovat	BATCH-1		od start ova t
přidevastovat	BATCH-1		při devast ova t
vyhladovovat	BATCH-1		vy hlad ov ova t
přiflegmatizovat	BATCH-1		při flegmat izova t
vyrejžovat	BATCH-1		vy rejž ova t
zfúzovat	BATCH-2	V	z fúz ova t	
oběť	BATCH-2	N	oběť	
oplácet	BATCH-1		o plác e t
počet	BATCH-2	N	po čet	
frčet	BATCH-1		frč e t
spleť	BATCH-2	N	spleť	
vkoulet	BATCH-1		v koul e t
předmět	BATCH-2	N	předmět	
potmět	BATCH-1		po tm ě t
ret	BATCH-2	N	ret	
zlupenatět	BATCH-1		z lup en at ě t
vletět	BATCH-1		v let ě t
vyvenčit	BATCH-1		vy ven č i t
pocit	BATCH-2	N	po cit	
zvučit	BATCH-1		zvuč i t
vyzdít	BATCH-1		vy zd í t
nakojit	BATCH-1		na koj i t
smyslit	BATCH-1		s mysl i t
mínit	BATCH-2	V	mín it	
zopernit	BATCH-1		z oper n i t
zpodstatnit	BATCH-1		z pod st at n i t
zefektivnit	BATCH-2	V	z efekt iv n i t	
Obodrit	BATCH-1		Obodrit
vyvětřit	BATCH-1		vy větř i t
nahlásit	BATCH-2	V	na hlás it	
odcizit	BATCH-1		od ciz i t
odložit	BATCH-1		od lož i t
efekt	BATCH-2	N	efekt	
objekt	BATCH-2	N	objekt	
projekt	BATCH-2	N	pro jekt	
konflikt	BATCH-2	N	konflikt	
produkt	BATCH-2	N	pro duk t	
Akragant	BATCH-1		Akragant
projektant	BATCH-2	N	pro jekt ant	
prezident	BATCH-2	N	prezident	
agent	BATCH-2	N	agent	
klient	BATCH-2	N	klient	
element	BATCH-2	N	element	
argument	BATCH-2	N	argument	
dokument	BATCH-2	N	dokument	
kontinent	BATCH-2	N	kontinent	
joint	BATCH-1		joint
Pot	BATCH-1		Pot
život	BATCH-2	N	ži vot	
šept	BATCH-2	N	šept	
smrt	BATCH-2	N	s mr t	
komfort	BATCH-2	N	komfort	
Ort	BATCH-1		Ort
Aerotransport	BATCH-1		Aero trans port
transport	BATCH-2	N	transport	
čtvrt	BATCH-2	N	čtvrt	
bombast	BATCH-1		bombast
součást	BATCH-2	N	sou část	
křest	BATCH-2	N	křest	
list	BATCH-2	N	list	
dost	BATCH-2	D	dost	
host	BATCH-2	N	host	
orografickost	BATCH-1		oro graf ic k ost
urogynekologickost	BATCH-1		ur o gynek o log ic k ost
bakchickost	BATCH-1		bakch ic k ost
maličkost	BATCH-2	N	mal ičk ost	
tromboembolickost	BATCH-1		tromb o embol ic k ost
akademickost	BATCH-1		akadem ic k ost
schizofrenickost	BATCH-1		schizo fren ic k ost
sokolnickost	BATCH-1		sokol nic k ost
romantickost	BATCH-1		romant ic k ost
antivirotickost	BATCH-1		anti vir ot ic k ost
velikost	BATCH-2	N	velik ost	
dlouhokrkost	BATCH-1		dlouh o krk ost
paralympijskost	BATCH-1		para lymp ij sk ost
prokremelskost	BATCH-1		pro kremel sk ost
slosovatelskost	BATCH-1		s los ova tel sk ost
růžodolskost	BATCH-1		růž o dol sk ost
lukovenskost	BATCH-1		lukoven sk ost
charentonskost	BATCH-1		charenton sk ost
českolipskost	BATCH-1		česk o lip sk ost
paleničářskost	BATCH-1		pal enič ář sk ost
strunařskost	BATCH-1		strun ař sk ost
vakuářskost	BATCH-1		vaku ář sk ost
košumberskost	BATCH-1		košumber sk ost
synovskost	BATCH-1		syn ov sk ost
vojtovskost	BATCH-1		vojt ov sk ost
nezralost	BATCH-2	N	ne zral ost	
zprůmyslnělost	BATCH-1		z prů mysl n ě l ost
sešlost	BATCH-2	N	se š l ost	
souvislost	BATCH-2	N	sou vis l ost	
vrhanost	BATCH-1		vrh a n ost
viklanost	BATCH-1		vikl a n ost
zamyklanost	BATCH-1		za mykl a n ost
roztoulanost	BATCH-1		roz toul a n ost
vhečmanost	BATCH-1		v hečm a n ost
zbobtnanost	BATCH-1		z bobtn a n ost
rozkolísanost	BATCH-1		roz kolís a n ost
ujebávanost	BATCH-1		u jeb á v a n ost
cédávanost	BATCH-1		cé dá v a n ost
vylehávanost	BATCH-1		vy leh á v a n ost
ošukávanost	BATCH-1		o šuk á v a n ost
vyslípávanost	BATCH-1		vy slíp á v a n ost
zažírávanost	BATCH-1		za žír á v a n ost
počurávanost	BATCH-1		po čur á v a n ost
vyzpytávanost	BATCH-1		vy zpyt á v a n ost
pakovávanost	BATCH-1		pak ová v a n ost
zpaličkovávanost	BATCH-1		z pal ič k ová v a n ost
acidifikovávanost	BATCH-1		acid i fik ová v a n ost
popostrkovávanost	BATCH-1		po po strk ová v a n ost
přibalovávanost	BATCH-1		při bal ová v a n ost
začachrovávanost	BATCH-1		za čachr ová v a n ost
zkypřovávanost	BATCH-1		z kypř ová v a n ost
ocenzurovávanost	BATCH-1		o cenzur ová v a n ost
invertovávanost	BATCH-1		in vert ová v a n ost
zaklíšťovávanost	BATCH-1		za klíšť ová v a n ost
sabrážovávanost	BATCH-1		sabráž ová v a n ost
antagonizovávanost	BATCH-1		anta gon izová v a n ost
ironizovávanost	BATCH-1		iron izová v a n ost
plejtvávanost	BATCH-1		plejtv á v a n ost
zimavívanost	BATCH-1		zimavív a n ost
transkribovanost	BATCH-1		tran skrib ova n ost
odštěničovanost	BATCH-1		od štěn ič ova n ost
rozporcovanost	BATCH-1		roz porc ova n ost
oštrikovanost	BATCH-1		o štrik ova n ost
modelovanost	BATCH-1		model ova n ost
zašpejlovanost	BATCH-1		za špejl ova n ost
izolovanost	BATCH-2	N	izol ov an ost	
odchylovanost	BATCH-1		od chyl ova n ost
přičleňovanost	BATCH-1		při čleň ova n ost
abstenovanost	BATCH-1		absten ova n ost
předželatinovanost	BATCH-1		před žel atin ova n ost
uzemňovanost	BATCH-1		u zem ň ova n ost
zareturnovanost	BATCH-1		za return ova n ost
přišněrovanost	BATCH-1		při šněr ova n ost
zhangrovanost	BATCH-1		z hangr ova n ost
přezahořovanost	BATCH-1		pře za hoř ova n ost
vyhořovanost	BATCH-1		vy hoř ova n ost
zvěšovanost	BATCH-1		z věš ova n ost
osušovanost	BATCH-1		o suš ova n ost
proklesťovanost	BATCH-1		pro klesť ova n ost
rozhazovanost	BATCH-1		roz haz ova n ost
zparalyzovanost	BATCH-1		z para lyz ova n ost
opryžovanost	BATCH-1		o pryž ova n ost
znovunavázanost	BATCH-1		z nov u na váz a n ost
podrobnost	BATCH-2	N	pod rob n ost	
osobnost	BATCH-2	N	o sob n ost	
vyděračnost	BATCH-1		vy děr a č n ost
vděčnost	BATCH-2	N	vděč n ost	
společnost	BATCH-2	N	společ n ost	
skutečnost	BATCH-2	N	skuteč n ost	
budoucnost	BATCH-2	N	bud oucn ost	
dovednost	BATCH-2	N	do ved n ost	
odpovědnost	BATCH-2	N	od po věd n ost	
nedochůdnost	BATCH-1		ne do chůd n ost
vydrobenost	BATCH-1		vy drob en ost
skotačenost	BATCH-1		skotač en ost
modrozlatozelenost	BATCH-1		modr o zlat o zelen ost
lenost	BATCH-2	N	len ost	
vychráněnost	BATCH-1		vy chrán ěn ost
obořenost	BATCH-1		o boř en ost
snesenost	BATCH-1		s nes en ost
rozsršenost	BATCH-1		roz srš en ost
zmramorovatěnost	BATCH-1		z mramor ovat ě n ost
vychraptěnost	BATCH-1		vy chrapt ě n ost
přichutěnost	BATCH-1		při chut ěn ost
znovuoživenost	BATCH-1		z nov u o živ en ost
scezenost	BATCH-1		s cez en ost
vydluženost	BATCH-1		vy dluž en ost
pomíchatelnost	BATCH-1		po mích a teln ost
zamakatelnost	BATCH-1		za mak a teln ost
spráskatelnost	BATCH-1		s prásk a teln ost
vytínatelnost	BATCH-1		vy tín a teln ost
rozbíratelnost	BATCH-1		roz bír a teln ost
šouratelnost	BATCH-1		šour a teln ost
zaplítatelnost	BATCH-1		za plít a teln ost
zadrkotatelnost	BATCH-1		za drk ot a teln ost
očichávatelnost	BATCH-1		o čich á v a teln ost
dočmuchávatelnost	BATCH-1		do čmuch á v a teln ost
výskávatelnost	BATCH-1		výsk á v a teln ost
čmárávatelnost	BATCH-1		čmár á v a teln ost
vyčurávatelnost	BATCH-1		vy čur á v a teln ost
dorachtávatelnost	BATCH-1		do racht á v a teln ost
subvencovávatelnost	BATCH-1		sub ven c ová v a teln ost
usoustruhovávatelnost	BATCH-1		u sou struh ová v a teln ost
proschvalovávatelnost	BATCH-1		pro s chval ová v a teln ost
dopatrolovávatelnost	BATCH-1		do patrol ová v a teln ost
sublimovávatelnost	BATCH-1		sublim ová v a teln ost
šelmovávatelnost	BATCH-1		šelm ová v a teln ost
zkonsumovávatelnost	BATCH-1		z konsum ová v a teln ost
zosobňovávatelnost	BATCH-1		z osob ň ová v a teln ost
zatrubňovávatelnost	BATCH-1		za trub ň ová v a teln ost
poželatinovávatelnost	BATCH-1		po žel atin ová v a teln ost
navagónovávatelnost	BATCH-1		na vagón ová v a teln ost
posunovávatelnost	BATCH-1		po sun ová v a teln ost
nakupírovávatelnost	BATCH-1		na kupír ová v a teln ost
rozpočtovávatelnost	BATCH-1		roz po čt ová v a teln ost
uletovávatelnost	BATCH-1		u let ová v a teln ost
nacizovávatelnost	BATCH-1		na ciz ová v a teln ost
atomizovávatelnost	BATCH-1		atom izová v a teln ost
rozhněvatelnost	BATCH-1		roz hněv a teln ost
obezdívatelnost	BATCH-1		obe zd í v a teln ost
brousívatelnost	BATCH-1		brous í v a teln ost
milkovatelnost	BATCH-1		mil k ova teln ost
přešlukovatelnost	BATCH-1		pře šluk ova teln ost
exhumovatelnost	BATCH-1		ex hum ova teln ost
upovšechňovatelnost	BATCH-1		u po vše ch ň ova teln ost
zmalátňovatelnost	BATCH-1		z malát ň ova teln ost
prolisovatelnost	BATCH-1		pro lis ova teln ost
zautomatisovatelnost	BATCH-1		z auto mat isova teln ost
debutovatelnost	BATCH-1		debut ova teln ost
zmrvovatelnost	BATCH-1		z mrv ova teln ost
zkrystalizovatelnost	BATCH-1		z krystal izova teln ost
povázatelnost	BATCH-1		po váz a teln ost
nahraditelnost	BATCH-1		na hrad i teln ost
zpitomitelnost	BATCH-1		z pitom i teln ost
odclonitelnost	BATCH-1		od clon i teln ost
usouvstažnitelnost	BATCH-1		u sou vs taž n i teln ost
zvráštitelnost	BATCH-1		z vráš t i teln ost
odpřeložitelnost	BATCH-1		od pře lož i teln ost
podvrknutelnost	BATCH-1		pod vrk nu teln ost
zatřepnutelnost	BATCH-1		za třep nu teln ost
okolnost	BATCH-2	N	o kol n ost	
strastiplnost	BATCH-1		strast i pln ost
přítomnost	BATCH-2	N	pří tom n ost	
pětistrannost	BATCH-1		pět i stran n ost
šestasedmdesátičlennost	BATCH-1		šest a sedm desát i člen n ost
úkornost	BATCH-1		ú kor n ost
pozornost	BATCH-2	N	po zor n ost	
vláhonosnost	BATCH-1		vláh o nos n ost
neposlušnost	BATCH-1		ne po sluš n ost
neobratnost	BATCH-1		ne ob rat n ost
vlastnost	BATCH-2	N	vlast n ost	
možnost	BATCH-2	N	mož n ost	
vododržnost	BATCH-2	N	vod o drž n ost	
post	BATCH-2	N	post	
odkletost	BATCH-1		od kle t ost
pobitost	BATCH-1		po bit ost
trávolistost	BATCH-1		tráv o list ost
ufouknutost	BATCH-1		u fouk nu t ost
rozsýpavost	BATCH-1		roz sýp a v ost
brodivost	BATCH-1		brod iv ost
učenlivost	BATCH-1		uč e nliv ost
žárlivost	BATCH-2	N	žárl iv ost	
půjčkychtivost	BATCH-1		půjč k y cht iv ost
jedenadvacetisekundovost	BATCH-1		jeden a dv a cet i sekund ov ost
prokládkovost	BATCH-1		pro klád k ov ost
trekovost	BATCH-1		trek ov ost
balíkovost	BATCH-1		bal ík ov ost
půlsnímkovost	BATCH-1		půl s ním k ov ost
bezesrážkovost	BATCH-1		beze s ráž k ov ost
šestnáctisvazkovost	BATCH-1		šest náct i s vaz k ov ost
balzámovost	BATCH-1		balzám ov ost
jednobránovost	BATCH-1		jedn o brán ov ost
třicetimilionovost	BATCH-1		tř i cet i milion ov ost
čtyřicítikilometrovost	BATCH-1		čtyř i cít i kilo metr ov ost
kychtovost	BATCH-1		kycht ov ost
belcantovost	BATCH-1		bel cant ov ost
prst	BATCH-2	N	prst	
holocaust	BATCH-1		holocaust
elliott	BATCH-2	N	elliott	
skaut	BATCH-2	N	skaut	
chuť	BATCH-2	N	chuť	
obtáhnout	BATCH-1		ob táh nou t
šplhnout	BATCH-1		šplh nou t
zapolítnout	BATCH-1		za po lít n out
text	BATCH-2	N	text	
byt	BATCH-2	N	by t	???
svézt	BATCH-1		s véz t
dopředu	BATCH-2	D	do před u	
opravdu	BATCH-2	D	o prav du	
mathieu	BATCH-2	N	mathieu	
trochu	BATCH-2	D	troch u	
zpočátku	BATCH-2	D	z počátk u	???
vskutku	BATCH-2	D	v skutk u	
pomalu	BATCH-2	D	po mal u	
spolu	BATCH-2	D	spolu	
Alemannů	BATCH-1		Alemann ů
stranou	BATCH-2	D	stran ou	
jednou	BATCH-2	D	jedn ou	
většinou	BATCH-2	D	větš inou	
tu	BATCH-2	D	tu	
bohuslav	BATCH-2	N	bohu slav	
oděv	BATCH-2	N	o dě v	???
objev	BATCH-2	N	ob jev	
úsměv	BATCH-2	N	ú smě v	
krev	BATCH-2	N	krev	
název	BATCH-2	N	ná zev	
objektiv	BATCH-2	N	objekt iv	
motiv	BATCH-2	N	motiv	
Šinkarjov	BATCH-1		Šinkarj ov
Jakov	BATCH-1		Jak ov
Novikov	BATCH-1		Novik ov
kov	BATCH-2	N	kov	
venkov	BATCH-2	N	ven k ov	
proslov	BATCH-2	N	pro sl ov	
Krušanov	BATCH-1		Kruš an ov
Měchnov	BATCH-1		Měchn ov
ostrov	BATCH-2	N	ostrov	
Janišov	BATCH-1		Jan iš ov
Sudoplatov	BATCH-1		Sud o plat ov
Rutov	BATCH-1		Rut ov
Stanislavov	BATCH-1		Stanislav ov
Lupačův	BATCH-1		Lup ač ův
vybíračův	BATCH-1		vy bír ač ův
knihvazačův	BATCH-1		knih vaz ač ův
Pribiševičův	BATCH-1		Pribišev ič ův
příjemcův	BATCH-1		pří jem c ův
Alfrédův	BATCH-1		Alfréd ův
vševědův	BATCH-1		vše věd ův
Hannawaldův	BATCH-1		Hannawald ův
Czendův	BATCH-1		Czend ův
pageův	BATCH-2	A	page ův	
georgeův	BATCH-2	A	george ův	
Hammarbergův	BATCH-1		Hammarberg ův
Krejbichův	BATCH-1		Krejbich ův
Galileiův	BATCH-1		Galilei ův
Baranjův	BATCH-1		Baranj ův
Dekojův	BATCH-1		Dekoj ův
Procákův	BATCH-1		Procák ův
Pistovčákův	BATCH-1		Pistovčák ův
Anďákův	BATCH-1		Anď ák ův
Stempniakův	BATCH-1		Stempniak ův
Babulakův	BATCH-1		Babulak ův
Hrčkulákův	BATCH-1		Hrčkulák ův
Manákův	BATCH-1		Manák ův
Marrackův	BATCH-1		Marrack ův
Tilečkův	BATCH-1		Til eč k ův
úderníčkův	BATCH-1		ú der n íč k ův
Lávíčkův	BATCH-1		Láv íč k ův
Sierckův	BATCH-1		Sierck ův
Knapčíkův	BATCH-1		Knap čík ův
Nevařilíkův	BATCH-1		Ne vař i l ík ův
Vošmíkův	BATCH-1		Vošmík ův
vinohradníkův	BATCH-1		vin o hrad ník ův
záludníkův	BATCH-1		zá lud n ík ův
křížovníkův	BATCH-1		kříž ovník ův
Regentíkův	BATCH-1		Regent ík ův
Juránkův	BATCH-1		Jur ánk ův
Polenkův	BATCH-1		Polen k ův
Alexaněnkův	BATCH-1		Alexaněnk ův
Vosejpkův	BATCH-1		Vo sejp k ův
Beznoskův	BATCH-1		Bez nos k ův
Franciszkův	BATCH-1		Franciszk ův
Kosmálův	BATCH-1		Kosmál ův
babralův	BATCH-1		babr a l ův
Krejdlův	BATCH-1		Krejdl ův
pohlcovatelův	BATCH-1		po hlc ova tel ův
postihovatelův	BATCH-1		po stih ova tel ův
hýřilův	BATCH-1		hýř i l ův
Jurnyklův	BATCH-1		Jurnykl ův
Brummellův	BATCH-1		Brummell ův
Gargulův	BATCH-1		Gargul ův
Suchanův	BATCH-1		Such an ův
Malsanův	BATCH-1		Malsan ův
Thubtänův	BATCH-1		Thubtän ův
Atvánův	BATCH-1		Atván ův
Kühnenův	BATCH-1		Kühnen ův
Šitinův	BATCH-1		Šitin ův
Sargonův	BATCH-1		Sargon ův
Manethónův	BATCH-1		Manethón ův
Skarynův	BATCH-1		Skaryn ův
Blomkampův	BATCH-1		Blomkamp ův
Balgarův	BATCH-1		Balgar ův
rejtharův	BATCH-1		rejthar ův
gonkařův	BATCH-1		gonk ař ův
binarův	BATCH-2	A	binar ův	
Večeřův	BATCH-1		Večeř ův
Kolmhoferův	BATCH-1		Kolmhofer ův
Ciglerův	BATCH-1		Cigler ův
retailerův	BATCH-1		retailer ův
Pillerův	BATCH-1		Piller ův
pasterův	BATCH-1		paster ův
nemotorův	BATCH-1		ne motor ův
Tulsídásův	BATCH-1		Tulsídás ův
Anacharsisův	BATCH-1		Anacharsis ův
Watersův	BATCH-1		Waters ův
klausův	BATCH-2	A	klaus ův	
matoušův	BATCH-2	A	matouš ův	
tlusťoušův	BATCH-1		tlusť ouš ův
Waitův	BATCH-1		Wait ův
Diartův	BATCH-1		Diart ův
verbalistův	BATCH-1		verb al ist ův
exslávistův	BATCH-1		ex sláv ist ův
Burdettův	BATCH-1		Burdett ův
Uzunogluův	BATCH-1		Uzunoglu ův
Michalovův	BATCH-1		Michal ov ův
Abušinovův	BATCH-1		Abušinov ův
show	BATCH-2	N	show	
heathrow	BATCH-2	N	heathrow	???
Palmex	BATCH-1		Palmex
box	BATCH-2	N	box	
rádoby	BATCH-1		rád o by
jakoby	BATCH-2	D	jakoby	
derby	BATCH-2	N	derby	
Obruby	BATCH-1		Ob rub y
mladý	BATCH-2	A	mlad ý	
tady	BATCH-2	D	tady	
hnědý	BATCH-2	A	hněd ý	
tehdy	BATCH-2	D	tehdy	???
nikdy	BATCH-2	D	nikdy	
kdy	BATCH-2	D	kdy	
rudý	BATCH-2	A	rud ý	
všudy	BATCH-2	D	všud y	
každý	BATCH-2	A	každ ý	
neblahý	BATCH-2	A	ne blah ý	
čechy	BATCH-2	N	čech y	
suchý	BATCH-2	A	such ý	
mnohý	BATCH-2	A	mnoh ý	
druhý	BATCH-2	A	druh ý	
taky	BATCH-2	D	tak y	
rodácký	BATCH-1		rod ác k ý
hanácký	BATCH-2	A	haná ck ý	
maloměšťácký	BATCH-2	A	mal o měšť áck ý	
vědecký	BATCH-2	A	věd ec k ý	
herecky	BATCH-2	D	her eck y	
bezvěrecký	BATCH-1		bez věr ec k ý
echokardiografický	BATCH-2	A	echo kardio graf ick ý	
strategický	BATCH-2	A	strateg ic k ý	
technologický	BATCH-2	A	technolog ick ý	
anglický	BATCH-2	A	angl ick ý	
anglicky	BATCH-2	D	angl ick y	
Vorlický	BATCH-1		Vorl ic k ý
předtanečnický	BATCH-1		před taneč nic k ý
kriminalistickotechnický	BATCH-1		kriminal ist ick o techn ic k ý
etnický	BATCH-2	A	etnick ý	
zdravotnický	BATCH-2	A	zdrav otnick ý	???
brtnicky	BATCH-1		brtn ic k y
řeznicky	BATCH-1		řez nic k y
geometrický	BATCH-2	A	geometr ick ý	
elektrický	BATCH-2	A	elektr ick ý	
klasický	BATCH-2	A	klasic ký	
problematický	BATCH-2	A	problem atick ý	???
klimatický	BATCH-2	A	klim atick ý	
automatický	BATCH-2	A	auto mat ick ý	
aeromagneticky	BATCH-1		aero magnet ic k y
teoretický	BATCH-2	A	teoretický	???
politický	BATCH-2	A	politic k ý	
prakticky	BATCH-2	D	praktick y	
antimykoticky	BATCH-1		anti myk ot ic k y
asymptoticky	BATCH-1		a symptot ic k y
fantastický	BATCH-2	A	fantast ick ý	???
nacistický	BATCH-2	A	nac ist ick ý	
achronisticky	BATCH-1		a chron ist ic k y
slávistický	BATCH-2	A	sláv ist ic k ý	
lingvistický	BATCH-2	A	lingv ist ick ý	
budějovický	BATCH-2	A	buděj ov ic k ý	
velkopavlovický	BATCH-2	A	velk o pavl ov ick ý	
metafyzický	BATCH-2	A	meta fyzick ý	
sladký	BATCH-2	N	slad k ý	
lehký	BATCH-2	A	lehk ý	
velký	BATCH-2	A	vel k ý	
tenký	BATCH-2	A	ten k ý	??? kořen tenk?
široký	BATCH-2	A	šir ok ý	
visegradský	BATCH-1		visegrad sk ý
český	BATCH-2	A	čes k ý	
Vísky	BATCH-1		Vís k y
aquilejský	BATCH-1		aquilej sk ý
ochranitelsky	BATCH-1		o chran i tel sk y
růžodolsky	BATCH-1		růž o dol sk y
chrudimský	BATCH-1		chrudim sk ý
dánský	BATCH-2	A	dán sk ý	
zaoceánský	BATCH-2	A	za oceán sk ý	
valdensky	BATCH-1		valden sk y
československý	BATCH-2	A	česk o sloven sk ý	
náboženský	BATCH-2	A	ná bož enský	
čínský	BATCH-2	A	čín sk ý	
provodínský	BATCH-1		pro vod ín sk ý
japonský	BATCH-2	A	japon sk ý	
evropský	BATCH-2	A	evrop sk ý	
středoevropský	BATCH-2	A	střed o evrop sk ý	
hospodářský	BATCH-2	A	hospod ář sk ý	
šéflékařský	BATCH-1		šéf lék ař sk ý
pobožnůstkářský	BATCH-1		po bož n ůst k ář sk ý
hamburgrářsky	BATCH-1		ham burgr ář sk y
tatarský	BATCH-1		tatar sk ý
gondoliérský	BATCH-1		gondol iér sk ý
východozairský	BATCH-1		vý chod o zair sk ý
prétorský	BATCH-1		prétor sk ý
editorský	BATCH-2	A	edit or sk ý	
keltský	BATCH-2	A	kelt sk ý	
rakouský	BATCH-2	A	rakousk ý	
tetřevsky	BATCH-1		tetřev sk y
zlechovský	BATCH-1		zlechov sk ý
berehovsky	BATCH-1		bereh ov sk y
snílkovsky	BATCH-1		sn í l k ovsk y
jankovský	BATCH-2	N	jan k ov sk ý	
zelenkovsky	BATCH-1		zelen k ovsk y
protikrálovsky	BATCH-1		proti král ovsk y
spořilovský	BATCH-1		spoř i l ov sk ý
delonovsky	BATCH-1		delon ov sk y
Vokurovský	BATCH-1		Vokur ov ský
tokugawský	BATCH-1		tokugaw sk ý
protiabcházský	BATCH-1		proti abcház sk ý
břežský	BATCH-1		břež sk ý
zpátky	BATCH-2	D	zpát ky	
hezký	BATCH-2	A	hezk ý	
hezky	BATCH-2	D	hezk y	
těžký	BATCH-2	A	těž k ý	
nízký	BATCH-2	A	níz ký	
zoufalý	BATCH-2	A	zouf al ý	
malý	BATCH-2	N	mal ý	
zralý	BATCH-2	A	zra l ý	
bývalý	BATCH-2	A	bý val ý	
celý	BATCH-2	A	celý	
zkamenělý	BATCH-2	A	z kamen ěl ý	
ojedinělý	BATCH-2	A	o jedin ěl ý	
vyspělý	BATCH-2	A	vy spě l ý	
podezřelý	BATCH-2	A	pode zř el ý	
veselý	BATCH-2	A	vesel ý	
rychlý	BATCH-2	A	rychl ý	
štíhlý	BATCH-2	A	štíhl ý	
zelenomodrobílý	BATCH-1		zelen o modr o bíl ý
zchlapčilý	BATCH-1		z chlap č i l ý
obvyklý	BATCH-2	A	ob vyk l ý	
zvyklý	BATCH-2	A	z vyk l ý	
zahoustlý	BATCH-1		za houst l ý
minulý	BATCH-2	A	min ul ý	
známý	BATCH-2	N	zn ám ý	
přímý	BATCH-2	A	přím ý	
zřejmý	BATCH-2	A	zř ejm ý	
zakydaný	BATCH-1		za kyd a n ý
vytahaný	BATCH-2	A	vy tah a n ý	
zberchaný	BATCH-1		z berch a n ý
oblékaný	BATCH-2	A	ob lék an ý	
procvikaný	BATCH-1		pro cvik a n ý
zasálaný	BATCH-1		za sál a n ý
povolaný	BATCH-2	A	po vol an ý	
polámaný	BATCH-2	A	po lám an ý	
dostoupaný	BATCH-1		do stoup a n ý
sebeuzavíraný	BATCH-1		seb e u za vír a n ý
vyzdvíhávaný	BATCH-1		vy zdvíh á v a n ý
rozestrkávaný	BATCH-1		roze strk á v a n ý
vecpávaný	BATCH-1		ve cp á v a n ý
přisévávaný	BATCH-1		při sév á v a n ý
dozpracovávaný	BATCH-1		do z prac ová v a n ý
popučovávaný	BATCH-1		po puč ová v a n ý
zapreludovávaný	BATCH-1		za pre lud ová v a ný
překomplikovávaný	BATCH-1		pře komplik ová v a n ý
zaproximovávaný	BATCH-1		z a proxim ová v a n ý
zkapalňovávaný	BATCH-1		z kap a l ň ová v a n ý
zesnovávaný	BATCH-1		ze snov á v a n ý
odštěpovávaný	BATCH-1		od štěp ová v a n ý
zmikroskopovávaný	BATCH-1		z mikro skop ová v a n ý
vjádrovávaný	BATCH-1		v jádr ová v a n ý
přeorientovávaný	BATCH-1		pře orient ová v a n ý
odtestovávaný	BATCH-1		od test ová v a n ý
překoštovávaný	BATCH-1		pře košt ová v a n ý
zlaicizovávaný	BATCH-1		z laic izová v a n ý
desexualizovávaný	BATCH-1		de sex ual izová v a n ý
vábívaný	BATCH-1		váb í v a n ý
spíjívaný	BATCH-1		s píj í v a n ý
blouznívaný	BATCH-1		blouzn í v a n ý
vystačovaný	BATCH-1		vy stač ova n ý
následovaný	BATCH-2	A	ná sled ov an ý	
sledovaný	BATCH-2	A	sled ovan ý	???
navrhovaný	BATCH-2	A	na vrh ova n ý	
posprejovaný	BATCH-2	A	po sprej ov an ý	
švenkovaný	BATCH-1		švenk ova n ý
ocyklovaný	BATCH-1		o cykl ova n ý
plánovaný	BATCH-2	A	plán ovaný	
pozeleňovaný	BATCH-1		po zeleň ova n ý
vklínovaný	BATCH-1		v klín ova n ý
znečitelňovaný	BATCH-1		z ne či telň ova n ý
zmultiplicírovaný	BATCH-1		z multi plic ír ova n ý
ilustrovaný	BATCH-2	A	ilustr ov an ý	
zřasovaný	BATCH-1		z řas ova n ý
zainteresovaný	BATCH-2	A	za interes ova n ý	
římsovaný	BATCH-1		říms ova n ý
zakultivovaný	BATCH-1		za kult iv ova n ý
motivovaný	BATCH-2	A	motiv ov an ý	
obarvovaný	BATCH-1		o barv ova n ý
fašizovaný	BATCH-1		faš izova n ý
ztraumatizovaný	BATCH-1		z traum at izova n ý
povylézaný	BATCH-1		po vy léz a n ý
pravděpodobný	BATCH-2	A	pravd ě podob n ý	
podobný	BATCH-2	A	podob n ý	
zhoubný	BATCH-1		z houb n ý
obecný	BATCH-2	A	obec n ý	
skutečný	BATCH-2	A	skuteč n ý	
nadbytečný	BATCH-2	A	nad byteč n ý	???
mocný	BATCH-2	A	moc ný	
náročný	BATCH-2	A	ná roč n ý	
záhadný	BATCH-2	A	zá had ný	
snadný	BATCH-2	A	snadn ý	
nápadný	BATCH-2	A	ná pad n ý	
pohledný	BATCH-2	A	po hled n ý	
přírodovědný	BATCH-1		pří rod o věd n ý
svobodný	BATCH-2	A	svobod n ý	
vhodný	BATCH-2	A	v hod n ý	
výhodný	BATCH-2	A	vý hod n ý	
průjezdný	BATCH-1		prů jezd n ý
oblíbený	BATCH-2	A	ob líb en ý	
odkřemičený	BATCH-1		od křem ič en ý
dorachocený	BATCH-1		do rach oc en ý
vínovoměděný	BATCH-1		vín ov o měd ěn ý
spokojený	BATCH-2	A	s pokoj en ý	
spojený	BATCH-2	A	s poj en ý	
zabalený	BATCH-2	A	za bal ený	
vzdálený	BATCH-2	A	vz dál en ý	
dělený	BATCH-2	A	děl en ý	
zelený	BATCH-2	A	zelen ý	
osvětlený	BATCH-2	A	o svět l en ý	??? svět nebo světl
chráněný	BATCH-2	A	chrán ěn ý	
vyplněný	BATCH-1		vy pln ěn ý
rozšířený	BATCH-2	A	roz šíř en ý	
zamořený	BATCH-2	A	za moř en ý	
prohlášený	BATCH-2	A	pro hláš en ý	
přikuchtěný	BATCH-1		při kucht ěn ý
zapuštěný	BATCH-2	A	za pušt ěný	
sestavený	BATCH-2	A	se sta v en ý	
postavený	BATCH-2	A	po sta v en ý	
vystavený	BATCH-2	A	vy sta v en ý	
domluvený	BATCH-2	A	do mluv en ý	
rozházený	BATCH-2	A	roz ház en ý	
chlazený	BATCH-2	A	chlaz en ý	
shlazený	BATCH-1		s hlaz en ý
napřažený	BATCH-2	A	na přaž en ý	
rozsazený	BATCH-1		roz saz en ý
založený	BATCH-2	A	za lož en ý	
vržený	BATCH-2	A	vrž en ý	
prodloužený	BATCH-2	A	pro dlouž en ý	
vytoužený	BATCH-2	A	vy touž en ý	
dějiny	BATCH-2	N	dě jiny	
jiný	BATCH-2	A	jin ý	
prázdniny	BATCH-2	N	prázdn iny	
stejný	BATCH-2	A	stejn ý	
reálný	BATCH-2	A	reál n ý	
valný	BATCH-2	A	val n ý	
pravidelný	BATCH-2	A	prav idel n ý	
dýchatelný	BATCH-2	A	dých ateln ý	
zašmidlatelný	BATCH-1		za šmidl a teln ý
pochutnatelný	BATCH-1		po chut n a teln ý
dorovnatelný	BATCH-1		do rovn a teln ý
střepatelný	BATCH-1		s třep a teln ý
podrbávatelný	BATCH-1		po drb á v a teln ý
ošolichávatelný	BATCH-1		o šolich á v a teln ý
podestýlávatelný	BATCH-1		pode stýl á v a teln ý
pozírávatelný	BATCH-1		po zír á v a teln ý
zadusávatelný	BATCH-1		za dus á v a teln ý
propočítávatelný	BATCH-1		pro po čít á v a teln ý
omdlévávatelný	BATCH-1		o mdl é v á v a teln ý
posmívávatelný	BATCH-1		po sm í v á v a teln ý
deeskalovávatelný	BATCH-1		de eskal ová v a teln ý
umilovávatelný	BATCH-1		u mil ová v a teln ý
převolovávatelný	BATCH-1		pře vol ová v a teln ý
filmovávatelný	BATCH-1		film ová v a teln ý
otejpovávatelný	BATCH-1		o tejp ová v a teln ý
zavzdorovávatelný	BATCH-1		za vz dor ová v a teln ý
ušetřovávatelný	BATCH-1		u šetř ová v a teln ý
záplatovávatelný	BATCH-1		zá plat ová v a teln ý
pachtovávatelný	BATCH-1		pacht ová v a teln ý
konstruovávatelný	BATCH-1		kon stru ová v a teln ý
vyživovávatelný	BATCH-1		vy živ ová v a teln ý
rozlévatelný	BATCH-1		roz lév a teln ý
hranívatelný	BATCH-1		hran í v a teln ý
jasnívatelný	BATCH-1		jas n í v a teln ý
velrybařívatelný	BATCH-1		vel ryb ař í v a teln ý
lepšívatelný	BATCH-1		lep š í v a teln ý
žilnatívatelný	BATCH-1		žil n atí v a teln ý
čtvrtívatelný	BATCH-1		čtvrt í v a teln ý
skvívatelný	BATCH-1		skv í v a teln ý
kadencovatelný	BATCH-1		kadenc ova teln ý
gaučovatelný	BATCH-1		gauč ova teln ý
zmultitaskovatelný	BATCH-1		z multi task ova teln ý
eskalovatelný	BATCH-1		eskal ova teln ý
zmikrofilmovatelný	BATCH-1		z mikro film ova teln ý
datumovatelný	BATCH-1		dat um ova teln ý
stripovatelný	BATCH-1		strip ova teln ý
skompresovatelný	BATCH-1		s kom pres ova teln ý
rozkompresovatelný	BATCH-1		roz kom pres ova teln ý
zpolitisovatelný	BATCH-1		z polit isova teln ý
temporalizovatelný	BATCH-1		tempor al izova teln ý
sesynchronizovatelný	BATCH-1		se syn chron izova teln ý
prokluzovatelný	BATCH-1		pro kluz ova teln ý
světelný	BATCH-2	A	svět eln ý	
prohloubitelný	BATCH-1		pro hloub i teln ý
slučitelný	BATCH-2	A	s luč itel n ý	???
přičouditelný	BATCH-1		při čoud i teln ý
vytrolitelný	BATCH-1		vy trol i teln ý
odkřesťanitelný	BATCH-1		od křesť an i teln ý
pochopitelný	BATCH-2	A	po chop iteln ý	???
zešimlovatitelný	BATCH-1		ze šiml ova t i teln ý
stravitelný	BATCH-2	A	s trav iteln ý	
jevitelný	BATCH-1		jev i teln ý
úžitelný	BATCH-1		úž i teln ý
vobléknutelný	BATCH-1		v ob lék nu teln ý
ztlápnutelný	BATCH-1		z tláp nu teln ý
vstoupnutelný	BATCH-1		v stoup nu teln ý
silný	BATCH-2	A	sil n ý	
odolný	BATCH-2	A	odol n ý	
volný	BATCH-2	A	vol ný	
tajuplný	BATCH-2	A	taju pln ý	
útulný	BATCH-2	A	ú tul n ý	
významný	BATCH-2	A	vý znam n ý	
příjemný	BATCH-2	A	pří jem n ý	
temný	BATCH-2	A	tem ný	
skromný	BATCH-2	A	skromn ý	
stanný	BATCH-2	A	stan n ý	
červenosemenný	BATCH-1		červen o semen n ý
povinný	BATCH-2	A	po vin n ý	
zákonný	BATCH-2	A	zá kon n ý	
anthony	BATCH-2	N	anthony	
sestupný	BATCH-2	A	se stup n ý	
úderný	BATCH-2	A	úder n ý	
poměrný	BATCH-2	A	po měr n ý	
nepatrný	BATCH-2	A	ne patr n ý	
občasný	BATCH-2	A	ob čas n ý	
jasný	BATCH-2	A	jas n ý	
souhlasný	BATCH-2	A	sou hlas n ý	
strašný	BATCH-2	A	straš n ý	
přesný	BATCH-2	A	přesn ý	
špatný	BATCH-2	A	špatn ý	
podstatný	BATCH-2	A	pod stat n ý	
posvátný	BATCH-2	A	po svát n ý	
bezpředmětný	BATCH-1		bez před mět n ý
trestný	BATCH-2	A	trest n ý	
pověstný	BATCH-2	A	po věs tn ý	???
nenasytný	BATCH-1		ne na syt n ý
přípravný	BATCH-2	A	pří prav n ý	
správný	BATCH-2	A	s práv n ý	
úsměvný	BATCH-2	A	ú smě vný	
tmavobarevný	BATCH-1		tmav o barev n ý
šikovný	BATCH-2	A	šik ov n ý	
výrazný	BATCH-2	A	vý raz n ý	
oběžný	BATCH-2	A	o běž n ý	
železný	BATCH-2	A	želez n ý	
možný	BATCH-2	A	mož ný	
totožný	BATCH-2	A	totožn ý	
různý	BATCH-2	A	různ ý	
tropy	BATCH-2	N	trop y	
starý	BATCH-2	N	star ý	
dobrý	BATCH-2	A	dobr ý	
Plandry	BATCH-1		Plandr y
zelenošedomodrý	BATCH-1		zelen o šed o modr ý
pestrý	BATCH-2	A	pestr ý	
kostrbatý	BATCH-2	A	kostrbat ý	
blonďatý	BATCH-2	A	blonď at ý	
vypjatý	BATCH-2	A	vy pj at ý	
hrbolkatý	BATCH-2	A	hrbol kat ý	
louhovatý	BATCH-1		louh ovat ý
letitý	BATCH-2	A	let it ý	
svažitý	BATCH-2	A	s važ it ý	
důležitý	BATCH-2	A	dů lež it ý	
častý	BATCH-2	A	čast ý	
jistý	BATCH-2	A	jist ý	
prostý	BATCH-2	A	prost ý	
černosrstý	BATCH-1		čern o srst ý
píchnutý	BATCH-2	A	pích nut ý	
podtrhnutý	BATCH-1		pod trh nu t ý
vytuhnutý	BATCH-1		vy tuh nu t ý
zaklesnutý	BATCH-2	A	za kles nut ý	
špinavý	BATCH-2	A	špin av ý	
zdravý	BATCH-2	A	zdrav ý	
pravý	BATCH-2	A	prav ý	
krvavý	BATCH-2	A	krv av ý	
Halévy	BATCH-1		Halév y
levý	BATCH-2	A	lev ý	
opovážlivý	BATCH-2	A	o po váž liv ý	
oděvuchtivý	BATCH-1		o děv u cht iv ý
zpěvuchtivý	BATCH-1		z pěv u cht iv ý
milostivý	BATCH-2	A	mil ost iv ý	
trojvodičový	BATCH-2	A	troj vod ič ov ý	
důchodový	BATCH-2	A	dů chod ov ý	
půlmiliardový	BATCH-1		půl miliard ov ý
proudový	BATCH-2	A	proud ov ý	
reliéfový	BATCH-1		reliéf ov ý
podlahový	BATCH-2	A	podlah ov ý	
předtuchový	BATCH-1		před tuch ov ý
paládiový	BATCH-1		paládi ov ý
zrakový	BATCH-2	A	zrak ov ý	
jednotrubkový	BATCH-1		jedn o trub k ov ý
superšpičkový	BATCH-1		super špič k ov ý
růžičkový	BATCH-2	A	růž ičk ov ý	
celohliníkový	BATCH-1		cel o hlin ík ov ý
celkový	BATCH-2	A	celk ov ý	
dvourámkový	BATCH-1		dv ou rám k ov ý
strunkový	BATCH-1		strun k ov ý
úrokový	BATCH-2	A	ú rok ov ý	
ložiskový	BATCH-2	A	lož iskov ý	???
ocelový	BATCH-2	A	ocel ov ý	
kyslíkoniklový	BATCH-1		kysl ík o nikl ov ý
kolový	BATCH-2	A	kol ov ý	
akrylový	BATCH-2	A	akryl ov ý	
filmový	BATCH-2	A	film ov ý	
vrásnozlomový	BATCH-1		vrás n o z lom ov ý
měnový	BATCH-2	A	měn ový	
kožešinový	BATCH-2	A	kož eš in ov ý	
zahumnový	BATCH-1		za humn ov ý
nový	BATCH-2	N	nov ý	
bezfreonový	BATCH-1		bez freon ov ý
čtyřistatunový	BATCH-1		čtyř i st a tun ov ý
březnový	BATCH-2	A	břez nov ý	
čárový	BATCH-2	A	čár ov ý	
padesátilibrový	BATCH-1		pa desát i libr ov ý
lágrový	BATCH-2	A	lágr ov ý	
trojkomorový	BATCH-1		tr oj komor ov ý
sprašový	BATCH-2	A	s praš ov ý	
ztrátový	BATCH-2	A	z trát ov ý	
eternitový	BATCH-1		eternit ov ý
plastový	BATCH-2	A	plast ov ý	
březový	BATCH-2	A	břez ov ý	
brzy	BATCH-2	D	brzy	
vzkaz	BATCH-2	N	vz kaz	
mráz	BATCH-2	N	mráz	
důraz	BATCH-2	N	dů raz	
výraz	BATCH-2	N	vý raz	
bez	BATCH-2	N	bez	
rovněž	BATCH-2	D	rovněž	
již	BATCH-2	D	již	
mříž	BATCH-2	N	mříž	
průtrž	BATCH-2	N	prů trž	
skorokonkurz	BATCH-1		skoro konkurz
muž	BATCH-2	N	muž	
už	BATCH-2	D	už	
