pískovištích	písk ov išt -ích	pískoviště	písk ov išt -ě
tati	tat -i	táta	tát -a
tiskárnu	tisk árn -u	tiskárna	tisk árn -a
netrpělivě	ne trp ě liv -ě	trpělivě	trp ě liv -ý
neuznávajících	ne u zn á v aj íc -ích	uznávající	u zn á v aj íc -í
živí	ži v -í	živý	ži v -ý
drže	drž -e	držet	drž e -t
duchovního	duch ovn -ího	duchovní	duch ovn -í
hradbách	hrad b ách	hradba	hrad b -a
chladněji	chlad n ěj -i	chladno	chlad n -o
jatkami	jatk -ami	jatky	jatk -y
obešli	obe š l -i	obejít	obe jí -t
stoupněte	stoup ně -te	stoupnout	stoup nou -t
šachovnicích	šach ov nic -ích	šachovnice	šach ov nic -e
uřízněte	u říz ně -te	uříznout	u říz nou -t
zhasínají	z has í n aj -í	zhasínat	z has í n a -t
znepokojují	z ne po koj uj -í	znepokojovat	z ne po koj ova -t
hlouběji	hloub ěji	hluboce	hlub oc -e
žhavou	žhav -ou	žhavý	žhav -ý
vyňavše	vy ň a v -še	vyjmout	vy j mou -t
sletě	s let -ě	slet	s let -0
zeleně	zel en -ě	zeleň	zeleň -0
jablíčka	jablíč k -a	jablíčko	jablíč k -o
cílevědomější	cíl e věd om ějš -í	cílevědomý	cíl e věd om -ý
vyvinuli	vy vi nu l -i	vyvinout	vy vi nou -t
výš	výš	vysoko	vys ok -o
balkony	balkon -y	balkón	balkón
tau	tau	tao	ta -o
elysiem	elisi -em	elysium	elisi -um
odlehlejších	od leh l ejš -ích	odlehlý	od leh l -ý
schováš	s chov á -š	schovat	a chov a -t
admirála	admirál -a	admirál	admirál -0
neagitovala	ne agit ova l -a	agitovat	agit ova -t
agresi	agres -i	agrese	agres -e
americká	americ k -á	americký	americ k -ý
anima	anim -a	animum	anim -um
asfaltovou	asfalt ov -ou	asfaltový	asfalt ov -ý
autostopem	aut +o stop -em	autostop	aut +o stop -0
autobusu	auto bus -0	autobus	auto bus -0
bála	bá l -a	bát	bá -t
bázní	bá zn -í	bázeň	bá zeň -0
bahnišť	bahn išť -0	bahniště	bahn išt -ě
bále	bál -e	bál	bál -0
banálními	banál n -ími	banální	banál n -í
banditi	bandit -i	bandita	bandit -a
bankovek	bank ovek -0	bankovka	bank ovk -a
bankrotech	bankrot -ech	bankrot	bankrot -0
barákama	barák -ama	barák	barák -0
barvami	barv -ami	barva	barv -a
básně	básn -ě	báseň	báseň -0
baterkou	bater k -ou	baterka	bater k -a
bažinou	bažin -ou	bažina	bažin -a
bedýnce	bedýn c -e	bedýnka	bedýn k -a
bělocha	běl och -a	běloch	běl och -0
bandža	bandž -a	bendžo	bendž -o
bezdůvodná	bez dů vod n -á	bezdůvodný	bez dů vod n -ý
bezkrevné	bez krev n -é	bezkrevný	bez krev n -ý
nebezpečné	ne bezpeč n é	bezpečný	bezpeč n -ý
běželo	běž e l -o	běžet	běž e -t
bijí	bi j -í	bít	bí -t
bigbítovej	big bít ov -ej	bigbítový	big bít ov -ý
bikinách	bikin -ách	bikiny	bikin -y
blábolíš	blábol í -š	blábolit	blábol i -t
blátem	blát -em	bláto	blát -o
bláznům	blázn -ům	blázen	blázen -0
bláznivého	blázn iv -ého	bláznivý	blázn iv -ý
blíže	blíže	blízko	blíz k -o
nejbližšího	nej bliž š -ího	blízký	blíz k -ý
blížíme	blíž í -me	blížit	blíž i -t
bloků	blok -ů	blok	blok -0
blokovány	blok ová n -y	blokovat	blok ova -t
bludišti	blud išt -i	bludiště	blud iště -0
nebolí	ne bol -í	bolet	bol e -t
bolestí	bol est -í	bolest	bol est -0
bolnému	bol n -ému	bolný	bol n -ý
borku	bork -u	borek	borek -0
borku	bork -u	borka	bork -a
boty	bot -y	bota	bot -a
nebouřím	ne bouř í -m	bouřit	bouř i -t
brácho	brách -o	brácha	brách -a
brambor	brambor -0	brambora	brambor -a
bran	bran -0	brána	brán -a
nebrání	ne brán í -0	bránit	brán i -t
bratry	bratr -y	bratr	bratr -0
bratranci	bratr anc -i	bratranec	bratr anec -0
brejliček	brejl iček -0	brejličky	brejl ičk -y
britští	brit št -í	britský	brit sk -ý
brokátem	broktá -em	brokát	brokát -0
bručí	bruč í -0	bručet	bruč e -t
brýlemi	brýl -emi	brýle	brýl -e
břehové	břeh ov -é	břehový	břeh ov -ý
břichem	břich -em	břicho	břich -o
břišním	břiš n -ím	břišní	břiš n -í
budkám	bud k -ám	budka	bud k -a
bože	bož -e	bůh	bůh -0
bujní	buj n -í	bujný	buj n -ý
bulteriéry	bul teriér -y	bulteriér	bul teriér -0
buňkách	buňk -ách	buňka	buňk -a
nebušilo	ne buš i l -o	bušit	buš i -t
bývá	bý v á -0	bývat	bý v a -t
bydlí	bydl -í	bydlet	bydl e -t
casy	cas -y	casus	cas -us
celou	cel -ou	cela	cel -a
ceníme	cen í -me	cenit	cen i -t
cestuji	cest uj -i	cestovat	cest ova -t
cingrlátek	cingrl átek -0	cingrlátko	cingrl átk -o
cítil	cít i l -0	cítit	cít i -t
necivilizovaná	ne civil izová n -a	civilizovaný	civil izova n -ý
cizinci	ciz inc -i	cizinec	ciz inec -0
cel	cel -0	clo	cl -o
coulem	coul -em	coul	coul -0
courama	cour -ama	coura	cour -a
cucán	cuc á n -0	cucat	cuc a -t
cukaje	cuk aj -e	cukat	cuk a -t
cvakaly	cvak a l -y	cvakat	cvak a -t
cvaklo	cvak l -o	cvaknout	cvak nou -t
čajem	čaj -em	čaj	čaj -0
čarou	čar -ou	čára	čár -a
čeká	ček á -0	čekat	ček a -t
černých	čern -ých	černý	čern -ý
červených	červen -ých	červený	červen -ý
července	červen c -e	červenec	červen ec -0
čeřili	čeř i l -i	čeřit	čeř i -t
cti	ct -i	čest	čest -0
nečetných	ne čet n -ých	četný	čet n -ý
četl	čet l -0	číst	čís -t
nečisté	ne čist -é	čistý	čist -ý
člunů	člun -ů	člun	člun -0
čtvrti	čtvrt -i	čtvrť	čtvrť -0
ďáblem	ďábl -em	ďábel	ďábel -0
dálnici	dál nic -i	dálnice	dál nic -e
darebo	dareb -o	dareba	dareb -a
nedávná	ne dávn -á	dávný	dávn -ý
nedbal	ne db a l -0	dbát	db á -t
nedefinovatelné	ne de fin ova teln -é	definovatelný	de fin ova teln -ý
demoralizuje	de moral iz uje -0	demoralizovat	de moral iz ova -t
dědečka	děd ečk -a	dědeček	děd eček -0
dějů	děj -ů	děj	děj -0
dekách	dek -ách	deka	dek -a
dekádách	dek ád -ách	dekáda	dek ád -a
děkujeme	děk uje -me	děkovat	děk ova -t
děl	děl -0	dělo	děl -o
dělostřelci	děl +o střel c -i	dělostřelec	děl +o střel ec -0
dělníci	děl níc -i	dělník	děl ník -0
deskách	desk -ách	desky	desk -y
destiláty	destil át -y	destilát	destil át -0
deště	dešt -ě	déšť	déšť -0
děvčátku	děvč átk -u	děvčátko	děvč átk -o
děje	děj -e	dít	dí -t
dílky	díl k -y	dílek	díl ek -0
dírách	dír -ách	díra	dír -a
dírkou	dír k -ou	dírka	dír k -a
nedívám	ne dív á -m	dívat	dív a -t
divíte	div í -te	divit	div i -t
dívek	dív ek -0	dívka	dív k -a
divoši	div oš -i	divoch	div och -0
dlel	dl e l -0	dlít	dl í -t
dlani	dlan -i	dlaň	dlaň -0
dlážce	dláž c -e	dlážka	dláž k -a
dlouhé	dlouh -é	dlouhý	dlouh -ý
dlužíme	dluž í -me	dlužit	dluž i -t
dlužen	dluž en -0	dlužný	dluž n -ý
dně	dn -ě	dno	dn -o
dneška	dneš k -a	dnešek	dneš ek -0
dnešního	dneš n -í	dnešní	dneš n -í
dobyli	do by l -i	dobýt	do bý -t
dobytka	do byt k -a	dobytek	do byt ek -0
dočkáte	do čk á -te	dočkat	do čk a -t
dodány	do d á n -y	dodat	do d a -t
dohlídne	do hlíd ne -0	dohlédnout	do hléd nou -t
nedohoní	ne do hon í -0	dohonit	do hon i -t
dojmy	do jm -y	dojem	do jem -0
dojedl	do jed l -0	dojíst	do jís -t
dokonalému	do kon a l -ému	dokonalý	do kon a l -ý
dolezl	do lez l -0	dolézt	do léz -t
domyslili	do mysl i l -i	domyslet	do mysl e -t
doneste	do nes -te	donést	do nés -t
donutím	do nut í -m	donutit	do nut i -t
dopadla	do pad l -a	dopadnout	do pad nou -t
nedopracovali	ne od prac ova l -i	dopracovat	do prac ova -t
nedopřávalo	ne do přá v a l -o	dopřávat	do přá v a -t
doslechli	do slech l -i	doslechnout	do slech nou -t
dostávám	do stá v á -m	dostávat	do stá v a -t
dostizích	do stiz -ích	dostih	do stih -0
dostrkali	do strk a l -i	dostrkat	do strk a -t
dotknul	do tk nu l -0	dotknout	do tk nou -t
nedotýká	ne do týk á -0	dotýkat	do týk a -t
dovedla	do ved l -a	dovést	do vés -t
dovezeme	do vez e -me	dovézt	do véz -t
dovolíte	do vol í -te	dovolit	do vol i -t
dovoluji	do vol uj -i	dovolovat	do vol ova -t
nedozví	ne do z v -í	dozvědět	do z věd ě -t
dozněl	do zn ě l -0	doznít	do zn í -t
dožili	do ži l -i	dožít	do ží -t
dobré	dobr -é	dobrá	dobr -á
doktore	doktor -e	doktor	doktor -0
doufám	douf á -m	doufat	douf a -t
doupaty	doup at -y	doupě	doup -ě
douškem	douš k -em	doušek	douš ek -0
dral	dr a l -0	drát	dr á -t
nejdražší	nej draž š í	drahý	drah -ý
drahoušku	drah ouš k -u	drahoušek	drah ouš ek -0
dramatu	dram at -u	drama	dram -a
drmolí	drmol -í	drmolit	drmol i -t
drobečky	drob eč k -y	drobeček	drob eč ek -0
drobnější	drob n ějš -í	drobný	drob n -ý
drobností	drob n ost -í	drobnost	drob n ost -0
drožkáři	drožk ář -i	drožkář	drožk ář -0
dřel	dř e l -0	dřít	dř í -t
důležitosti	dů lež it ost -i	důležitost	dů lež it ost -0
důrazností	dů raz n ost -í	důraznost	dů raz n ost -0
důstojníci	dů stoj n íc -i	důstojník	dů stoj n ík -0
důvěrném	dů věr n -ém	důvěrný	dů věr n -ý
nedůvěřuje	ne dů věř uje -0	důvěřovat	dů věř ova -t
dunivého	nud iv -ého	dunivý	dun iv -ý
dveří	dveř -í	dveře	dveř -e
dvířek	dvíř ek -0	dvířka	dvíř k -a
dýmkou	dýmk -ou	dýmka	dým k -a
džbánem	džbán -em	džbán	džbán -0
ech	ech -0	echo	ech -o
ekologům	eko log -ům	ekolog	eko log -0
nejelegantnější	nej elegant n ějš -í	elegantní	elegant n -í
epicentru	epi centr -u	epicentrum	epi centr -um
epoše	epoš -e	epocha	epoch -a
es	es -0	eso	es -o
estrádního	estrád n -ího	estrádní	estrád n -í
etatismu	etat ism -u	etatismus	etat ism -us
exponují	ex pon uj -í	exponovat	ex pon ova -t
exponovaném	ex pon ova n -ém	exponovaný	ex pon ova n -ý
existuje	exist uje -0	existovat	exist ova -t
tajze	tajz -e	tajga	fajg -a
fakta	fakt -a	faktum	fakt -um
nefalšované	ne falš ova n -é	falšovaný	falš ova n -ý
faraónova	faraón ov -a	faraónův	faraón ův -0
nefasuje	ne fas uje -0	fasovat	fas ova -t
fazolích	fazol -ích	fazole	fazol -e
filozofií	fil +o zofi -í	filozofie	fil +o zofi -e
filosof	fil o sof -0	filozof	fil o zof -0
filipa	filip -a	filip	filip -0
finančníka	finanč ník -a	finančník	finanč ník -0
floka	flok -a	flok	flok -0
neformální	ne form ál n -í	formální	form ál n -í
fotbale	fot bal -e	fotbal	fot bal -0
fotografická	foto graf ick -á	fotografický	foto graf ick -ý
guerille	guerill -e	gerila	geril -a
gestem	gest -em	gesto	gest -o
golfoví	golf ov -í	golfový	golf ov -ý
gramodesce	gram +o desc -e	gramodeska	gram +o desk -a
gratuluju	gratul uj -u	gratulovat	gratul ova -t
nehnul	ne h nu l -0	hnout	h nou -t
háčkem	háč k -em	háček	háč ek -0
hádám	hád á -m	hádat	hád a -t
halou	hal -ou	hala	hal -a
havrani	havran -i	havran	havran -0
házíš	ház í -š	házet	ház e -t
helmách	helm -ách	helma	helm -a
herečku	her eč k -u	herečka	her eč k -a
hladí	hlad í -0	hladit	hlad i -t
nehladověli	ne hlad ov ě l -i	hladovět	hlad ov ě -t
hlasům	hlas -ům	hlas	hlas -0
nehlásili	ne hlás i l -i	hlásit	hlás i -t
hláskám	hlás k -ám	hláska	hlás k -a
hlavou	hlav -ou	hlava	hlav -a
hlavní	hlav n -í	hlaveň	hlav eň -0
hlavních	hlav n -ích	hlavní	hlav n -í
nehledal	ne hled a l -0	hledat	hled a -t
hledaného	hled a n -ého	hledaný	hled a n -ý
hledí	hled í -0	hledět	hled ě -t
hloupé	hloup -é	hloupý	hloup -ý
hlubší	hlub š -í	hluboký	hlub ok -ý
hlučnej	hluč n -ej	hlučný	hluč n -ý
hlupáci	hlup ác -i	hlupák	hlup ák -0
hmot	hmot -0	hmota	hmot -a
hnalo	hn a l -o	hnát	hn á -t
hnusí	hnus í -0	hnusit	hnus i -t
hodily	hod i l -y	hodit	hod i -t
hoden	hod en -0	hodný	hod n -ý
hodinek	hodin ek -0	hodinky	hodin k -y
nehodlám	ne hodl á -m	hodlat	hodl a -t
hoši	hoš -i	hoch	hoch -0
holeně	hol en -ě	holeň	hol eň -0
honičce	hon i čc -e	honička	hon i čk -a
horách	hor -ách	hora	hor -a
horečce	hor eč c -e	horečka	hor eč k -a
horkém	hor k -ém	horký	hor k -ý
horši	hor š	horšit	hor š i -t
hoří	hoř í -0	hořet	hoř e -t
hořkosti	hořk ost -i	hořkost	hořk ost -0
hospodyni	hospod yn -i	hospodyně	hospod yn -ě
hostincem	hostin c -em	hostinec	host in ec -0
hotových	hotov -ých	hotový	hotov -ý
houpačce	houp a čc -e	houpačka	houp a čk -a
houště	houště	houšť	houšť
hře	hř -e	hra	hr -a
hrála	hrá l -a	hrát	hrá -t
hrachu	hrach -u	hrách	hrách -0
hrbáčovu	hrb áč ov -u	hrbáčův	hrb áč ův -0
hrbí	hrb í -0	hrbit	hrb i -t
hrkne	hrk ne -0	hrknout	hrk nou -t
hrobě	hrob -ě	hrob	hrob -0
hrobníkovy	hrob ník ov -y	hrobníkův	hrob ník ův -0
hrstě	hrst -ě	hrst	hrst -0
hrudi	hrud -i	hruď	hruď -0
hrůzou	hrůz -ou	hrůza	hrůz -a
hřbitově	hřbitov -ě	hřbitov	hřbitov -0
hřebce	hřeb c -e	hřebec	hřeb ec -0
hříchů	hřích -ů	hřích	hřích -0
hřmí	hřm í -0	hřmít	hřm í -t
hučí	huč í -0	hučet	huč e -t
hudebními	hud eb n -ími	hudební	hud eb n -í
hustého	hust -ého	hustý	hust -ý
hutnější	hutn ějš -í	hutný	hutn -ý
hvězdopravci	hvězd +o prav c -i	hvězdopravec	hvězd +o prav ec -0
hvězdiček	hvězd iček -0	hvězdička	hvězd ičk -a
nehýbá	ne hýb á -0	hýbat	hýb a -t
nechápal	ne cháp a l -0	chápat	cháp a -t
chapadly	chap a dl -y	chapadlo	chap a dl -o
chlapa	chlap -0	chlap	chlap -0
chlapce	chlap c -e	chlapec	chlap ec -0
chlápka	chláp k -a	chlápek	chláp ek -0
chodíš	chod í -š	chodit	chod i -t
chodidly	chod i dl -y	chodidlo	chod i dl -o
chodníkům	chod ník -ům	chodník	chod ník -0
chotí	chot -í	choť	choť -0
chovány	chov á n -y	chovat	chov a -t
chtěnej	cht ě n -ej	chtěný	cht ě n -ý
chytrá	chytr -á	chytrý	chtr -ý
chudší	chud š -í	chudý	chud -ý
chudáci	chud ác -i	chudák	chud ák -0
nechutnalo	ne chut n a l -o	chutnat	chut n a -t
chůzí	chůz -í	chůze	chůz -e
chvěly	chvě l -y	chvět	chvě -t
chvěním	chvě n -ím	chvění	chvě n -í
chvilku	chvil k -u	chvilka	chvil k -a
chyb	chyb -0	chyba	chyb -a
chybějí	chyb ěj -í	chybět	chyb ě -t
nechybí	ne chyb í -0	chybit	chyb i -t
chýší	chýš -í	chýše	chýš -e
chyťte	chyť -te	chytit	chyt i -t
intelektuálskejma	intelekt uál sk ej ma	intelektuálský	intelekt uál sk -ý
jabloní	jabl on -í	jabloň	jabl oň -0
jablek	jablek -0	jablko	jablk -o
jadrnějšího	jadr n ějš -ího	jadrný	jadr n -ý
jaktěživo	jak tě živ -o	jaktěživ	jak tě živ -0
jalovic	jalov ic -0	jalovice	jalov ic -e
jarmarce	jarmarc -e	jarmark	jarmark -0
jazyka	jazyk -a	jazyk	jazyk
jazyková	jazyk ov -á	jazykový	jazyk ov -ý
jedináčci	jedin áčc -i	jedináček	jedin áček -0
jednodušší	jedn +o duš š -í	jednoduchý	jedn +o duch -ý
jednotlivce	jedn ot liv c -e	jednotlivec	jedn ot liv ec -0
jezera	jezer -a	jezero	jezer -o
jídlem	jí dl -em	jídlo	jí dl -o
jedla	jed l -a	jíst	jís -t
jiskří	jiskř í -0	jiskřit	jiskř i -t
jmenujete	jmen uje -te	jmenovat	jmen ova -t
judy	jud -y	judo	jud -o
kacíře	kacíř -e	kacíř	kacíř -0
kadidly	kad i dl -y	kadidlo	kad i dl -o
kakaovém	kaka ov -ém	kakaový	kaka ov -ý
kamarádem	kamarád -em	kamarád	kamarád -0
kamélií	kaméli -í	kamélie	kaméli -e
kamenů	kamen -ů	kámen	kámen -0
kamen	kamen -0	kamna	kamn -a
kápne	káp ne -0	kápnout	káp nou -t
kapesníčku	kapes níč k -u	kapesníček	kapes níč ek -0
kapitalismu	kapital ism -u	kapitalismus	kapital ism -us
kapitáne	kapitán -e	kapitán	kapitán -0
kapitánově	kapitán ov -ě	kapitánův	kapitán ův -0
kapitol	kapitol -0	kapitola	kapitol -a
kaplanovy	kapl an ov -y	kaplanův	kapl an -ův
kaplanovi	kaplan -ovi	kaplan	kaplan -0
kapsičky	kaps ičk -y	kapsička	kaps ičk -a
kávu	káv -u	káva	káv -a
kdekoliv	kde koliv	kdekoli	kde koli
kdykoliv	kdy koliv	kdykoli	kdy koli
kecáš	kec á -š	kecat	kec a -t
keřů	keř -ů	keř	keř -0
kině	kin -ě	kino	kin -o
klackem	klack -em	klacek	klacek -0
klapne	klap ne -0	klapnout	klap nou -t
klenuly	kle nu l -y	klenout	kle nou -t
klečí	kleč í -0	klečet	kleč e -t
neklepali	ne klep a l -i	klepat	klep a -t
klíče	klíč -e	klíč	klíč -0
klidná	klid n -á	klidný	klid n -ý
klína	klín -a	klín	klín -0
kloakách	kloak -ách	kloaka	kloak -a
kloužou	klouž ou -0	klouzat	klouz a -t
knihovny	knih ovn -y	knihovna	knih ovn -a
knížete	kníž et -e	kníže	kníž -e
knížkách	kníž k -ách	knížka	kníž k -a
kňučí	kňuč í -0	kňučet	kňuč e -t
koberci	koberc -i	koberec	koberec -0
kojence	koj en c -e	kojenec	koj en ec -0
kojné	koj n -é	kojná	koj n -á
kokosky	kokos k -y	kokoska	kokos k -a
kolegyní	koleg yn -í	kolegyně	koleg yn -ě
koleje	kolej -e	kolej	kolej -0
komoře	komoř -e	komora	komor -a
komunistickej	komun ist ick -ej	komunistický	komun ist ick -ý
nekonečně	ne koneč n -ě	konečně	koneč n -ě
konkurz	konkurz -0	konkurs	konkurs -0
konšelé	konšel -é	konšel	konšel -0
kopancům	kop anc -ům	kopanec	kop anec -0
koryty	koryt -y	koryto	koryt -o
koštěte	košt ět -e	koště	košt -ě
koukej	kouk ej -0	koukat	kouk a -t
kouknu	kouk n -u	kouknout	kouk nou -t
koupí	koup í -0	koupě	koup -ě
kup	kup -0	koupit	koup i -t
kouše	kouš e -0	kousat	kous a -t
kouta	kout -a	kout	kout -0
koutcích	kout c -íc	koutek	kout ek -0
kovovou	kov ov -ou	kovový	kov ov -ý
koze	koz -e	koza	koz -a
kožichu	kožich -u	kožich	kožich -0
kráčejíce	kráč ej íc -e	kráčet	kráč e -t
kraji	kraj -i	kraj	kraj -0
krámku	krám k -u	krámek	krám ek -0
kradl	krad l -0	krást	krás -t
krásnou	krás n -ou	krásný	krás n -ý
krášlicích	krášl ic -ích	krášlicí	kráš l ic -í
krátkými	krát k -ý	krátký	krát k -ý
kráteru	kráter -u	kráter	kráter -0
krbem	krb -em	krb	krb -0
kriteriích	kritéri -ích	kritérium	kritéri -um
kručí	kruč í -0	kručet	kruč e -t
kryli	kry l -i	krýt	krý -t
křehká	křeh k -á	křehký	křeh k -ý
křičí	křič í -0	křičet	křič e -t
křídla	křídl -a	křídlo	křídl -o
křísla	křís l -a	křísnout	křís nou -t
křivkách	křiv k -ách	křivka	křiv k -a
křížku	kříž k -u	křížek	kříž ek -0
křižovatce	křiž ovat c -e	křižovatka	křiž ovat k -a
kulometného	kul +o met n -ého	kulometný	kul +o met n -ý
kultivovanější	kultiv ova n ějš -í	kultivovaný	kultiv ova n -ý
koní	kon -í	kůň	kůň -0
kupu	kup -u	kupa	kup -a
kupují	kup uj -í	kupovat	kup ova -t
kurzech	kurz -ech	kurs	kurs -0
kuřat	kuř at -0	kuře	kuř -e
nekuřáckého	ne kuř áck -ého	kuřácký	kuř ác k -ý
kůži	kůž -i	kůže	kůž -e
kvetly	kvet l -y	kvést	kvés -t
kyčli	kyčl -i	kyčel	kyčel -0
kymácejíce	kymác ej íc -e	kymácet	kymác e -t
kysely	kysel -y	kyselo	kysel -o
kývl	kýv l -0	kývnout	kýv nou -t
nejlacinější	nej lac in ějš -í	laciný	lac in -ý
láhve	láhv -e	láhev	láhev -0
lajdáky	lajd ák -y	lajdák	lajd ák -0
lamp	lamp -0	lampa	lamp -a
lásko	lásk -o	láska	lásk -a
lehla	leh l -a	lehnout	le nou -t
lebkou	lebk -ou	lebka	leb k -a
ledovým	led ov -ým	ledový	led ov -ý
lehkomyslnější	lehk +o mysl n ějš -í	lehkomyslný	lehk +o mysl n -ý
lejnem	lejn -em	lejno	lejn -o
lekla	lek l -a	leknout	lek nou -t
lenoši	len oš -i	lenoch	len och -0
lese	les -e	les	les -0
leskly	lesk l -y	lesknout	lesk nou -t
letadel	let a del -0	letadlo	let a dl -o
letíš	let í -š	letět	let ě -t
leteckých	let ec k -ých	letecký	let ec k -ý
lvům	lv -ům	lev	lev -0
lezu	lez u -0	lézt	léz -t
lži	lž -i	lež	lež -0
leží	lež í -0	ležet	lež e -t
nelhal	ne lh a l -0	lhát	lh á -t
lil	li l -0	lít	lí -t
libovolných	lib +o vol n -ý	libovolný	lib +o vol n -ý
líbila	líb i l -a	líbit	líb i -t
líbnul	líb nu l -0	líbnout	líb nou -t
liber	liber -0	libra	libr -a
lihem	lih -em	líh	líh -0
límečkem	lím eč k -em	límeček	límeč ek -0
lince	lin c -e	linka	lin k -a
linoucího	lin ouc -ího	linoucí	lin ouc -í
lístečcích	líst ečc -ích	lísteček	líst eček -0
lístků	líst k -ů	lístek	líst ek -0
lítostí	lít ost -í	lítost	lít ost -0
nelituje	ne lit uje -0	litovat	lit ova -t
lodi	lod -i	loď	loď -0
loktem	lokt -em	loket	loket -0
lokýtky	lokýt k -y	lokýtek	lokýt ek -0
lomcuje	lomc uje -0	lomcovat	lomc ova -t
loňsku	loň sk -u	loňsko	loň sk -o
lovci	lov c -i	lovec	lov ec -0
loveckou	lov ec k -ou	lovecký	lov ec k -ý
ložem	lož -em	lože	lož -e
lóži	lóž -i	lóže	lóž -e
ložnicí	lož nic -í	ložnice	lož nic -e
lpíme	lp í -me	lpět	lp ě -t
lůžku	lůž k -u	lůžko	lůž k -o
lžíci	lžíc -i	lžíce	lžíc -e
nemá	ne m á -0	mít	m í -t
míváš	m í v á -š	mívat	m í v a -t
mnul	m nu l -0	mnout	m nou -t
magazínech	magazín -ech	magazín	magazín -0
mami	mam i	máma	mám -a
maminko	mam ink -o	maminka	mam ink -a
mamutími	mamut -ími	mamutí	mamut -í
maniokoví	maniok ov -í	maniokový	maniok ov -ý
manšestrovém	manšestr ov -ém	manšestrový	manšestr ov -ý
manželé	manžel -é	manžel	manžel -0
nemanželská	ne manžel sk -á	manželský	manžel sk -ý
manželovy	manžel ov -y	manželův	manžel ův -0
manžílka	manžíl k -a	manžílek	manžíl ek -0
mariana	maria n -a	marianum	maria n -um
marek	marek -0	marka	mark -a
masky	mask -y	maska	mask -a
mašlí	mašl -í	mašle	mašl -e
mávli	máv l -i	mávnout	máv nou -t
nemazlí	ne maz l í	mazlit	mazl i -t
medajli	medajl -i	medaile	medail -e
meditačního	medit ač n -ího	meditační	medit ač n -í
medvídcích	medvíd c -ích	medvídek	medvíd ek -0
mechem	mech -em	mech	mech -0
mejdanech	mejdan -ech	mejdan	mejdan -0
měnilo	měn i l -o	měnit	měn i -t
mentalitou	mental it -ou	mentalita	mental it -a
měř	měř -0	měřit	měř i -t
města	měst -a	město	měst -o
městečku	měst ečk -u	městečko	měst ečk -o
metry	metr -y	metr	metr -0
minula	mi nu l -a	minout	mi nou -t
mihl	mih l -0	mihnout	mih nou -t
míchá	mích á -0	míchat	mích a -t
mil	mil -0	míle	míl -e
milí	mil -í	milý	mil -ý
nemilosrdně	ne mil +o srd n -ě	milosrdně	mil +o srd n -ě
miláčku	mil áčk -u	miláček	mil áček -0
milence	mil en c -e	milenec	mil en ec -0
milostpaničky	mil ost -0 pan ičk -y	milostpanička	mil ost -0 pan ičk -a
nemiluje	ne mil uje -0	milovat	mil ova -t
mínění	mín ěn -í	míněný	mín ěn -ý
ministře	ministř -e	ministr	ministr -0
ministrova	ministr ov -a	ministrův	ministr ův -0
minut	minut -0	minuta	minut -a
mírou	mír -ou	míra	mír -a
miř	miř -0	mířit	míř i -t
místečka	míst ečk -a	místečko	míst ečk -o
místního	míst n -í	místní	míst n -í
místnosti	míst n ost -i	místnost	míst n ost -0
mizině	miz in -ě	mizina	miz in -a
mizerným	mizer n -ým	mizerný	mizer n -ý
mlela	ml e l -a	mlít	ml í -t
mlčel	mlč e l -0	mlčet	mlč e -t
mléčném	mléč n -ém	mléčný	mléč n -ý
mlékem	mlék -em	mléko	mlék -o
mloci	mloc -i	mlok	mlok -0
mniši	mniš -i	mnich	mnich -0
mnoha	mnoh -a	mnoho	mnoh -o
módy	mód -y	móda	mód -a
modrých	modr -ých	modrý	modr -ý
mola	mol -a	molo	mol -o
morganovým	morgan ov -ým	morganův	morgan ův -0
morseovce	morse ov k -a	morseovka	morse ov k -a
moři	moř -i	moře	moř -e
motivován	motiv ová n -0	motivovat	motiv ova -t
motýlků	motýl k -ů	motýlek	motýl ek -0
mozku	mozk -u	mozek	mozek -0
mrtvol	mrt v ol -0	mrtvola	mrt v ol -a
mrtev	mrtev -0	mrtvý	mrtv -ý
mudrcové	mudr c -ové	mudrc	mudr c -0
muklům	mukl -ům	mukl	mukl -0
mumii	mumi -i	mumie	mumi -e
mundúrech	mundúr -ech	mundúr	mundúr -0
musel	mus e l -0	muset	mus e -t
mýlí	mýl -í	mýlit	mýl i -t
myslí	mysl í -0	mysl	mysl -0
nabízej	na bíz ej -0	nabízet	na bíz e -t
nabere	na ber e -0	nabrat	na br a -t
nabyla	na by l -a	nabýt	na bý -t
nacvičováno	na cvič ová n -o	nacvičovat	na cvič ova -t
naději	na děj -i	naděje	na děj -e
nádražního	ná draž n -í	nádražní	ná draž n -í
nadýchl	na dých l -0	nadýchnout	na dých nou -t
nahlíží	na hlíž í -0	nahlížet	na hlíž e -t
nahrnuli	na hr nu l -i	nahrnout	na hr nou -t
našel	na š e l -0	najít	na j í -t
najede	na jed e -0	najet	na je -t
najím	na jí -m	najíst	na jís -t
náklady	ná klad -y	náklad	ná klad -0
nakládají	na klád aj -í	nakládat	na klád a -t
naklonila	na klon i l -a	naklonit	na klon i -t
nalito	na l i t -o	nalít	na l í -t
nalakovaných	na lak ova n -ých	nalakovaný	na lak ova n -ý
nalehli	na leh l -i	nalehnout	na leh nou -t
nalezena	na lez en -a	nalézt	na léz -t
námahou	ná mah -ou	námaha	ná mah -a
namáháte	na máh á -te	namáhat	na máh a -t
náměstka	ná měst k -a	náměstek	ná měst ek -0
namířeno	na míř en -o	namířit	na míř i -t
nenápadně	ne ná pad n -ě	nápadně	ná pad n -ě
napadlo	na pad l -o	napadnout	na pad nou -t
napíná	na pín á -0	napínat	na pín a -t
napínáky	na pín ák -y	napínák	na pín ák -0
napjatýma	na pj a t -ýma	napjatý	na pj a t -ý
napomenula	na po me nu l -a	napomenout	na po me nou -t
nenapovídalo	ne na po víd a l -o	napovídat	na po víd a -t
náramkem	ná ram k -em	náramek	ná ram ek -0
naráží	na ráž í -0	narážet	na ráž e -t
národům	ná rod -ům	národ	ná rod -0
národního	ná rod n -ího	národní	ná rod n -í
nenarozené	ne na roz en -é	narozený	na roz en -ý
narozeninám	na roz en in -ám	narozeniny	na roz en in -y
narostly	na rost l -y	narůst	na růs -t
nenarušil	ne na ruš i l -0	narušit	na ruš i -t
nařizují	na řiz uj -í	nařizovat	na řiz ova -t
nasedli	na sed l -i	nasednout	na sed nou -t
naslouchají	na slouch aj -í	naslouchat	na slouch a -t
nastanou	na sta n ou -0	nastat	na sta -t
nastrkáme	na strk á -me	nastrkat	na strk a -t
nastupuje	na stup uje -0	nastupovat	na stup ova -t
natáhl	na táh l -0	natáhnout	na táh nou -t
natírají	na tír aj -í	natírat	na tír a -t
natřena	na tř e n -a	natřít	na tř í -t
natřásalo	na třás a l -o	natřásat	na třás a -t
nenaučil	ne na uč i l -0	naučit	na uč i -t
nevídanou	ne víd a n -ou	nevídaný	na víd a n -ý
nenavrhuje	ne na vrh uje -0	navrhovat	na vrh ova -t
návršíčku	ná vrš íčk -u	návršíčko	ná vrš íčk -o
nazul	na zu l -0	nazout	na zou -t
nacismu	nac ism -u	nacismus	nac ism -us
nadnese	nad nes -e	nadnést	nad nés -t
nadporučíkovou	nad po ruč ík ov -ou	nadporučíková	nad po ruč ík ov -á
nadzvedávaje	nad z ved á v aj -e	nadzvedávat	nad z ved á v a -t
nahá	nah -á	nahý	nah -ý
návštěvě	návštěv -ě	návštěva	návštěv -a
navštívíme	navštív í -me	navštívit	navštív i -t
nedávnem	ne dávn -em	nedávno	ne dávn -o
nechutí	ne chut -í	nechuť	ne chuť -0
nemluvňat	ne mluv ň at -0	nemluvně	ne mluv n -ě
nemocnici	ne moc nic -e	nemocnice	ne moc nic -e
nenapravitelně	ne na prav i teln -ě	nenapravitelně	ne na prav i teln -ě
nepaměti	ne pamět -i	nepaměť	ne paměť -0
nespokojeností	ne s po koj en ost -í	nespokojenost	ne s po koj en ost -0
nezvyklými	ne z vyk l -ými	nezvyklý	ne z vyk l -ý
nebi	neb -i	nebe	neb -e
nehty	neht -y	nehet	nehet -0
nechává	nech á v á -0	nechávat	nech á v a -t
německému	něm ec k ému	německý	něm ec k -ý
nesl	nes l -0	nést	nés -t
nešporech	nešpor -ech	nešpory	nešpor -y
netopýři	netopýř -i	netopýr	netopýr -0
ničím	nič -ím	nic	nic -0
ničíc	nič íc -0	ničit	nič i -t
níž	níž	nízko	níz k -o
noci	noc -i	noc	noc -0
nočnímu	noč n -ímu	noční	noč n -í
nohy	noh -y	noha	noh -a
normě	norm -ě	norma	norm -a
nosů	nos -ů	nos	nos -0
nenoste	ne nos -te	nosit	nos i -t
novinama	novin -ama	noviny	nov in -y
novel	novel -0	novela	novel -a
nozdrám	nozdr -ám	nozdra	nozdr -a
nenutím	ne nut í -m	nutit	nut i -t
nutno	nut n -o	nutný	nut n -ý
nožem	nož -em	nůž	nůž -0
obalech	o bal -ech	obal	o bal -0
obálce	o bál c -e	obálka	o bál k -a
obydli	o bydl -i	obydlet	o bydl e -t
obývacího	o býv ac -ího	obývací	o býv ac -í
oceňován	o ceň ová n -0	oceňovat	o ceň ova -t
očekáváte	o ček á v á -te	očekávat	o ček á v a -t
neočekávaně	ne o ček á v a n -ě	očekávaně	o ček á v a n -ě
odřel	o dř e l -0	odřít	o dř í -t
ohlásím	o hlás í -m	ohlásit	o hlás i -t
neohlédla	ne o hléd l -a	ohlédnout	o hléd nou -t
neohrabané	ne o hrab a n -é	ohrabaný	o hrab a n -ý
ohromena	o hrom en -a	ohromit	o hrom i -t
ochabuje	o chab uje -0	ochabovat	o chab ova -t
neochotně	ne o chot n -ě	ochotně	o chot n -ě
ochraptělí	o chrapt ě l -í	ochraptělý	o chrapt ě l -ý
neokázalou	ne o káz a l -ou	okázalý	o káz a l -ý
okupována	o kup ová n -a	okupovat	o kup ova -t
neomezenou	ne o mez en -ou	omezený	o mez en -ý
omítce	o mít c -e	omítka	o mít k -a
omlouvám	o mlouv á -m	omlouvat	o mlouv a -t
opatrného	o patr n -ého	opatrný	o patr n -ý
opilí	o pi l -í	opilý	o pi l -ý
opouštěl	o poušt ě l -0	opouštět	o poušt ě -t
opřela	o př e l -a	opřít	o př í -t
opustíš	o pust í -š	opustit	o pust i -t
osamocena	o sam oc en -a	osamocený	o sam oc en -ý
neoslovila	ne o slov i l -a	oslovit	o slov i -t
osobě	o sob -ě	osoba	o sob -a
osvícenosti	o svíc en ost -i	osvícenost	o svíc en ost -0
osvícen	o svíc en -0	osvítit	o svít i -t
osvobodí	o svobod í -0	osvobodit	o svobod i -t
ošetřovně	o šetř ov n -ě	ošetřovna	o šetř ov n -a
otočily	o toč i l -y	otočit	o toč i -t
otýpkami	o týp k -ami	otýpka	o týp k -a
ověřte	o věř -te	ověřit	o věř i -t
ovládá	o vlád á -0	ovládat	o vlád a -t
neovládl	ne o vlád l -0	ovládnout	o vlád nou -t
ozářeno	o zář en -o	ozářit	o zář i -t
ozvalo	o zv a l -o	ozvat	o zv a -t
obcházeje	ob cház ej -e	obcházet	ob cház e -t
obchodního	ob chod n -ího	obchodní	ob chod n -í
obchodníci	ob chod níc -i	obchodník	ob chod ník -0
obchodníkovo	ob chod ník ov -o	obchodníkův	ob chod ník ův -0
objevují	ob jev uj -í	objevovat	ob jev ova -t
oblékla	ob lék l -a	obléci	ob léc -i
neoblečená	ne ob leč en -á	oblečený	ob leč en -ý
oblékla	ob lék l -a	obléknout	ob lék nou -t
oblohy	ob loh -y	obloha	ob loh -a
obležen	ob lež en -0	oblehnout	ob měn -a
obměn	ob měn -0	obměna	ob měn -a
obrací	ob rac í -0	obracet	ob rac e -t
obrácena	ob rác en -a	obrátit	ob rát i -t
obrazy	ob raz -y	obraz	ob raz -0
obrazců	ob raz c -ů	obrazec	ob raz ec -0
neobstálo	ne ob stá l -o	obstát	ob stá -t
obšírnějšího	ob šír n -ějš -ího	obšírný	ob šír n -ý
obtíže	ob tíž -e	obtíž	ob tíž -0
obyčejné	obyčej n -é	obyčejný	ob yčej n -ý
objal	obj a l -0	obejmout	obe j mou -t
oběda	oběd -a	oběd	oběd -0
obohacen	o bohac en -0	obohatit	obohat i -t
ocáskem	ocás k -em	ocásek	ocás ek -0
očku	oč k -u	očko	oč k -o
odbyla	od by l -a	odbýt	od bý -t
oddechli	od dech l -i	oddechnout	od dech nou -t
odhodlána	od hodl á n -a	odhodlat	od hodl a -t
odcházela	od cház e l -a	odcházet	od cház e -t
odlišnému	od liš n -ému	odlišný	od liš n -ý
odmítla	od mít l -a	odmítnout	od mít nou -t
odnesli	od nes l -i	odnést	od nés -t
odpínaje	od pín aj -e	odpínat	od pín a -t
odpluje	od plu je -0	odplout	od plou -t
odpočinu	od po či -nu	odpočinout	od po či nou -t
odpovězte	od po věz -te	odpovědět	od po věd ě -t
neodpovídalo	ne od po víd a l -o	odpovídat	od po víd a -t
odpočivadle	od poč i v a dl -e	odpočivadlo	od poč i v a dl -o
odpráskli	od prásk l -i	odprásknout	od prásk nou -t
odpusťte	od pusť -te	odpustit	od pust i -t
odradilo	od rad i l -o	odradit	od rad i -t
odrodilců	od rod i l c -ů	odrodilec	od rod i l ec -0
vodsaď	vod saď	odsaď	od saď
odstraněn	od stran ěn -0	odstranit	od stran i -t
odsunuty	od su nu t -y	odsunout	od su nou -t
odsuzuji	od suz uj -i	odsuzovat	od suz ova -t
odtáhne	od táh ne -0	odtáhnout	od táh nou -t
neodvážil	ne od váž i l -0	odvážit	od váž i -t
odvažuješ	od važ uje -š	odvažovat	od važ ova -t
odvedl	od ved l -0	odvést	od vés -t
odvezl	od vez l -0	odvézt	od vét -z
odvrací	od vrac í -0	odvracet	od vrac e -t
odvrácena	od vrác en -a	odvrátit	od vrát i -t
odvrhne	od vrh ne -0	odvrhnout	od vrh nou -t
odepřeno	ode př e n -o	odepřít	ode př í -t
odeslán	ode sl á n -0	odeslat	ode sl a -t
odevzdám	ode vz d á -m	odevzdat	ode vz d a -t
okénkem	okén k -em	okénko	okén k -o
okny	okn -y	okno	okn -o
opakuji	o pak uj -i	opakovat	opak ova -t
opatova	opat ov -a	opatův	opat ův -0
opětovném	opět ov n -ém	opětovný	opět ov n -ý
neořou	ne oř ou -0	orat	or a -t
oranžistů	oranž ist -ů	oranžista	oranž ist -a
orgasmus	orgasm -us	orgazmus	orgazm -us
oslové	osl -ové	osel	osel -0
otevřely	ote vř e l -y	otevřít	ote vř í -t
otče	otč -e	otec	otec -0
otrokům	otrok -ům	otrok	otrok -0
otrokyni	otrok yn -i	otrokyně	otrok yn -ě
pakoní	pa kon -í	pakůň	pa kůň -0
pacientkám	pacient k -ám	pacientka	pacient k -a
padlo	pad l -o	padnout	pad nou -t
palmama	palm -ama	palma	palm -a
pamatuj	pamat uj -0	pamatovat	pamat ova -t
paměti	pamět -i	paměť	paměť -0
panáčkují	pan áč k uj -í	panáčkovat	pan áč k ova -t
pámbů	pámbů	pánbůh	pán bůh
papíru	papír -u	papír	papír -0
párky	pár k -y	párek	pár ek -0
parapetu	parapet -u	parapet	parapet -0
partneři	partneř -i	partner	partner -0
pásci	pásc -i	pásek	pásek -0
patách	pat -ách	pata	pat -a
patře	patř -e	patro	patr -o
patroni	patr on -i	patron	patr on -0
pavlačí	pavlač -í	pavlač	pavlač -0
pavoučci	pavouč c -i	pavouček	pavouč ek -0
pavouci	pavouc -i	pavouk	pavouk -0
paží	paž -í	paže	paž -e
pecí	pec -í	pec	pec -0
pečlivostí	peč liv ost -í	pečlivost	peč liv ost -0
pěchotnímu	pěch ot n -ímu	pěchotní	pěch ot n -í
péra	pér -a	pero	per -o
perutě	perut -ě	peruť	peruť -0
psa	ps -a	pes	pes -0
pevností	pevn ost -í	pevnost	pevn ost -0
pije	pi je -0	pít	pí -t
pinčlové	pinčl -ové	pinčl	pinčl -0
pistoli	pistol -i	pistole	pistol -e
pitomej	pitom -ej	pitomý	pitom -ý
piva	piv -a	pivo	piv -o
plála	pl á l -a	planout	pla nou -t
plácky	plác k -y	plácek	plác ek -0
neplacení	ne plac en -í	placený	plac en -ý
plácli	plác l -i	plácnout	plác nou -t
nepláče	ne pláč e -0	plakat	plak a -t
neplánoval	ne plán ova l -0	plánovat	plán ova -t
plastiku	plast ik -u	plastik	plast ik -0
pláštích	plášt -ích	plášť	plášť -0
plátkem	plát k -em	plátek	plát ek -0
platí	plat í -0	platit	plat i -t
plavidlech	plav i dl -ech	plavidlo	plav i dl -o
plaze	plaz -e	plaz	plaz -0
pleskne	plesk ne -0	plesknout	plesk nou -t
pletí	plet -í	pleť	pleť -0
plic	plic -0	plíce	plíc -e
plivám	pliv á -m	plivat	pliv a -t
plnou	pln -ou	plný	pln -ý
neplodného	ne plod n -ého	plodný	plod n -ý
plotu	plot -u	plot	plot -0
plují	plu j -í	plout	plou -t
neplynul	ne ply nu l -0	plynout	ply nou -t
plýtváte	plýtv á -te	plýtvat	plýtv a -t
nepociťuješ	ne po ciť uje -š	pociťovat	po ciť ova -t
počal	po č a l -0	počít	po č í -t
nepočestných	ne po čest n -ých	počestný	po čest n -ý
počítám	po čít á -m	počítat	po čít a -t
počkejme	po čk ej -me	počkat	po čk a -t
podělaném	po děl a n -ém	podělaný	po děl a n -ý
poděla	po d ě l -a	podít	po dí -t
podívej	po dív ej -0	podívat	po dív a -t
podotkl	po do tk l -0	podotknout	po do tk nou -t
podomka	po dom k -a	podomek	po dom ek -0
pohnul	po h nu l -0	pohnout	po h nou -t
pohádek	p hád ek -0	pohádka	po hád k -a
pohaněné	po han ě n -é	pohaněný	po han ě n -ý
pohlédl	po hléd l -0	pohlédnout	po hléd nou -t
pohlcena	po hlc en -a	pohltit	po hlt i -t
pohřbil	po hřb i l -0	pohřbít	po hřb í t
nepohřbívá	ne po hřb í v á -0	pohřbívat	po hřb í v a -t
pohybuje	po hyb uje -0	pohybovat	po hyb ova -t
pocházím	po cház í -m	pocházet	po cház e -t
pochodně	po chod n -ě	pochodeň	po chod eň -0
pochroumán	po chroum á n -0	pochroumat	po chroum a -t
pochyb	po cyb -0	pochyba	po chyb -a
pochybujete	po chyb uje -te	pochybovat	po chyb ova -t
pokaždý	po každ -ý	pokaždé	po každ -é
pokládán	po klád á n -0	pokládat	po klád a -t
poklade	po klad e -0	poklást	po klás -t
pokožku	po kož k -u	pokožka	po kož k -a
pokračovala	po krač ova l -a	pokračovat	po krač ova -t
pokrčíš	po krč í -š	pokrčit	po krč i -t
pokročilejším	po kroč i l ejš -ím	pokročilý	po kroč i l -ý
pokryty	po kry t -y	pokrýt	po krý -t
pokusil	po kus i l -0	pokusit	po kus i -t
pokynul	po ky nu l -0	pokynout	po ky nou -t
polil	po li l -0	polít	po lí -t
polkla	polk l -a	polknout	po lk nou -t
polož	po lož -0	položit	po lož i -t
pomátl	po mát l -0	pomást	po más -t
pomašíruješ	po mašír uje -š	pomašírovat	po mašír ova -t
pomateném	po mat en -ém	pomatený	po mat en -ý
pominula	po mi nu l -a	pominout	po mi nou -t
pomohla	po moh l -a	pomoci	po moc -i
pomyslil	po mysl i l -0	pomyslet	po mysl e -t
ponechán	po nech á n -0	ponechat	po nech a -t
popadla	po pad l -a	popadnout	po pad nou -t
popelnic	po pel nic -0	popelnice	po pel nic -e
popletla	po plet l -a	poplést	po plés -t
popřel	po př e l -0	popřít	po př í -t
popřáli	po přá l -i	popřát	po přá -t
poradu	po rad -u	porada	po rad -a
poradím	po rad í -m	poradit	po rad i -t
poradkyní	po rad k yn -í	poradkyně	po rad k yn -ě
neporušily	ne po ruš i l -y	porušit	po ruš i -t
neporušitelné	ne po ruš i teln -é	porušitelný	po ruš i teln -ý
pořádku	po řád k -u	pořádek	po řád ek -0
posadila	po sad i l -a	posadit	po sad i -t
poselstva	po sel stv -a	poselstvo	po sel stv -o
poseroutkové	po ser outk -ové	poseroutka	po ser out k -a
posíláme	po síl á -me	posílat	po síl a -t
poslíčka	po sl íčk -a	poslíček	po sl íček -0
poslouchám	po slouch á -m	poslouchat	po slouch a -t
posloužím	po slouž í -m	posloužit	po slouž i -t
neposmívám	ne po smí v á -m	posmívat	po smí v a -t
posouvám	po souv á -m	posouvat	po souv a -t
pospícháme	po spích á -me	pospíchat	po spích a -t
poseru	po ser u -0	posrat	po sr a -t
postávalo	po stá v a l -o	postávat	po stá v a -t
postaráno	po star á n -o	postarat	po star a -t
postavila	po stav i l -a	postavit	po stav i -t
postele	po stel -e	postel	po stel -0
postýlek	po stýl ek -0	postýlka	po stýl k -a
poškozenému	po škoz en -ému	poškozený	po škoz en -ý
poškozujete	po škoz uje -te	poškozovat	po škoz ova -t
potápějícího	po táp ěj íc -ího	potápějící	po táp ěj íc -í
potěšená	po těš en -á	potěšený	po těš en -ý
potěšen	po těš en -0	potěšit	po těš i -t
potížemi	po tíž -emi	potíž	po tíž -0
potkáme	po tk á -me	potkat	po tk a -t
potměšilí	po tm +ě ši l -ý	potměšilý	po tm -ě šil -ý
potrpí	po trp í -0	potrpět	po trp ě -t
potřísněna	po třísn ěn -a	potřísnit	po třísn i -t
potulují	po tul uj -í	potulovat	po tul ova -t
potvrdila	po tvrd i l -a	potvrdit	po tvrd i -t
použila	po u ži l -a	použít	po u ží -t
povahy	po vah -y	povaha	po vah -a
pověřeni	po věř en -i	pověřit	po věř i -t
nepovedlo	ne po ved l -o	povést	po vés -t
povídala	po víd a l -a	povídat	po víd a -t
povolán	po vol á n -0	povolat	po vol a -t
nepovšiml	ne po všim l -0	povšimnout	po všim nou -t
povytáhl	po vy táh l -0	povytáhnout	po vy táh nou -t
nepozdržel	ne po z drž e l -0	pozdržet	po z drž e -t
pozdrav	po zdrav -0	pozdravit	po zdrav i -t
pozemku	po zem k -u	pozemek	po zem ek -0
pozná	po zn á -0	poznat	po zn a -t
poznámek	po znám ek -0	poznámka	po znám k -a
pozřeli	po zř e l -i	pozřít	po zř í -t
pozváni	po zv á n -i	pozvat	po zv a -t
požárech	po žár -ech	požár	po žár -0
nepodceňovala	ne pod ceň ova l -a	podceňovat	pod ceň ova -t
poddané	pod d a n -é	poddaná	pod d a n -á
nepoddajný	ne pod daj n -ý	poddajný	pod daj n -ý
podlaze	pod laz -e	podlaha	pod lah -a
podmíněném	pod mín ěn -ém	podmíněný	pod mín ěn -ý
nepodnikl	ne pod nik l -0	podniknout	pod nik nou -t
podnosem	pod nos -em	podnos	pod nos -0
nepodpoří	ne pod poř í -0	podpořit	pod poř i -t
podrobuji	pod rob uj -i	podrobovat	pod rob ova -t
podstupujeme	pod stup uje -me	podstupovat	pod stup ova -t
podvodů	pod vod -ů	podvod	pod vod -0
podepřel	pode př e l -0	podepřít	pode př í -t
podepiš	pode piš -0	podepsat	pode ps a -t
pohárech	pohár -ech	pohár	pohár -0
pohárky	pohár k -y	pohárek	pohár ek -0
poledním	pol e dn -ím	polední	pol e dn -í
pondělka	ponděl k -a	pondělek	ponděl ek -0
popošel	popo š e l -0	popojít	popo j í -t
nejpopulárnější	nej popul ár n ějš -í	populární	popul ár n -í
pouště	poušt -ě	poušť	poušť
pouštního	poušt n -ího	pouštní	poušt n -í
pouti	pout -i	pouť	pouť -0
poutem	pout -em	pouto	pout -o
pouzdru	pouzdr -u	pouzdro	pouzdr -o
nepral	ne pr a l -0	prát	pr á -t
prádelnímu	pr á del n -ímu	prádelní	pr á del n -í
prádle	pr á dl -e	prádlo	pr á dl -o
pradědkové	pra děd k -ové	pradědek	pra děd ek -0
pravěkých	pra věk -ých	pravěký	pra věk -ý
pracovně	prac ov n -ě	pracovna	prac ov n -a
pracovití	prac ovit -í	pracovitý	prac ovit -ý
prahu	prah -u	práh	práh -0
prahl	prah l -0	prahnout	prah nou -t
prachama	prach -ama	prachy	prach -y
nepraktikují	ne prakt ik uj -í	praktikovat	prakt ik ova -t
prasata	pras at -a	prase	pras -e
prasklo	prask l -o	prasknout	prask nou -t
praštíme	prašt í -me	praštit	prašt i -t
práv	práv -0	právo	práv -o
nepravdivé	ne prav d iv -é	pravdivý	prav d iv -ý
pravím	prav í -m	pravit	prav i -t
pravidel	prav i del -0	pravidlo	prav i dl -o
pravítkem	prav í tk -em	pravítko	prav í tk -o
pražskou	praž sk -ou	pražský	praž sk -ý
proběhám	pro běh á -m	proběhat	pro běh a -t
probodeni	pro bod en -i	probodnout	pro bod nou -t
probudila	pro bud i l -a	probudit	pro bud i -t
pročetl	pro čet l -0	pročíst	pro čís -t
prodáme	pro d á -me	prodat	pro d a -t
prohnula	pro h nu l -a	prohnout	pro h nou -t
neprohlašuju	ne pro hlaš uj -u	prohlašovat	pro hlaš ova -t
prohlédlo	pro hléd l -o	prohlédnout	pro hléd nou -t
projede	pro jed e -0	projet	pro je -t
projektován	pro jekt ová n -0	projektovat	pro jekt ova -t
projevovaly	pro jev ova l -y	projevovat	pro jev ova -t
projíždí	pro jížd í -0	projíždět	pro jížd ě -t
neprokáže	ne pro káž e -0	prokázat	pro káz a -t
proměňuje	pro měň uje -0	proměňovat	pro měň ova -t
promiňte	pro miň -te	prominout	pro mi nou -t
nepromluvím	ne pro mluv í -m	promluvit	pro mluv i -t
promočenými	pro moč en -ými	promočený	pro moč en -ý
pronajala	pro na j a l -a	pronajmout	pro na j mou -t
nepronesla	ne pro nes l -a	pronést	pro nés -t
propadli	pro pad l -i	propadnout	pro pad nou -t
propuknou	pro puk n ou -0	propuknout	pro puk nou -t
prorazí	pro raz í -0	prorazit	pro raz i -t
prosel	pro se l -0	prosít	pro sí -t
prospěšné	pro spěš n -é	prospěšný	pro spěš n -ý
prostředků	pro sřed k -ů	prostředek	pro střed ek -0
protáhlo	pro táh l -o	protáhnout	pro táh nou -t
neprovádim	ne pro vád i -m	provádět	pro vád ě -t
prozkoumáme	pro zkoum á -me	prozkoumat	pro zkoum a -t
prosím	pros í -m	prosit	pros i -t
protivíš	protiv í -š	protivit	protiv i -t
proužkem	prouž k -em	proužek	prouž ek -0
pršipláštích	prš +i plášt -ích	pršiplášť	prš i plášť -0
neprůhledné	ne prů hled n -é	průhledný	prů hled n -ý
průchodech	prů chod -ech	průchod	prů chod -0
průjezdech	prů jezd -ech	průjezd	prů jezd -0
přátelského	přátel sk -ého	přátelský	přátel sk -ý
přeběhly	při běh l -y	přeběhnout	pře běh nou -t
přečetl	pře čet l -0	přečíst	pře čís -t
přečká	pře čk á -0	přečkat	pře čk a -t
nepřeháněj	ne pře hán ěj -0	přehánět	pře hán ě -t
přehlédl	pře hléd l -0	přehlédnout	pře hléd nou -t
přehlušováno	pře hluš ová n -o	přehlušovat	pře hluš ova -t
přehozenou	pře hoz en -ou	přehozený	pře hoz en -ý
přecházejí	pře cház ej -í	přecházet	pře cház e -t
přešel	pře š e l -0	přejít	pře j í -t
překážek	pře káž ek -0	překážka	pře káž k -a
překladatelé	pře klad a tel -é	překladatel	pře klad a tel -0
překračuji	pře krač uj -i	překračovat	pře krač ova -t
nepřekročila	ne pře kroč i l -a	překročit	pře kroč i -t
překvapíme	pře kvap í -me	překvapit	pře kvap i -t
nepřekvapovala	ne pře kvap ova l -a	překvapovat	pře kvap ova -t
překypuje	pře kyp uje -0	překypovat	pře kyp ova -t
přelétávají	pře lét á v aj -í	přelétávat	pře lét á v a -t
přelila	pře li l -a	přelít	pře lí -t
přeložte	pře lož -te	přeložit	pře lož i -t
přemohla	pře moh l -a	přemoci	pře moc -i
nepřemýšlela	ne pře mýšl e l -a	přemýšlet	pře mýšl e -t
přeneseni	pře nes en -i	přenést	pře nés -t
přepadaly	pře pad a l -y	přepadat	pře pad a -t
přepíšete	pře píš e -te	přepsat	pře ps a -t
přesvědčen	pře s věd č en -0	přesvědčit	pře s věd č i -t
přestal	pře sta l -0	přestat	pře sta -t
přestavěn	pře stav ěn -0	přestavět	pře stav ě -t
přestěhují	pře stěh uj -í	přestěhovat	pře stěh ova -t
přesunuly	pře su nu l -y	přesunout	pře su nou -t
přetáhnou	pře táh n ou -0	přetáhnout	pře táh nou -t
převlékneš	pře vlék ne -š	převléknout	pře vlék nou -t
převzal	pře zv a l -0	převzít	pře vz í -t
přežila	pře ži l -a	přežít	pře ží -t
předpisům	před pis -ům	předpis	před pis -0
nepředpojatým	ne před po j a t -ým	předpojatý	před po j a t -ý
předpokládám	před po klád á -m	předpokládat	před po klád a -t
předsíni	před sín -i	předsíň	před síň -0
představuješ	před stav uje -š	představovat	před stav ova -t
předválečné	před váleč n -é	předválečný	před váleč n -ý
předvedl	před ved l -0	předvést	před vés -t
předešel	přede š e l -0	předejít	přede j í -t
přiběhli	při běh l -i	přiběhnout	při běh nou -t
nepřibouchla	ne při bouch l -a	přibouchnout	při bouch nou -t
příčin	př čin -0	příčina	pří čin -a
přihnul	při h nu l -0	přihnout	při h nou -t
přihodilo	při hod i l -o	přihodit	při hod i -t
příhodnějšího	pří hod n ějš -ího	příhodný	pří hod n -ý
přijal	při j a l -0	přijmout	při j mou -t
přijedou	při jed ou -0	přijet	při je -t
nepřijímejte	ne při jí mej -te	přijímat	při jím a -t
přijímacího	při jím ac -ího	přijímací	při jím ac -í
přijíždí	při jížd í -0	přijíždět	při jížd ě -t
příkazech	pří kaz -ech	příkaz	pří kaz -0
nepřikážu	ne při káž u -0	přikázat	při káz a -t
přikazuješ	při kaz uje -š	přikazovat	při kaz ova -t
přikován	při kov á n -0	přikovat	při kov a -t
přikrčen	při krč en -0	přikrčit	při krč i -t
nepřikryl	ne při kry l -0	přikrýt	při krý -t
přikývl	při kýv l -0	přikývnout	při kýv nou -t
přilehly	při leh l -y	přilehnout	při leh nou -t
přiletí	při let í -0	přiletět	při let ě -t
přiložen	při lož en -0	přiložit	při lož i -t
přimluv	při mluv -0	přimluvit	při mluv i -t
přinesla	při nes l -a	přinést	při nés -t
připjal	při pj a l -0	připnout	při p nou -t
připadlo	při pad l -o	připadnout	při pad nou -t
připomínaly	při po mín a l -y	připomínat	při po mín a -t
připrav	při prav -0	připravit	při prav i -t
přísahám	pří sah á -m	přísahat	pří sah a -t
příslušníci	pří sluš níc -i	příslušník	pří sluš ník -0
přistane	při sta ne -0	přistát	při st á -t
nepřistoupila	ne při stoup i l -a	přistoupit	při stoup i -t
přisuzovalo	při suz ova l -o	přisuzovat	při suz ova -t
přitaká	při tak á -0	přitakat	při tak a -t
přítěží	pří těž -í	přítěž	pří těž -0
přitiskne	při tisk ne -0	přitisknout	při tisk nou -t
přitisknutou	při tisk nu t -ou	přitisknutý	při tisk nu t -ý
přítomen	pří tom en -0	přítomný	pří tom n -ý
přituhly	při tuh l -y	přituhnout	při tuh nou -t
přivádí	při vád í -0	přivádět	při vád ě -t
přivážou	při váž ou -0	přivázat	při váz a -t
přived	při ved -0	přivést	při vés -t
přivez	při vez -0	přivézt	při véz -t
přivinul	při vi nu l -0	přivinout	při vi nou -t
nepřivolat	ne při vol a -t	přivolat	při vol a -t
přivřel	při vř e l -0	přivřít	při vř í -t
nepřivykl	ne při vyk l -0	přivyknout	při vyk nou -t
nepřiznal	ne při zn a l -0	přiznat	při zn a -t
předl	před l -0	příst	přís -t
přítelíčka	přítel íčk -a	přítelíček	přítel íček -0
přítelkyň	přítel kyň -0	přítelkyně	přítel kyn -ě
psala	ps a l -a	psát	ps á -t
pstruzi	pstruz -i	pstruh	pstruh -0
ptal	pt a l -0	ptát	pt á -t
ptáka	pták -a	pták	pták -0
publiku	publik -u	publikum	publ ik -um
publikací	publik ac -í	publikace	publik ac -e
pudem	pu d e -m	pud	pud -0
půlnoci	půl noc -i	půlnoc	půl noc -0
pusu	pus -u	pusa	pus -a
pusťte	pusť -te	pustit	pust i -t
pytlem	pytl -em	pytel	pytel -0
pytláci	pytl ác -i	pytlák	pytl ák -0
račte	rač -te	ráčit	ráč i -t
radnici	rad n ic -i	radnice	rad n ic -0
radiotelegrafisté	radio tele graf ist -é	radiotelegrafista	radio tele graf ist -a
rajčata	raj č at -a	rajče	raj č -e
rakve	rakv -e	rakev	rakev -0
rákosů	rákos -ů	rákos	rákos -0
ramena	ramen -a	rameno	ramen -o
ránu	rán -u	ráno	rán -o
raněnej	ran ěn -ej	raněný	ran ěn -ý
raní	ran í -0	ranit	ran i -t
razítky	raz í tk -y	razítko	raz í tk -o
rejdili	rejd i l -i	rejdit	rejd i -t
relací	relac -í	relace	relac -e
révovím	rév ov -ím	révoví	rév ov -í
riskuju	risk uj -u	riskovat	risk ova -t
rivalové	rival -ové	rival	rival -0
rodu	rod -u	rod	rod -0
rohem	roh -em	roh	roh -0
rojily	roj i l -y	rojit	roj i -t
rouru	rour -u	roura	rour -a
rozbíhá	roz bíh á -0	rozbíhat	roz bíh a -t
rozdrcen	roz drc en -0	rozdrtit	roz drt i -t
rozflákanej	roz flák a n -ej	rozflákaný	roz flák a n -ý
nerozhodně	ne roz hod n -ě	rozhodně	roz hod n -ě
rozhodnější	roz hod n ějš -í	rozhodný	roz hod n -ý
rozhodujeme	roz hod uje -me	rozhodovat	roz hod ova -t
rozhozenýma	roz hoz en -ýma	rozhozený	roz hoz en -ý
rozhrnuty	roz hr nu t -y	rozhrnout	roz hr nou -t
rozjedem	roz jed e -m	rozjet	roz j e -t
rozjívence	roz jív en c -e	rozjívenec	roz jív en ec -0
rozkašle	roz kašl e -0	rozkašlat	roz kašl a -t
rozkročen	roz kroč en -0	rozkročit	roz kroč i -t
rozkvetla	roz kvet l -a	rozkvést	roz kvés -t
rozloučenou	roz louč en -ou	rozloučená	roz louč en -á
rozmnoženy	roz množ en -y	rozmnožit	roz množ i -t
rozpacích	roz pac -ích	rozpaky	roz pak -y
rozprostřeli	roz pro stř e l -i	rozprostřít	roz pro stř í -t
rozrušena	roz ruš en -a	rozrušit	roz ruš i -t
rozškrtl	roz škrt l -0	rozškrtnout	roz škrt nou -t
roztahány	roz tah á n -y	roztahat	roz tah a -t
roztaženýma	roz taž en -ýma	roztažený	roz taž en -ý
roztrhán	roz trh á n -0	roztrhat	roz trh a -t
rozutečou	roz u teč ou -0	rozutéci	roz u téc -i
rozumí	roz um í -0	rozumět	roz um ě -t
rozvětvené	roz větv en -é	rozvětvený	roz větv en -ý
rozvinulo	roz vi nu l -o	rozvinout	roz vi nou -t
rozzuřují	roz zuř uj -í	rozzuřovat	roz zuř ova -t
rozešel	roze š e l -0	rozejít	roze j í -t
rozepnul	roze p nu l -0	rozepnout	roze p nou -t
rozepsáno	roze ps á n -o	rozepsat	roze ps a -t
rozestavím	roze stav í -m	rozestavit	roze stav i -t
rozevřenýma	roze vř e n -ýma	rozevřený	roze vř e n -ý
rozezněla	roze zn ě l -a	rozeznít	roze zn í -t
rublů	rubl -ů	rubl	rubl -0
nerušili	ne ruš i l -i	rušit	ruš i -t
rušném	ruš n -ém	rušný	ruš n -ý
růží	růž -í	růže	růž -e
rynkem	rynk -em	rynek	rynek -0
rýpne	rýp ne -0	rýpnout	rýp nou -t
nerýsovalo	ne rýs ova l -o	rýsovat	rýs ova -t
řádí	řád í -0	řádit	řád i -t
řádná	řád n -á	řádný	řád n -ý
ředitelově	ředitel ov -ě	ředitelův	řed i tel -0
ředkviček	ředkv iček -0	ředkvička	ředkv ičk -a
řeky	řek -y	řeka	řek -a
řekl	řek l -0	říci	říc -i
říděj	říd ěj -0	řídit	říd i -t
řídícímu	říd íc -ímu	řídící	říd íc -í
řídkým	říd k -ým	řídký	říd k -ý
říkal	řík a l -0	říkat	řík a -t
římsách	říms -ách	římsa	říms -a
říší	říš -í	říše	říš -e
řval	řv a l -0	řvát	řv á -t
shledanou	s hled a n -ou	shledaná	s hled a n -á
shodli	s hod l -i	shodnout	s hod nou -t
shodovalo	s hod ova l -o	shodovat	s hod ova -t
shrnul	s hr nu l -0	shrnout	s hr nou -t
schodišti	s chod išt -i	schodiště	s chod iště -0
schopno	s chop n -o	schopný	s chop n -ý
schoulena	s choul en -a	schoulit	s choul i -t
schovaní	s chov a n -í	schovaný	s chov a n -ý
zchrastil	z chrast i l -0	schrastit	s chrast i -t
schůdkům	s chůd k -ům	schůdek	s chůd ek -0
schůdcích	s chůd c -ích	schůdky	s chůd k -y
schváleny	s chvál en -y	schválit	s chvál i -t
sjednáno	s jedn á n -o	sjednat	s jedn a -t
sjezdu	s jezd -u	sjezd	s jezd -0
skládáme	s klád á -me	skládat	s klád a -t
skladbě	s klad b -ě	skladba	s klad b -a
skladišti	s klad išt -i	skladiště	s klad išt -ě
sklony	s klon -y	sklon	s klon
sklopenýma	s klop en -ýma	sklopený	s klop en -ý
sklouznul	s klouz nu l -0	sklouznout	s klouz nou -t
skončíme	s konč í -me	skončit	s konč i -t
skrývají	s krý v aj -í	skrývat	s krý v a -t
sletí	s let í -0	sletět	s let ě -t
slibte	s lib -te	slíbit	s líb i -t
slibuji	s lib uj -i	slibovat	s lib ova -t
slohovému	s loh ov -ému	slohový	s loh ov -ý
složena	s lož en -a	složit	s lož i -t
nesmetl	ne s met l -0	smést	s més -t
nesnášel	ne s náš e l -0	snášet	s náš e -t
snídaní	s níd a n -í	snídaně	s níd a n -ě
snědl	s něd l -0	sníst	s nís -t
nespadá	ne s pad á -0	spadat	s pad a -t
spad	s pad -0	spadnout	s pad nou -t
spáse	s pás -e	spása	s pás -a
spisů	s pis -ů	spis	s pis -0
spisovatelé	s pis ova tel -é	spisovatel	s pis ova tel -0
splnili	s pln i l -i	splnit	s pln i -t
spotřebuje	s po třeb uje -0	spotřebovat	s po třeb ova -t
spojeno	s poj en -o	spojit	s poj i -t
srozuměni	s roz um ě n -i	srozumět	s roz um ě -t
stáhnu	s táh n -u	stáhnout	s táh nou -t
stísněném	s tísn ěn -ém	stísněný	s tísn ěn -ý
stočil	s toč i l -0	stočit	s toč i -t
svádí	s vád í -0	svádět	s vád ě -t
svážou	s váž ou -0	svázat	s váz a -t
svazkům	s vaz k -ům	svazek	s vaz ek -0
nesvěřovala	ne s věř ova l -a	svěřovat	s věř ova -t
svlékla	s vlék l -a	svléknout	s vlék nou -t
sabotáže	sabot áž -e	sabotáž	sabot áž -0
sáčky	sáč k -y	sáček	sáč ek -0
nesahá	ne sah á -0	sahat	sah a -t
salamandrů	salamandr -ů	salamandr	salamandr -0
salonu	salon -u	salón	salón -0
salonku	salon k -u	salónek	salón ek -0
salutuju	salut uj -u	salutovat	salut ova -t
samečka	sam eč k -a	sameček	sam eč ek -0
sečetla	se čet l -a	sečíst	se čís -t
seženu	se žen -u	sehnat	se hn a -t
sňal	s ň a l -0	sejmout	se j mou -t
seřazuje	se řaz uje -0	seřazovat	se řaz ova -t
nesesedl	ne se sed l -0	sesednout	se sed nou -t
sešlejší	se š l ejš -í	sešlý	se š l -ý
setkal	se tk a l -0	setkat	se tk a -t
setřel	se tř e l -0	setřít	se tř í -t
sevřely	se vř e l -i	sevřít	se vř í -t
sebevědomým	seb -e věd om -ým	sebevědomý	seb -e věd om -ý
sebevraždě	seb -e vražd -ě	sebevražda	seb -e vražd -a
sedačkami	sed a čk ami	sedačka	sed a čk -a
sedadle	sed a dl -e	sedadlo	sed a dl -o
sedátek	sed á tek -0	sedátko	sed á tk -o
sedí	sed í -0	sedět	sed ě -t
sekyrou	sekyr -ou	sekyra	sekyr -a
senzačnější	senzač n ějš -í	senzační	senzač n -í
signály	signál -y	signál	signál -0
silněji	sil n ě j -i	silně	sil n -ě
siluety	siluet -y	silueta	siluet -a
síni	sín -i	síň	síň -0
sirku	sirk -u	sirka	sir k -a
sírové	sír ov -é	sírový	sír ov -ý
sirotky	sirot k -y	sirotek	sirot ek -0
síti	sít -i	síť	síť -0
skále	skál -e	skála	skál -a
skla	skl -a	sklo	skl -o
sklepě	sklep -ě	sklep	sklep -0
skotské	skot sk -é	skotská	skot sk -á
skříní	skřín -í	skříň	skříň -0
skříňce	skříň c -e	skříňka	skříň k -a
slabostí	slab ost -í	slabost	slab ost -0
slečno	slečn -o	slečna	slečn -a
sledovala	sled ova l -a	sledovat	sled ova -t
sloupce	sloup c -e	sloupec	sloup ec -0
sluhu	sluh -u	sluha	sluh -a
neslušný	ne sluš n -ý	slušný	sluš n -ý
slůvek	slův ek -0	slůvko	slův k -o
služebných	služ eb n -ých	služebná	služ eb n -á
neslyšel	ne slyš e l -0	slyšet	slyš e -t
nesmí	ne sm í -0	smět	sm ě -t
smažených	smaž en -ých	smažený	smaž en -ý
smetanovými	s met an ov -ými	smetanový	smetan ov -ý
smíchem	smích -em	smích	smích -0
smrkáčů	smrk áč -ů	smrkáč	smrk áč -0
nesmrtelné	ne smrt eln -é	smrtelný	smrt eln -ý
snili	sn i l -i	snít	sn í -t
snaze	snaz -e	snaha	snah -a
snažili	snaž i l -i	snažit	snaž i -t
soudruzi	sou druz -i	soudruh	sou druh -0
souhlasu	sou hlas -u	souhlas	sou hlas -0
souhlasili	sou hlas i l -i	souhlasit	sou hlas i -t
soustředěna	sou střed ěn -a	soustředit	sou střed i -t
soudíte	soud í -te	soudit	soud i -t
spaly	sp a l -y	spát	sp á -t
spolujezdce	spolu jezd c -e	spolujezdec	spolu jezd ec -0
spolužákům	spolu žák -ům	spolužák	spolu žák -0
sporty	sport -y	sport	sport -0
stovkou	st ovk -ou	stovka	st ovk -a
nestačím	ne stač í -m	stačit	stač i -t
stalinismu	stalin ism -u	stalinismus	stalin ism -us
nestarala	ne star a l -a	starat	star a -t
starochům	star och -ům	staroch	star och -0
starosti	star ost -i	starost	star ost -0
starce	star c -e	stařec	stař ec -0
staříkovi	stař ík -ovi	stařík	stař ík -0
stavu	stav -u	stav	stav -0
stavím	stav í -m	stavit	stav i -t
stehny	stehn -y	stehno	stehn -o
stodole	stodol -e	stodola	stodol -a
stolku	stol k -u	stolek	stol ek -0
strání	stran í -0	stráň	stráň -0
stránek	strán ek -0	stránka	strán k -a
strašlivější	straš liv ějš -í	strašlivý	straš liv -ý
strážníci	stráž níc -i	strážník	stráž ník -0
stroje	stroj -e	stroj	stroj -0
stromy	strom -y	strom	strom -0
strýčkovi	strýč k -ovi	strýček	strýč ek -0
středem	střed -em	střed	střed -0
střeše	střeš -e	střecha	střech -a
střevíčky	střevíč k -y	střevíček	střevíč ek -0
stříbrnými	stříbr n -ými	stříbrný	stříbr n -ý
střídaly	stříd a l -y	střídat	stříd a -t
nestřílel	ne stříl e l -0	střílet	stříl e -t
studni	studn -i	studně	studn -ě
studnicí	studn ic -í	studnice	studn ic -e
stolu	stol -u	stůl	stůl -0
stužky	stuž k -y	stužka	stuž k -a
stydím	styd í -m	stydět	styd ě -t
sunul	su nu l -0	sunout	su nou -t
sukněma	sukn -ěma	sukně	sukn -ě
suknem	sukn -em	sukno	sukn -o
sutí	sut -í	suť	suť -0
svalnatá	sval nat -á	svalnatý	sval nat -ý
svalovou	sval ov -ou	svalový	sval ov -ý
nejsvětější	nej svět ějš -í	svatý	svat -ý
světci	svět c -i	světec	svět ec -0
světélkem	svět él k -em	světélko	svět él k -o
světlejší	svět l ejš -í	světlý	svět l -ý
světskému	svět sk -ému	světský	svět sk -ý
světýlka	svět ýl k -a	světýlko	svět ýl k -o
svícnem	svíc n -em	svícen	svíc en -0
synu	syn -u	syn	syn -0
synáčku	syn áčk -i	synáček	syn áček -0
synka	syn k -a	synek	syn ek -0
synovcem	syn ovc -em	synovec	syn ovec -0
sýra	sýr -a	sýr	sýr -0
šálku	šálk -u	šálek	šálek -0
šatech	šat -ech	šaty	šat -y
šátkem	šát k -em	šátek	šát ek -0
šedýma	šed -ýma	šedý	šed -ý
šedivého	šed iv -ého	šedivý	šed iv -ý
šeptne	šept ne -0	šeptnout	šept nou -t
šeru	šer -u	šero	šer -o
nešifrované	ne šifr ova n -é	šifrovaný	šifr ova n -ý
šíleni	šíl en -i	šílený	šíl e n -ý
školáci	škol ác -i	školák	škol ák -0
neškrtám	ne škrt á -m	škrtat	škrt a -t
škubnutím	škub nu t -ím	škubnutí	škub nu t -í
šlapaje	šlap aj -e	šlapat	šlap a -t
nešmakují	ne šmak uj -í	šmakovat	šmak ova -t
šňůře	šňůř -e	šňůra	šňůr -a
šohajky	šohaj k -y	šohajek	šohaj ek -0
špičku	špič k -u	špička	špič k -a
šťastní	šťast n -í	šťastný	šťast n -ý
štěpnicemi	štěp n ic -emi	štěpnice	štěp nic -e
štítky	štít k -y	štítek	štít ek -0
štvali	štv a l -i	štvát	štv á -t
šunkofleků	šunk +o flek -ů	šunkofleky	šunk +o flek -y
šuplátek	šupl átek -0	šuplátko	šupl átk -o
švagrové	švagr -ové	švagrová	švagr ov -á
tabulí	tabul -í	tabule	tabul -e
táhnou	táh n ou -0	táhnout	táh nou -t
tajnému	taj n -ému	tajný	taj n -ý
talentu	talent -u	talent	talent -0
tančíte	tanč í -te	tančit	tanč i -t
tápali	táp a l -i	tápat	táp a -t
tatínkovi	tat ínk -ovi	tatínek	tat ínek -0
tátova	tát ov -a	tátův	tát ův -0
tážeme	táž e -me	tázat	táz a -t
tekl	tek l -0	téci	téc -i
telat	tel at -0	tele	tel -e
temnotě	temn ot -ě	temnota	temn ot -a
terase	teras -e	terasa	teras -a
těší	těš í -0	těšit	těš i -t
tetřeva	tetřev -a	tetřev	tetřev -0
tichu	tich -u	ticho	tich -o
tichým	tich -ým	tichý	tich -ý
tiskly	tisk l -y	tisknout	tisk nou -t
tísnivém	tísn iv -ém	tísnivý	tísn iv -ý
titulky	titul k -y	titulek	titul ek -0
tlačenicí	tlač en ic -í	tlačenice	tlač en ic -e
tlukouc	tluk ouc -0	tlouci	tlouc -i
tlouštíka	tloušt ík -a	tlouštík	tloušt ík -0
tonuly	to nu l -y	tonout	to nou -t
tolika	tolik -a	tolik	tolik
toužil	touž i l -0	toužit	touž i -t
továrně	továr n -ě	továrna	továr n -a
rozrušují	roz ruš uj -í	rozrušovat	toz ruš ova -t
rozsvítili	roz svít i l -i	rozsvítit	toz svít i -t
trnutím	tr nu t -ím	trnutí	tr nu t -í
transakci	trans akc -i	transakce	trans akc -e
trav	trav -0	tráva	tráv -a
trenérovi	tren ér -ovi	trenér	tren ér -0
triumfálního	trium ál n -ího	triumfální	triumf ál n -í
trnkových	trn k ový -ch	trnkový	trn k ov -ý
tropickém	trop ick -ém	tropický	trop ick -ý
troufá	trouf á -0	troufat	trouf a -t
třela	tř e l -a	třít	tř í -t
netřesou	ne třes ou -0	třást	třás -t
třískají	třísk aj -í	třískat	třísk a -t
tuctu	tuct -u	tucet	tucet -0
tuři	tuř -i	tur	tur -0
turečtí	tureč t -í	turecký	turec k -ý
netušícího	ne tuš íc -ího	tušící	tuš íc -í
tužeb	tuž eb -0	tužba	tuž b -a
tváři	tvář -i	tvář	tvář -0
tváříte	tvář í -te	tvářit	tvář i -t
tvrdí	tvrd í -0	tvrdý	tvrd -ý
tyfem	tyf -em	tyfus	tyf -us
netýká	ne týk á -0	týkat	týk a -t
ubíhají	u bíh aj -í	ubíhat	u bíh a -t
ubíralo	u bír a l -o	ubírat	u bír a -t
neublíží	ne u blíž í -0	ublížit	u blíž i -t
ubohej	u boh -ej	ubohý	u boh -ý
ubytují	u byt uj -í	ubytovat	u byt ova -t
úctyhodnému	ú ct -y hod n -ému	úctyhodný	ú ct -y hod n -ý
účtech	ú čt -ech	účet	ú čet -0
učiněno	u čin ěn -o	učinit	u čin i -t
účinnější	čin n ějš -í	účinný	ú čin n -ý
události	u d á l ost -i	událost	u d á l ost -0
udělám	u děl á -m	udělat	u děl a -t
úderu	ú der -u	úder	ú der -0
udivilo	u div i l -o	udivit	u div i -t
neudržitelnou	ne u drž i teln ou -0	udržitelný	u drž i teln -ý
udýchanej	u dých a n -ej	udýchaný	u dých a n -ý
uhnul	u h nu l -0	uhnout	u h nou -t
uhozené	u hoz en -é	uhozený	u hoz en -ý
neúhybným	ne ú hyb n -ým	úhybný	ú hyb n -ý
ujedou	u jed ou -0	ujet	u je -t
ujde	u jd e -0	ujít	u jí -t
ujišťuji	u jišť uj -i	ujišťovat	u jišť ova -t
ukážu	u káž u -0	ukázat	u káz a -t
uklidnili	u klid n i l -i	uklidnit	u klid n i -t
uklouzlo	u klouz l -o	uklouznout	u klouz nou -t
ukryl	u kry l -0	ukrýt	u krý -t
neukvapeného	ne u kvap en -ého	ukvapený	u kvap en -ý
ulétli	u lét l -i	ulétnout	u lét nou -t
ulítla	u lít l -a	ulítnout	u lít nou -t
umíraje	u mír aj -e	umírat	u mír a -t
umístěny	u míst ěn -y	umístit	u míst i -t
umřela	u mř e l -a	umřít	u mř í -t
umyl	u my l -0	umýt	u mý -t
unavení	u nav en -í	unavený	u nav en -ý
unavena	u nav en -a	unavit	u nav i -t
neúnavnou	ne ú nav n -ou	únavný	ú nav n -ý
unavujou	u nav uj -ou	unavovat	u nav ova -t
unesl	u nes l -0	unést	u nés -t
uniknete	u nik ne -te	uniknout	u nik nou -t
upekla	u pek l -a	upéci	u péc -i
upevněna	u pevn ěn -a	upevnit	u pevn i -t
neupije	ne u pi je -0	upít	u pí -t
upíral	u pír a l -0	upírat	u pír a -t
upozorňujeme	u po zor ň uje -me	upozorňovat	u po zor ň ova -t
upoutávalo	u pout á v a l -o	upoutávat	u pout á v a -t
neupravenou	ne u prav en -ou	upravený	u prav en -ý
upřel	u př e l -0	upřít	u př í -t
urážena	u ráž en -a	urážet	u ráž e -t
určeno	u rč en -o	určit	u rč i -t
určitého	u rč i t -ého	určitý	u rč i t -ý
určitostí	u rč it ost -í	určitost	u rč it ost
úroky	ú rok -y	úrok	ú rok -0
úředním	ú řed n -ím	úřední	ú řed n -í
úředníci	ú řed níc -i	úředník	ú řed ník -0
uschopňují	u s chop ň uj -í	uschopňovat	u s chop ň ova -t
usneš	u s ne -š	usnout	u s nou -t
uspokojen	u s po koj en -0	uspokojit	u s po koj i -t
neuspořádané	ne u s po řád a n -é	uspořádaný	u s po řád a n -ý
usedlostech	u sed l ost -ech	usedlost	u sed l ost -0
úsecích	ú sec -ích	úsek	ú sek -0
úseková	ú sek ov -á	úsekový	ú sek ov -ý
usilují	u sil uj -í	usilovat	u sil ova -t
usínám	u sín á -m	usínat	u sín a -t
uskakuju	u skak uj -u	uskakovat	u skak ova -t
neuslyším	ne u slyš í -m	uslyšet	u slyš e -t
usměje	u smě je -0	usmát	u sm á -t
usmívá	u sm í v á -0	usmívat	u sm í v a -t
úspěšné	ú spěš n -é	úspěšný	ú spěš n -ý
úsvitě	ú svit -ě	úsvit	ú svit -0
ušil	u ši l -0	ušít	u ší -t
ušklíbl	u šklíb l -0	ušklíbnout	u šklíb nou -t
utaháš	u tah á -š	utahat	u tah a -t
utěšenému	u těš en -ému	utěšený	u těš en -ý
neuteklo	ne u tek l -o	utéci	u tét -i
utichají	u tich aj -í	utichat	u tich a -t
utíkaly	u tík a l -y	utíkat	u tík a -t
utkáme	u tk á -me	utkat	u tk a -t
utonuly	u to nu l -y	utonout	u to nou -t
útržků	ú trž k -ů	útržek	ú trž ek -0
utřel	u tř e l -0	utřít	u tř í -t
uvádí	u vád í -0	uvádět	u vád ě -t
neuvažovala	neu važ ova l -a	uvažovat	u važ ova -t
uvezeme	u vez e -me	uvézt	u véz -t
uvidíte	u vid í -te	uvidět	u vid ě -t
uvrženi	u vrž en -i	uvrhnout	u vrh nou -t
uznána	u zn á n -0	uznat	u zn a -t
užije	u ži je -0	užít	u ží -t
neučit	ne uč i -t	učit	uč i -t
učitelského	uč i tel sk -ého	učitelský	uč i tel -0
úhlu	úhl -u	úhel	úhel -0
uším	uš -ím	ucho	uch -o
uličkou	ulič k -ou	ulička	ulič k -a
ulsterští	ulster št -í	ulsterský	ulster sk -ý
umí	um í -0	umět	um ě -t
uniformě	uni form -ě	uniforma	uni form -a
nejútlejším	nej útl ejš -ím	útlý	útl -ý
vběhli	v běh l -i	vběhnout	v běh nou -t
nevdala	ne v d a l -a	vdát	v d á -t
vyhlídek	vy hlíd ek -0	vyhlídka	v hlíd k -a
vcházejíc	v cház ej íc -0	vcházet	v cház e -t
vklíněna	v klín ěn -a	vklínit	v klín i -t
vklouzla	v klouz l -a	vklouznout	v klouz nou -t
vkročil	v kroč i l -0	vkročit	v kroč i -t
vlezu	v lez u -0	vlézt	v léz -t
nevnímal	ne v ním a l -0	vnímat	v ním a -t
vpila	v pi l -a	vpít	v pí -t
vrazím	v raz í -m	vrazit	v raz i -t
vstali	v sta l -i	vstát	v stá -t
nejvábnější	nej váb n ějš -í	vábný	váb n -ý
vagónů	vagón -ů	vagón	vagón -0
vahou	vah -ou	váha	váh -a
válej	vál ej -0	válet	vál e -t
vatikánskému	vatikán sk ému	vatikánský	vatikán sk -ý
vázance	váz a n c -e	vázanka	váz a n k -a
vážim	váž i -m	vážit	váž i -t
vetřela	ve tř e l -a	vetřít	ve tř í -t
večír	večír -0	večer	večer -0
víte	v í -te	vědět	věd ě -T
vědci	věd c -i	vědec	věd ec -0
vědoma	věd om -a	vědomý	věd om -ý
vedru	vedr -u	vedro	vedr -o
vědru	vědr -u	vědro	vědr -o
vejpravu	vej prav -u	vejprava	vej prav -a
věnovány	věn ová n -y	věnovat	věn ova -t
věnce	věnc -e	věnec	věnec -0
verst	verst -0	versta	verst -a
věřim	věř i -m	věřit	věř i -t
vedu	ved -u	vést	vés -t
nevěšejí	ne věš ej -í	věšet	věš e -t
vět	vět -0	věta	vět -a
vezli	vez l -i	vézt	véz -t
věže	věž -e	věž	věž -0
neviditelná	ne vid iteln -á	viditelný	vid iteln -ý
vidlicích	vidl ic -e	vidlice	vidl ic -e
víří	víř í -0	vířit	víř i -t
visely	vis e l -y	viset	vis e -t
větrů	větr -ů	vítr	vítr -0
vizím	viz -ím	vize	viz -e
vlasti	vlast -i	vlast	vlast -0
vlhne	vlh ne -0	vlhnout	vlh nou -t
nevlídná	ne vlíd n -á	vlídný	vlídn -ý
vlci	vlc -i	vlk	vlk -0
vopije	vo pi je -0	vopít	vo pí -t
vodě	vod -ě	voda	vod -a
vodítku	vod í tk -u	vodítko	vod í tk -o
vodnes	vod nes -0	vodnést	vod nés -t
nevolají	ne vol aj -í	volat	vol a -t
vousech	vous -ech	vousy	vous -y
vozí	voz í -0	vozit	voz i -t
vozovce	voz ovk -a	vozovka	voz ovk -a
vracím	vrac í -m	vracet	vrac e -t
vrásek	vrás ek -0	vráska	vrás k -a
nevrátí	ne vrát í -0	vrátit	vrát i -t
vrátnici	vrát nic -i	vrátnice	vrát nic -e
vtrhly	v trh l -y	vtrhnout	vrh nou -t
vrhne	vrh ne -0	vrhnout	vrh nou -t
vršku	vrš k -u	vršek	vrš ek -0
vrzlo	vrz l -o	vrznout	vrz nou -t
nevšedního	ne všedn -ího	všední	všedn -í
všimla	všim l -a	všimnout	všim nou -t
vteřin	vteřin -0	vteřina	vteřin -a
vtipkařům	vtip k ař -ům	vtipkař	vtip k ař -0
voly	vol -y	vůl	vůl -0
voze	voz -e	vůz	vůz -0
vyli	vy l -i	výt	vý -t
vybídla	vy bíd l -a	vybídnout	vy bíd nou -t
vybíráš	vy bír á -š	vybírat	vy bír a -t
vyberte	vy ber -te	vybrat	vy br a -t
vybraným	vy br a n -ým	vybraný	vy br a n -ý
nevybuchne	ne vy buch ne -0	vybuchnout	vy buch nou -t
vycvičeni	vy cvič en -i	vycvičit	vy cvič i -t
vyčerpaná	vy čerp a n -á	vyčerpaný	vy čerp a n -ý
vyčetla	vy čet l -a	vyčíst	vy čís -t
vyčištěnej	vy čišt ěn -ej	vyčištěný	vy čišt ěn -ý
vydechne	vy dech ne -0	vydechnout	vy dech nou -t
vydlabanému	vy dlab a n -ému	vydlabaný	vy dlab an -ý
nevydržel	ne vy drž e l -0	vydržet	vy drž e -t
vyhánějí	vy hán ěj -í	vyhánět	vy hán ě -t
nevyhledávají	ne vy hled á v aj -í	vyhledávat	vy hled á v a -t
vyženu	vy žen -u	vyhnat	vy hn a -t
nevyhověla	ne vy hov ě l -a	vyhovět	vy hov ě -t
vyhrnula	vy hr nu l -a	vyhrnout	vy hr nou -t
vyhrnutými	vy hr nu t -ými	vyhrnutý	vy hr nu t -ý
vyhrkly	vy hrk l -y	vyhrknout	vy hrk nou -t
východě	vý chod -ě	východ	vý chod -0
vychutnáváme	vy chut n á v á -me	vychutnávat	vy chut n á v a -t
vyjádřeno	vy jádř en -o	vyjádřit	vy jádř i -t
nevyjadřuje	ne vy jadř uje -0	vyjadřovat	vy jadř ova -t
nevyjasněného	ne vy jas n ěn -ého	vyjasněný	vy jas n ěn -ý
vyjek	vy jek -0	vyjeknout	vy jek nou -t
vykašlem	vy kašl e -m	vykašlat	vy kašl a -t
vykládáme	vy klád á -me	vykládat	vy klád a -t
vykřikli	vy řkik l -i	vykřiknout	vy křik nou -t
vykvetl	vy kvet l -0	vykvést	vy kvés -t
výletě	vý let -ě	výlet	vý let -0
vylétne	vy lét ne -0	vylétnout	vy lét nou -t
vylez	vy lez -0	vylézt	vy léz -t
vylézaly	vy léz a l -y	vylézat	vy léz a -t
vyloučeni	vy louč en -i	vyloučit	vy louč i -t
vyměňuje	vy měň uje -0	vyměňovat	vy měň ova -t
výmluvností	vý mluv n ost -í	výmluvnost	vý mluv n ost -0
vymyslím	vy mysl í -m	vymyslet	vy mysl e -t
nevymýšlím	ne vy mýšl í -m	vymýšlet	vy mýšl e -t
vynálezcova	vy ná lez c ov -a	vynálezcův	vy ná lez c ův -0
vynášejí	vy náš ej -í	vynášet	vy náš e -t
nevyniká	ne vy nik á -0	vynikat	vy nik a -t
vynucenému	vy nuc en -ému	vynucený	vy nuc en -ý
vypni	vy p n -i	vypnout	vy p nou -t
vypnutelnými	vy p nu teln -ými	vypnutelný	vy p nu teln -ý
vypadneme	vy pad ne -me	vypadnout	vy pad nou -t
vypil	vy pi l -0	vypít	vy pí -t
vypínačem	vy pín ač -em	vypínač	vy pín ač -0
vyplivne	vy pliv ne -0	vyplivnout	vy pliv nou -t
vyplynuly	vy ply nu l -y	vyplynout	vy ply nou -t
výpovědi	vý po věd -i	výpověď	vý po věď -0
výpotky	vý pot k -y	výpotek	vý pot ek -0
vypoulenýma	vy poul en -ýma	vypoulený	vy poul en -ý
vyprahlého	vy prah l -ého	vyprahlý	vy prah l -ý
vyprávěli	vy práv ě l -i	vyprávět	vy práv ě -t
nevyprovokovaly	ne vy pro vok ova l -y	vyprovokovat	vy pro vok ova -t
nevyptávala	ne vy pt á v a l -a	vyptávat	vy pt á v a -t
vypůjčeny	vy půjč en -y	vypůjčit	vy půjč i -t
vypuštěnej	vy pušt ěn -ej	vypuštěný	vy pušt ěn -ý
nevyrábí	ne vy ráb í -0	vyrábět	vy ráb ě -t
vyrazíme	vy raz í -me	vyrazit	vy raz i -t
nevyráželi	ne vy ráž e l -i	vyrážet	vy ráž e -t
výrobků	vý rob k -ů	výrobek	vý rob ek -0
vyrostlo	vy rost l -o	vyrůst	vy růs -t
nevyrušovat	ne vy ruš ova -t	vyrušovat	vy ruš ova -t
nevyřešily	ne vy řeš i l -y	vyřešit	vy řeš i -t
nevyřízených	ne vy říz ený -ch	vyřízený	vy říz en -ý
vysadíme	vy sad í -me	vysadit	vy sad i -t
nevyskytovalo	ne vy skyt ova l -o	vyskytovat	vy skyt ova -t
vyšle	vy šl e -0	vyslat	vy sl a -t
výslechů	vý slech -ů	výslech	vý slech -0
vysloužilých	vy slouž i l -ých	vysloužilý	vy slouž i l -ý
vyslýchán	vy slých á n -0	vyslýchat	vy slých a -t
vysere	vy ser e -0	vysrat	vy sr a -t
výstavě	vý stav -ě	výstava	vý stav -a
nevysypalo	ne vy syp a l -o	vysypat	vy syp a -t
vyšetřovatelé	vy šetř ova tel -é	vyšetřovatel	vy šetř ova tel -0
nevyšplháš	ne vy šplh á -š	vyšplhat	vy šplh a -t
výtahům	vý tah -ům	výtah	vý tah -0
vytáhla	vy táh l -a	vytáhnout	vy táh nou -t
vytrácí	vy trác í -0	vytrácet	vy trác e -t
vytratím	vy trat í -m	vytratit	vy trat i -t
vytrhnu	vy trh n -u	vytrhnout	vy trh nou -t
nevytrubují	ne vy trub uj -i	vytrubovat	vy trub ova -t
vytryskly	vy trysk l -y	vytrysknout	vy trysk nou -t
vytřel	vy tř e l -0	vytřít	vy tř í -t
vytřeštěnýma	vy třešt ěn -ýma	vytřeštěný	vy třešt ěn -ý
vytvářeno	vy tvář e n -o	vytvářet	vy tvář e -t
vytvoříme	vy tvoř í -me	vytvořit	vy tvoř i -t
vytýkáno	vy týk á n -o	vytýkat	vy týk a -t
vyvázne	vy váz ne -0	vyváznout	vy váz nou -t
vyved	vy ved -0	vyvést	vy vés -t
vyvíjen	vy víj en -0	vyvíjet	vy víj -í
vývodama	vý vod -ama	vývod	vý vod -0
vyvracela	vy vrac e l -a	vyvracet	vy vrac e -t
vyzpovídej	vy z po víd ej -0	vyzpovídat	vy z po víd a -t
nevyznám	ne vy zn á -m	vyznat	vy zn a -t
nevyzní	ne vy zn í -0	vyznít	vy zn í -t
vyžadují	vy žad uj -i	vyžadovat	vy žad ova -t
výři	výř -i	výr	výr -0
vysoké	vys ok -é	vysoká	vys ok -á
vzdal	vz d a l -0	vzdát	vz d á -t
nevzdává	ne vz d á v á -0	vzdávat	vz d á v a -t
vzdorovitější	z dor ov it ějš -í	vzdorovitý	vz dor ov it -ý
vzdychá	vz dych á -0	vzdychat	vz dych a -t
vzdychla	vz dych l -a	vzdychnout	vz dych nou -t
vzhlédneme	vz hléd ne -me	vzhlédnout	vz hléd nou -t
vzchop	vz chop -0	vzchopit	vz chop i -t
vzala	vz a l -a	vzít	vz í -t
vzkážu	vz káž u -0	vzkázat	vz káz a -t
vzlétněme	vz lét ně -me	vzlétnout	vz lét nou -t
vznesl	vz nes l -0	vznést	vz nés -t
vznešenějšímu	vz nes en ějš -ímu	vznešený	vz neš en -ý
vzniklo	vz nik l -o	vzniknout	vz nik nou -t
vzpamatuj	vz pamat uj -0	vzpamatovat	vz pamat ova -t
nevzpomínám	ne vz po mín á -m	vzpomínat	vz po mín a -t
vzpomínkám	vz po mín k -ám	vzpomínka	vz po mín k -a
vzpourám	vz pour -ám	vzpoura	vz pour -a
nevzrušilo	ne vz ruš i l -o	vzrušit	vz ruš i -t
nejvzácnější	nej vzácn ějš -í	vzácný	vzácn -ý
vzejde	vze jd e -0	vzejít	vze jí -t
dycky	dycky	vždycky	vždycky
zbabělče	z bab ě l č -e	zbabělec	z bab ě l ec -0
zbavil	z bav i l -0	zbavit	z bav i -t
nejzbědovanější	nej z běd ova n ějš -í	zbědovaný	z běd ova n -ý
zbili	z bi l -i	zbít	z bí -t
nezbořila	ne z boř i l -a	zbořit	z boř i -t
zbraně	z bran -ě	zbraň	z braň -0
zbyl	z by l -0	zbýt	z bý -t
zbytečnou	z byt eč n -ou	zbytečný	z byt eč n -ý
zděšeni	z děš en -i	zděsit	z děs i -t
zdržím	z drž í -m	zdržet	z drž e -t
zdržuju	z drž uj -u	zdržovat	z drž ova -t
zhasnou	z has n -ou	zhasnout	z has nou -t
nejjednodušší	nej jedn +o duš š -í	zjednodušit	z jedn +o duš i -t
zjistím	z jist í -m	zjistit	z jist i -t
zkazilo	z kaz i l -o	zkazit	z kaz i -t
nezklamete	ne z klam e -te	zklamat	z klam a -t
zkomplikuješ	z kompl ik uje -š	zkomplikovat	z kompl ik ova -t
zkouším	z kouš í -m	zkoušet	z kouš e -t
zkusím	z kus í -m	zkusit	z kus i -t
nejzkušenější	nej z kuš en ějš -í	zkušený	z kuš en -ý
zmátl	z mát l -0	zmást	z más -t
zmateného	z mat en -ého	zmatený	z mat en -ý
nezmínila	ne z mín i l -a	zmínit	z mín i -t
zmiňuji	z miň uj -i	zmiňovat	z miň ova -t
zmítá	z mít á -0	zmítat	z mít a -t
zmizí	z miz í -0	zmizet	z miz e -t
nezmohl	ne z moh l -0	zmoci	z moc -i
neznečišťuje	ne z ne čišť uje -0	znečišťovat	z ne čišť ova -t
zneklidňována	z ne klid ň ová n -a	zneklidňovat	z ne klid ň ova -t
znešvařena	z ne švař en -a	znešvařit	z ne švař i -t
zneužila	z ne u ži l -a	zneužít	z ne u ží -t
zneužíváme	z ne u ží v á -me	zneužívat	z ne u ží v a -t
zničeného	z nič en -ého	zničený	z nič en -ý
zpovědi	z po věd -i	zpověď	z po věď -0
způsobili	z pů sob i l -i	způsobit	z pů sob i -t
zrudnul	z rud nu l -0	zrudnout	z rud nou -t
zrušenou	z ruš en -ou	zrušený	z ruš en -ý
ztrátách	z trát -ách	ztráta	z trát -a
ztratili	z trat i l -i	ztratit	z trat i -t
zůstáváme	z ů stá v á -me	zůstávat	z ů stá v a -t
zvedl	z ved l -0	zvednout	z ved nou -t
zvěstovaly	z věst ova l -y	zvěstovat	z věst ova -t
zvětšovaly	z větš ova l -y	zvětšovat	z větš ova -t
zvíří	z víř í -0	zvířit	z víř i -t
zvládnu	z vlád n -u	zvládnout	z vlád nou -t
zvykaly	z vyk a l -y	zvykat	z vyk a -t
nezvýšila	ne z výš i l -a	zvýšit	z výš i -t
zabedněnce	za bedn ě nc -e	zabedněnec	za bedn ěn ec -0
zabte	za b -te	zabít	za bí -t
nezabíjí	ne za bi j -í	zabíjet	za bíj e -t
zablesklo	za blesk l -o	zablesknout	za blesk nou -t
nezabývaly	ne z bý v a l -y	zabývat	za býv a -t
zaceluje	za cel uje -0	zacelovat	za cel ova -t
začíná	za čín á -0	začínat	za čín a -t
zadřela	za dř e l -a	zadřít	za dř í -t
zahnul	za h nu l -0	zahnout	za h nou -t
zahlédl	za hléd l -0	zahlédnout	za hléd nou -t
nezahořeli	ne za hoř e l -i	zahořet	za hoř e -t
zahrajeme	za hra je -me	zahrát	za hrá -t
zahřměl	za hřm ě l -0	zahřmít	za hřm í -t
zachmuřen	za chmuř en -0	zachmuřit	za chmuř i -t
zachráním	za chrán í -m	zachránit	za chrán i -t
zachce	za chc e -0	zachtít	za cht í -t
zašel	za š e l -0	zajít	za j í -t
zájmu	zá jm -u	zájem	zá jem -0
nezajímá	ne za jím á -0	zajímat	za jím a -t
zajištěn	za jišt ěn -0	zajistit	za jist i -t
zajištěnej	za jišt ěn -ej	zajištěný	za jišt ěn -ý
zákazníci	zá kaz níc -i	zákazník	zá kaz ník -0
základech	zá klad -ech	základ	zá klad -0
zaklaply	za klap l -y	zaklapnout	za klap nou -t
zaklenuly	za kle nu l -y	zaklenout	za kle nou -t
zaklepe	za klep e -0	zaklepat	za klep a -t
zaklesnuti	za kles nu t -í	zaklesnout	za kles nou -t
zakleti	za kle t -í	zaklít	za klí -t
zákony	zá kon -y	zákon	zá kon -0
zakopán	za kop á n -0	zakopat	za kop a -t
zákusky	zá kus k -y	zákusek	zá kus ek -0
zalejváte	za lejv á -te	zalejvat	za lej v a -t
nezalévaná	ne za lév a n -á	zalévaný	za lév a n -ý
nezáleželo	ne zá lež e l -o	záležet	zá lež e -t
zalil	za li l -0	zalít	za lí -t
zamávej	za máv ej -0	zamávat	za máv a -t
nezamčené	ne za mč en -é	zamčený	za mč en -ý
zámku	zá mk -u	zámek	zá mek -0
zaměstnanci	za měst n an c -i	zaměstnanec	za měst n an ec -0
zamčeno	za mč en -o	zamknout	za mk nou -t
zamluven	za mluv en -0	zamluvit	za mluv i -t
zamyslil	za mysl i l -0	zamyslet	za mysl e -t
zamžily	za mž i l -y	zamžít	za mž í -t
zaniklo	za nik l -o	zaniknout	za nik nou -t
nezaoblená	ne za obl en -á	zaoblený	za obl en -ý
zapadalo	za pad a l -o	zapadat	za pad a -t
zapadajícího	za pad aj íc -ího	zapadající	za pad aj íc -í
zapisují	za pis uj -í	zapisovat	za pis ova -t
zaplaven	za plav en -0	zaplavit	za plav i -t
zaplavuje	za plav uje -0	zaplavovat	za plav ova -t
nezapochyboval	ne za po chyb ova l -0	zapochybovat	za po chyb ova -t
zapříčiňuje	za pří čiň uje -0	zapříčiňovat	za pří čiň ova -t
zarámovány	za rám ová n -y	zarámovat	za rám ova -t
zarděnkami	za rd ě n k ami	zarděnky	za rd ě n k -y
zarmucuje	za rmuc uje -0	zarmucovat	za rmuc ova -t
zármutku	zá rmut k -u	zármutek	zá rmut ek -0
nezařaditelní	ne za řad i teln -í	zařaditelný	za řad i teln -ý
zařídím	za říd í -m	zařídit	za říd i -t
zařve	za řv e -0	zařvat	za řv a -t
zaslíbeni	za s líb en -i	zaslíbit	za s líb i -t
zásadám	zá sad -ám	zásada	zá sad -a
zasáhlo	za sáh l -o	zasáhnout	za sáh nou -t
zasilatelství	za sil a tel stv -í	zasílatelství	za síl a tel stv -í
zaslechli	za slech l -i	zaslechnout	za slech nou -t
zasloužím	za slouž í -m	zasloužit	za slouž i -t
zásluhám	zá sluh -ám	zásluha	zá sluh -a
nezasluhuje	ne za sluh uje -0	zasluhovat	za sluh ova -t
zasmáli	za smá l -i	zasmát	za smá -t
zásob	zá sob -0	zásoba	zá sob -a
zastavil	za stav i l -0	zastavit	za stav i -t
nezasténal	ne za stén a l -0	zasténat	za stén a -t
zástěře	zá stěř -e	zástěra	zá stěr -a
zástěrce	zá stěr c -e	zástěrka	zá stěr k -a
zastižen	za stiž en -0	zastihnout	za stih nou -t
zaťal	za ť a l -0	zatnout	za t nou -t
zatažena	za taž en -a	zatáhnout	za táh nou -t
zatčení	za tč en -í	zatčený	za tč en -ý
nezatížený	ne za tíž en -y	zatížený	za tíž en -ý
zatkneme	za tk ne -me	zatknout	za tk nou -t
zátoky	zá tok -y	zátoka	zá tok -a
zaujalo	za u j a l -o	zaujmout	za u j mou -t
zavalila	za val i l -a	zavalit	za val i -t
zavázali	za váz a l -i	zavázat	za váz a -t
zavazadla	za vaz a dl -a	zavazadlo	za vaz a dl -o
zavázanou	za váz a n -ou	zavázaný	za váz a n -ý
závazkům	zá vaz k -ům	závazek	zá vaz ek -0
zavedl	za ved l -0	zavést	za vés -t
zavezl	za vez l -0	zavézt	za véz -t
zavírají	za vír aj -í	zavírat	za vír a -t
zavoláme	za vol á -me	zavolat	za vol a -t
zavoní	za von í -0	zavonět	za von ě -t
zavrtí	za vrt í -0	zavrtět	za vrt ě -t
zavřenýma	za vř en -ýma	zavřený	za vř e n -ý
zavřeny	za vř en -y	zavřít	za vř í -t
zazněla	za zn ě l -a	zaznít	za zn í -t
zaznamenej	za znamen ej -0	zaznamenat	za znamen a -t
zazvonil	za zvon i l -0	zazvonit	za zvon i -t
zažili	za ži l -i	zažít	za ží -t
zdálo	zd á l -o	zdát	zd á -t
zemřel	ze mř e l -0	zemřít	ze mř í -t
zeptala	ze pt a l -a	zeptat	ze pt a -t
zdi	zd -i	zeď	zeď -0
zedníkům	zed ník -ům	zedník	zed ník -0
zeleniny	zelen in -y	zelenina	zelen in -a
zemáků	zem ák -ů	zemák	zem ák -0
zemité	zem it -é	zemitý	zem it -ý
zemského	zem sk -ého	zemský	zem sk -ý
zíraje	zír aj -e	zírat	zír a -t
zívl	zív l -0	zívnout	zív nou -t
zlému	zl -ému	zlý	zl -ý
zlatokopově	zlat +o kop ov -ě	zlatokopův	zlat +o kop ův -0
zlatovlasé	zlat +o vlas -é	zlatovlasý	zlat +o vlas -ý
zlověstná	zlo věst n -ý	zlověstný	zlo věst n -ý
nezlob	ne zlob -0	zlobit	zlob i -t
znalostí	zn a l ost -í	znalost	zn a l ost -0
zní	zn í -0	znít	zn í -t
známek	znám ek -0	známka	znám k -a
zpěvům	zpěv -ům	zpěv	zpěv -0
zpívaj	zpív aj -0	zpívat	zpív a -t
zrcadlem	zrc a dl -em	zrcadlo	zrc a dl -o
zrcátka	zrc á tk -a	zrcátko	zrc á tk -o
zřetelné	zř e teln -é	zřetelný	zř e teln -ý
zval	zv a l -0	zvát	zv á -t
zvonky	zvon k -y	zvonek	zvon ek -0
nezvonilo	ne zvon i l -o	zvonit	zvon i -t
žádám	žád á -m	žádat	žád a -t
nejžádoucnější	nej žád ouc n ějš -í	žádoucný	žád ouc n -ý
žebrákům	žebr ák -ům	žebrák	žebr ák -0
želízky	želíz k -y	želízko	želíz k -o
neženaté	ne žen at -é	ženatý	žen at -ý
ženské	žen sk -é	ženská	žen sk -á
ženských	žen sk -ých	ženský	žen sk -ý
žerdě	žerd -ě	žerď	žerď -0
životopisce	živ ot +o pis c -e	životopisec	živ ot +o pis ec -0
